game_id,blue_kills,blue_deaths,blue_assists,blue_elite_monsters,blue_dragons,blue_heralds,blue_towers_destroyed,blue_total_gold,blue_avg_level,blue_total_experience,blue_total_minions_killed,blue_total_jungle_minions_killed,blue_gold_diff,blue_experience_diff,blue_cs_per_min,blue_gold_per_min,red_kills,red_deaths,red_assists,red_elite_monsters,red_dragons,red_heralds,red_towers_destroyed,red_total_gold,red_avg_level,red_total_experience,red_total_minions_killed,red_total_jungle_minions_killed,red_gold_diff,red_experience_diff,red_cs_per_min,red_gold_per_min,winner,blue_kda,red_kda,blue_vision_score,red_vision_score,first_blood
4519157822,9,6,11,0,0,0,0,17210,6.6,17039,195,36,643,-8,19.5,1721,6,9,8,0,0,0,0,16567,6.8,17047,197,55,-643,8,19.7,1656.7,red,3.33,1.56,30,21,blue
4523371949,5,5,5,0,0,0,0,14712,6.6,16265,174,43,-2908,-1173,17.4,1471.2,5,5,2,2,1,1,1,17620,6.8,17438,240,52,2908,1173,24,1762,red,2,1.4,13,13,red
4521474530,7,11,4,1,1,0,0,16113,6.4,16221,186,46,-1172,-1033,18.6,1611.3,11,7,14,0,0,0,0,17285,6.8,17254,203,28,1172,1033,20.3,1728.5,red,1,3.57,15,18,red
4524384067,4,5,5,1,0,1,0,15157,7,17954,201,55,-1321,-7,20.1,1515.7,5,4,10,0,0,0,0,16478,7,17961,235,47,1321,7,23.5,1647.8,red,1.8,3.75,44,17,red
4436033771,6,6,6,0,0,0,0,16400,7,18543,210,57,-1004,230,21,1640,6,6,7,1,1,0,0,17404,7,18313,225,67,1004,-230,22.5,1740.4,red,2,2.17,79,19,red
4475365709,5,3,6,1,1,0,0,15899,7,18161,225,42,698,101,22.5,1589.9,3,5,2,0,0,0,0,15201,7,18060,221,59,-698,-101,22.1,1520.1,blue,3.67,1,18,41,red
4493010632,7,6,7,1,1,0,0,16874,6.8,16967,225,53,2411,1563,22.5,1687.4,6,7,9,0,0,0,0,14463,6.4,15404,164,35,-2411,-1563,16.4,1446.3,blue,2.33,2.14,21,58,blue
4496759358,5,13,3,0,0,0,0,15305,6.4,16138,209,48,-2615,-800,20.9,1530.5,13,5,11,1,1,0,0,17920,6.6,16938,157,54,2615,800,15.7,1792,red,0.62,4.8,18,15,red
4443048030,7,7,8,0,0,0,0,16401,7.2,18527,189,61,-1979,-771,18.9,1640.1,7,7,5,2,1,1,0,18380,7.2,19298,240,53,1979,771,24,1838,red,2.14,1.71,19,17,red
4509433346,4,5,5,1,1,0,0,15057,6.8,16805,220,39,-1548,-1574,22,1505.7,5,4,4,0,0,0,0,16605,6.8,18379,247,43,1548,1574,24.7,1660.5,blue,1.8,2.25,14,18,blue
4452162573,4,4,6,0,0,0,0,15474,6.6,16611,231,28,331,-1585,23.1,1547.4,4,4,5,1,1,0,0,15143,7.2,18196,216,51,-331,1585,21.6,1514.3,red,2.5,2.25,23,17,blue
4453038156,11,11,7,1,0,1,0,16695,7,18507,157,40,-1505,-635,15.7,1669.5,11,11,9,0,0,0,0,18200,7,19142,188,52,1505,635,18.8,1820,red,1.64,1.82,35,18,blue
4515594785,7,1,11,1,1,0,0,17865,7.4,19102,238,53,3274,1659,23.8,1786.5,1,7,1,0,0,0,0,14591,6.8,17443,240,50,-3274,-1659,24,1459.1,blue,18,0.29,19,13,blue
4524924257,4,9,1,1,0,1,0,14979,6.6,17213,210,52,-3414,-1141,21,1497.9,9,4,11,0,0,0,0,18393,7.2,18354,229,51,3414,1141,22.9,1839.3,red,0.56,5,17,23,red
4516505202,4,4,4,0,0,0,0,15722,6.8,17896,224,51,-470,-187,22.4,1572.2,4,4,3,0,0,0,0,16192,7,18083,242,48,470,187,24.2,1619.2,blue,2,1.75,18,103,blue
4482120064,3,7,3,0,0,0,0,15015,6.8,16974,209,53,-1996,-1804,20.9,1501.5,7,3,13,0,0,0,0,17011,7.2,18778,237,51,1996,1804,23.7,1701.1,red,0.86,6.67,18,21,red
4523758462,10,2,8,0,0,0,0,19733,7.6,20862,263,56,5228,3378,26.3,1973.3,2,10,2,1,1,0,0,14505,6.8,17484,210,64,-5228,-3378,21,1450.5,blue,9,0.4,15,15,blue
4503636905,3,7,3,1,0,1,0,14852,6.8,16888,203,54,-1975,-1345,20.3,1485.2,7,3,6,0,0,0,0,16827,6.8,18233,218,53,1975,1345,21.8,1682.7,red,0.86,4.33,46,31,red
4486384947,5,4,11,0,0,0,0,16282,6.8,17378,213,49,882,512,21.3,1628.2,4,5,3,2,1,1,0,15400,6.6,16866,228,52,-882,-512,22.8,1540,blue,4,1.4,25,22,blue
4457103291,5,9,5,0,0,0,0,14994,7,17924,188,48,-3155,-2773,18.8,1499.4,9,5,9,0,0,0,0,18149,7.4,20697,219,56,3155,2773,21.9,1814.9,red,1.11,3.6,14,16,red
4472164226,11,6,15,1,1,0,0,18606,7.2,19254,214,45,2526,1625,21.4,1860.6,6,11,4,0,0,0,0,16080,7,17629,225,48,-2526,-1625,22.5,1608,blue,4.33,0.91,17,14,blue
4445294621,4,13,5,0,0,0,0,15878,6.8,16945,203,43,-2835,-2821,20.3,1587.8,13,4,14,1,1,0,0,18713,7.2,19766,209,45,2835,2821,20.9,1871.3,red,0.69,6.75,14,18,red
4480384157,4,6,3,0,0,0,0,15773,7,17562,238,56,-1254,-567,23.8,1577.3,6,4,10,1,1,0,0,17027,7,18129,231,60,1254,567,23.1,1702.7,red,1.17,4,19,19,red
4520898233,4,3,4,2,1,1,0,15906,6.8,19219,238,67,406,1283,23.8,1590.6,3,4,3,0,0,0,0,15500,7,17936,220,64,-406,-1283,22,1550,red,2.67,1.5,82,18,red
4522124566,6,9,10,0,0,0,0,16515,6.8,17223,208,45,-1020,493,20.8,1651.5,9,6,13,0,0,0,0,17535,6.6,16730,197,36,1020,-493,19.7,1753.5,blue,1.78,3.67,36,21,red
4523978853,4,8,4,0,0,0,0,15415,6.2,16047,204,44,-2472,-1067,20.4,1541.5,8,4,13,1,1,0,0,17887,7,17114,221,36,2472,1067,22.1,1788.7,red,1,5.25,18,21,red
4507834811,8,6,9,1,1,0,0,17178,7,17854,209,44,1260,-55,20.9,1717.8,6,8,3,0,0,0,0,15918,6.8,17909,233,36,-1260,55,23.3,1591.8,blue,2.83,1.12,19,13,red
4501319968,7,4,9,0,0,0,0,17226,7,18982,228,61,1857,2015,22.8,1722.6,4,7,2,1,1,0,0,15369,6.6,16967,202,49,-1857,-2015,20.2,1536.9,red,4,0.86,22,18,blue
4519148589,8,6,13,1,1,0,0,17474,6.8,17436,217,53,1320,-413,21.7,1747.4,6,8,11,0,0,0,0,16154,6.8,17849,223,40,-1320,413,22.3,1615.4,red,3.5,2.12,110,68,blue
4484877784,3,8,2,1,1,0,0,14905,6.8,17974,233,52,-3282,-1647,23.3,1490.5,8,3,12,0,0,0,0,18187,7.4,19621,225,52,3282,1647,22.5,1818.7,red,0.62,6.67,23,21,red
4466931235,9,4,10,1,1,0,0,18132,7,18076,228,40,2883,2111,22.8,1813.2,4,9,2,0,0,0,0,15249,6.2,15965,227,36,-2883,-2111,22.7,1524.9,blue,4.75,0.67,29,25,blue
4524189570,5,2,6,2,1,1,0,16053,6.8,17406,218,51,1703,1696,21.8,1605.3,2,5,2,0,0,0,0,14350,6.4,15710,206,48,-1703,-1696,20.6,1435,blue,5.5,0.8,21,17,blue
4503380070,6,4,7,0,0,0,0,16438,6.8,16989,203,32,608,-85,20.3,1643.8,4,6,4,1,1,0,0,15830,6.8,17074,206,44,-608,85,20.6,1583,red,3.25,1.33,15,21,red
4497858921,5,4,4,0,0,0,0,15634,6.8,16355,201,45,71,-359,20.1,1563.4,4,5,4,1,1,0,0,15563,6.8,16714,222,38,-71,359,22.2,1556.3,red,2.25,1.6,17,15,blue
4509242024,6,4,4,0,0,0,0,16085,7.4,19076,204,56,275,872,20.4,1608.5,4,6,5,1,1,0,0,15810,7.2,18204,223,62,-275,-872,22.3,1581,blue,2.5,1.5,42,16,red
4524296550,3,4,6,0,0,0,0,14981,6.8,17082,235,52,-809,638,23.5,1498.1,4,3,7,2,1,1,0,15790,6.8,16444,218,50,809,-638,21.8,1579,red,2.25,3.67,27,19,red
4516034199,2,8,2,1,1,0,0,15421,7.2,19276,217,84,-2771,-1125,21.7,1542.1,8,2,5,0,0,0,0,18192,7.4,20401,234,64,2771,1125,23.4,1819.2,red,0.5,6.5,16,16,red
4504386463,5,6,4,1,0,1,0,15665,6.8,17716,203,48,-1730,-1236,20.3,1566.5,6,5,6,1,1,0,0,17395,7,18952,214,67,1730,1236,21.4,1739.5,red,1.5,2.4,22,44,blue
4523799496,7,9,5,1,0,1,0,17528,7.2,19609,234,68,-904,1377,23.4,1752.8,9,7,9,1,1,0,0,18432,7,18232,227,40,904,-1377,22.7,1843.2,red,1.33,2.57,14,19,red
4379931850,3,6,3,1,0,1,0,15032,6.6,16832,213,48,-1683,-1363,21.3,1503.2,6,3,6,1,1,0,0,16715,7,18195,236,44,1683,1363,23.6,1671.5,red,1,4,20,39,red
4523858150,4,11,3,0,0,0,0,15483,6.8,17362,222,48,-3025,-1833,22.2,1548.3,11,4,16,1,1,0,0,18508,7.2,19195,213,39,3025,1833,21.3,1850.8,red,0.64,6.75,31,41,red
4459778854,10,6,12,0,0,0,0,19226,7.4,20118,231,44,3004,2300,23.1,1922.6,6,10,7,0,0,0,0,16222,7,17818,185,39,-3004,-2300,18.5,1622.2,blue,3.67,1.3,37,18,red
4499523222,9,6,14,1,1,0,0,16945,6.8,17806,204,36,1574,761,20.4,1694.5,6,9,6,0,0,0,0,15371,6.8,17045,194,54,-1574,-761,19.4,1537.1,blue,3.83,1.33,21,19,red
4477029310,5,5,3,0,0,0,0,15000,6.6,16493,233,16,-1036,-1423,23.3,1500,5,5,4,0,0,0,0,16036,7,17916,221,44,1036,1423,22.1,1603.6,blue,1.6,1.8,14,20,blue
4525037711,3,4,2,1,0,1,0,15888,7.4,19090,252,60,16,433,25.2,1588.8,4,3,2,1,1,0,0,15872,7,18657,243,49,-16,-433,24.3,1587.2,red,1.25,2,22,43,blue
4459414345,1,10,0,0,0,0,0,12925,6.4,15498,187,32,-6386,-4210,18.7,1292.5,10,1,6,1,0,1,1,19311,7.2,19708,247,56,6386,4210,24.7,1931.1,red,0.1,16,41,13,red
4505664040,11,2,9,0,0,0,0,19250,7.6,19703,251,48,5096,3310,25.1,1925,2,11,2,0,0,0,0,14154,6.4,16393,196,53,-5096,-3310,19.6,1415.4,blue,10,0.36,18,18,blue
4439587692,8,4,5,1,1,0,1,18355,7,18790,218,54,2756,1683,21.8,1835.5,4,8,5,0,0,0,0,15599,6.8,17107,200,57,-2756,-1683,20,1559.9,blue,3.25,1.12,20,18,blue
4508000311,2,3,2,1,0,1,0,13978,6.6,16429,180,44,-977,-1025,18,1397.8,3,2,1,0,0,0,0,14955,6.8,17454,218,56,977,1025,21.8,1495.5,blue,1.33,2,17,16,red
4513365614,5,5,8,0,0,0,0,15851,6.8,17366,206,56,-808,-1655,20.6,1585.1,5,5,6,0,0,0,0,16659,7.2,19021,241,44,808,1655,24.1,1665.9,red,2.6,2.2,17,44,red
4473252742,7,9,5,0,0,0,0,16474,6.6,17408,209,50,-1559,-407,20.9,1647.4,9,7,13,1,1,0,0,18033,6.8,17815,206,53,1559,407,20.6,1803.3,red,1.33,3.14,14,26,red
4438138890,6,8,6,0,0,0,0,16590,7,18284,213,49,544,75,21.3,1659,8,6,7,0,0,0,0,16046,7,18209,182,44,-544,-75,18.2,1604.6,blue,1.5,2.5,18,13,red
4467008289,5,2,2,2,1,1,0,15737,7,18634,217,53,1381,1017,21.7,1573.7,2,5,1,0,0,0,0,14356,7,17617,212,60,-1381,-1017,21.2,1435.6,blue,3.5,0.6,26,19,blue
4492625917,5,3,5,0,0,0,0,16990,7.4,19634,248,54,2031,1449,24.8,1699,3,5,5,1,1,0,0,14959,7,18185,210,68,-2031,-1449,21,1495.9,blue,3.33,1.6,39,16,blue
4502901044,3,3,2,1,1,0,0,15297,7,19210,246,56,131,370,24.6,1529.7,3,3,1,0,0,0,0,15166,7.2,18840,227,64,-131,-370,22.7,1516.6,red,1.67,1.33,18,22,red
4467732013,4,10,4,1,0,1,0,15651,7,17696,224,53,-2699,-2749,22.4,1565.1,10,4,11,1,1,0,0,18350,7.4,20445,201,54,2699,2749,20.1,1835,red,0.8,5.25,18,32,red
4514402510,5,7,7,1,1,0,0,15587,6.8,16746,181,63,-1672,-2698,18.1,1558.7,7,5,6,0,0,0,0,17259,7.4,19444,218,76,1672,2698,21.8,1725.9,red,1.71,2.6,17,14,blue
4521277262,10,6,11,1,1,0,0,17777,7.2,18131,213,42,1201,316,21.3,1777.7,6,10,5,0,0,0,0,16576,6.8,17815,234,44,-1201,-316,23.4,1657.6,blue,3.5,1.1,22,22,blue
4521752962,7,5,5,2,1,1,0,16426,7,18407,222,55,-108,59,22.2,1642.6,5,7,4,0,0,0,0,16534,6.8,18348,247,44,108,-59,24.7,1653.4,blue,2.4,1.29,32,18,blue
4514070165,10,7,11,0,0,0,1,20278,7.2,19575,236,58,4633,2269,23.6,2027.8,7,10,6,1,1,0,0,15645,6.6,17306,182,45,-4633,-2269,18.2,1564.5,red,3,1.3,12,21,red
4525056568,2,7,0,0,0,0,0,13791,6.6,16437,191,62,-2262,-1391,19.1,1379.1,7,2,4,1,1,0,0,16053,6.8,17828,218,48,2262,1391,21.8,1605.3,red,0.29,5.5,22,21,red
4521255103,6,7,5,0,0,0,0,16505,7,17667,208,70,-49,500,20.8,1650.5,7,6,10,1,1,0,0,16554,6.8,17167,207,45,49,-500,20.7,1655.4,red,1.57,2.83,27,19,red
4510728488,6,4,4,1,1,0,0,17277,7.2,19610,229,54,1687,1089,22.9,1727.7,4,6,5,1,0,1,0,15590,7.2,18521,232,56,-1687,-1089,23.2,1559,blue,2.5,1.5,20,39,blue
4516919746,9,1,10,2,1,1,0,18269,7.2,19659,229,68,3933,2922,22.9,1826.9,1,9,1,0,0,0,0,14336,6.4,16737,233,40,-3933,-2922,23.3,1433.6,blue,19,0.22,125,17,blue
4499868617,4,10,3,1,1,0,0,14166,6.6,15959,203,41,-4061,-4397,20.3,1416.6,10,4,6,0,0,0,0,18227,7.4,20356,224,72,4061,4397,22.4,1822.7,red,0.7,4,16,18,red
4514234813,6,12,7,0,0,0,0,15456,6.6,16280,188,42,-4920,-3280,18.8,1545.6,12,6,11,1,0,1,1,20376,7.4,19560,240,62,4920,3280,24,2037.6,red,1.08,3.83,54,16,red
4513591449,4,5,2,0,0,0,0,15180,7,17773,210,52,-1705,-1839,21,1518,5,4,1,0,0,0,0,16885,7.2,19612,227,62,1705,1839,22.7,1688.5,red,1.2,1.5,21,15,red
4471416203,7,8,8,1,1,0,0,16179,6.8,16814,212,46,105,-1547,21.2,1617.9,8,7,5,1,0,1,0,16074,7,18361,200,42,-105,1547,20,1607.4,red,1.88,1.86,36,29,blue
4521227315,3,5,3,0,0,0,0,16026,7,18490,233,57,-554,521,23.3,1602.6,5,3,6,1,1,0,0,16580,6.8,17969,234,44,554,-521,23.4,1658,blue,1.2,3.67,14,12,red
4424144387,4,5,4,0,0,0,0,14850,6.8,17145,198,53,-1037,-1577,19.8,1485,5,4,5,1,1,0,0,15887,7,18722,241,44,1037,1577,24.1,1588.7,red,1.6,2.5,24,22,blue
4517806218,9,8,7,1,0,1,0,17347,7,18573,202,62,-1144,480,20.2,1734.7,8,9,11,1,1,0,1,18491,7,18093,199,45,1144,-480,19.9,1849.1,red,2,2.11,18,18,blue
4479974478,5,4,6,0,0,0,0,15887,6.8,17591,200,32,1173,953,20,1588.7,4,5,3,1,1,0,0,14714,6.6,16638,186,63,-1173,-953,18.6,1471.4,blue,2.75,1.4,36,13,blue
4423018162,8,2,11,0,0,0,0,17399,7,19449,232,44,3194,2534,23.2,1739.9,2,8,2,1,1,0,0,14205,6.6,16915,208,51,-3194,-2534,20.8,1420.5,red,9.5,0.5,20,16,blue
4518401885,2,7,1,1,1,0,0,13828,6.6,16629,204,38,-2622,-1136,20.4,1382.8,7,2,7,0,0,0,0,16450,6.8,17765,192,36,2622,1136,19.2,1645,red,0.43,7,16,12,blue
4525208730,6,4,4,1,1,0,0,16645,7.2,19110,242,52,1151,470,24.2,1664.5,4,6,3,1,0,1,0,15494,7,18640,205,50,-1151,-470,20.5,1549.4,blue,2.5,1.17,18,17,blue
4512774492,6,4,8,2,1,1,0,16248,6.8,17200,200,52,1463,1490,20,1624.8,4,6,8,0,0,0,0,14785,6.6,15710,169,52,-1463,-1490,16.9,1478.5,blue,3.5,2,54,50,blue
4522772001,4,6,1,0,0,0,0,15310,7,18337,221,52,-1038,-1307,22.1,1531,6,4,5,2,1,1,0,16348,7.2,19644,226,66,1038,1307,22.6,1634.8,red,0.83,2.75,16,17,red
4464439713,8,4,7,1,0,1,0,16784,6.6,17242,212,40,1424,1060,21.2,1678.4,4,8,5,0,0,0,0,15360,6.4,16182,180,61,-1424,-1060,18,1536,blue,3.75,1.12,19,17,blue
4479823004,13,9,18,1,1,0,0,19032,7.4,18951,232,44,527,721,23.2,1903.2,9,13,5,0,0,0,0,18505,7,18230,216,63,-527,-721,21.6,1850.5,blue,3.44,1.08,19,16,red
4507330276,7,6,12,0,0,0,0,17518,7.2,18342,242,46,1807,932,24.2,1751.8,6,7,9,2,1,1,0,15711,6.8,17410,198,60,-1807,-932,19.8,1571.1,red,3.17,2.14,22,56,red
4447392049,11,4,12,1,0,1,0,18976,7.4,20326,256,43,2856,1262,25.6,1897.6,4,11,6,1,1,0,0,16120,7.2,19064,210,72,-2856,-1262,21,1612,red,5.75,0.91,49,16,blue
4521089901,6,6,10,1,1,0,0,16143,6.6,16617,204,56,-964,-2454,20.4,1614.3,6,6,3,1,0,1,0,17107,7,19071,241,56,964,2454,24.1,1710.7,red,2.67,1.5,13,14,red
4427944005,7,8,6,1,0,1,0,15868,7,17111,199,51,-178,524,19.9,1586.8,8,7,6,1,1,0,0,16046,6.8,16587,178,47,178,-524,17.8,1604.6,red,1.62,2,22,49,red
4509784380,9,8,7,1,1,0,0,17977,7,18162,235,41,705,192,23.5,1797.7,8,9,8,0,0,0,0,17272,7,17970,207,44,-705,-192,20.7,1727.2,blue,2,1.78,21,16,red
4524411421,10,10,14,1,1,0,0,18138,7,18159,208,55,908,306,20.8,1813.8,10,10,16,0,0,0,0,17230,7,17853,210,44,-908,-306,21,1723,blue,2.4,2.6,16,16,red
4519898107,7,2,12,2,1,1,0,18025,7.2,19864,261,68,3558,3243,26.1,1802.5,2,7,3,0,0,0,0,14467,6.8,16621,220,56,-3558,-3243,22,1446.7,blue,9.5,0.71,16,25,red
4517633575,1,6,0,0,0,0,0,14625,6.8,17769,241,56,-1299,-49,24.1,1462.5,6,1,3,1,1,0,0,15924,7,17818,218,47,1299,49,21.8,1592.4,red,0.17,9,18,54,red
4521948875,5,8,7,1,1,0,0,15752,6.6,17113,201,48,-1763,-1864,20.1,1575.2,8,5,6,0,0,0,0,17515,7.2,18977,248,40,1763,1864,24.8,1751.5,blue,1.5,2.8,20,21,red
4509102299,10,4,12,0,0,0,0,18480,7.4,19565,232,64,2547,2189,23.2,1848,4,10,4,0,0,0,0,15933,6.6,17376,247,41,-2547,-2189,24.7,1593.3,blue,5.5,0.8,15,13,red
4525041896,3,10,2,1,1,0,0,14995,6.6,16206,210,53,-3685,-3119,21,1499.5,10,3,13,1,0,1,0,18680,7.4,19325,200,67,3685,3119,20,1868,red,0.5,7.67,16,23,red
4515706467,7,11,3,0,0,0,0,15655,6.4,15827,194,25,-3689,-4682,19.4,1565.5,11,7,7,1,1,0,0,19344,7.2,20509,216,59,3689,4682,21.6,1934.4,red,0.91,2.57,96,37,blue
4476006621,3,5,2,0,0,0,0,15562,7.2,18590,236,73,-764,803,23.6,1556.2,5,3,6,2,1,1,0,16326,6.8,17787,233,46,764,-803,23.3,1632.6,red,1,3.67,21,37,blue
4499940691,9,2,5,0,0,0,0,17139,7.2,19137,223,51,3037,2694,22.3,1713.9,2,9,2,1,1,0,0,14102,6.6,16443,213,41,-3037,-2694,21.3,1410.2,blue,7,0.44,19,16,blue
4426644547,7,7,6,0,0,0,1,19229,7.2,18820,257,62,3545,2162,25.7,1922.9,7,7,10,1,1,0,0,15684,6.6,16658,145,36,-3545,-2162,14.5,1568.4,blue,1.86,2.43,18,22,blue
4525072812,7,7,10,1,1,0,0,16972,7.2,19060,209,48,-1031,-394,20.9,1697.2,7,7,7,0,0,0,0,18003,7.4,19454,255,60,1031,394,25.5,1800.3,red,2.43,2,16,20,red
4524217548,5,10,6,0,0,0,0,16249,7,18383,213,59,-1796,-749,21.3,1624.9,10,5,15,1,1,0,0,18045,7,19132,214,44,1796,749,21.4,1804.5,red,1.1,5,18,18,red
4499622849,5,4,9,0,0,0,0,16415,6.8,17645,247,37,1626,747,24.7,1641.5,4,5,5,1,1,0,0,14789,7,16898,203,51,-1626,-747,20.3,1478.9,blue,3.5,1.8,22,19,blue
4499844894,6,8,10,1,0,1,0,18012,7.2,19837,250,70,832,1330,25,1801.2,8,6,11,1,1,0,0,17180,7,18507,186,48,-832,-1330,18.6,1718,blue,2,3.17,41,13,red
4460534353,11,6,11,2,1,1,0,19294,7.4,20668,242,52,2750,2647,24.2,1929.4,6,11,9,0,0,0,0,16544,7,18021,203,52,-2750,-2647,20.3,1654.4,blue,3.67,1.36,16,16,red
4495269641,5,8,4,1,0,1,0,15383,6.8,17243,227,28,-1524,-827,22.7,1538.3,8,5,11,0,0,0,0,16907,7,18070,186,39,1524,827,18.6,1690.7,red,1.12,3.8,17,14,red
4524995677,6,8,2,1,1,0,0,15777,6.6,17401,224,53,-1370,-875,22.4,1577.7,8,6,9,0,0,0,0,17147,7,18276,210,36,1370,875,21,1714.7,red,1,2.83,20,22,blue
4464596479,4,6,4,0,0,0,0,14805,6.6,17323,209,43,-1506,-412,20.9,1480.5,6,4,7,1,1,0,0,16311,7,17735,231,44,1506,412,23.1,1631.1,red,1.33,3.25,17,20,red
4452452649,6,7,2,0,0,0,0,15244,6.6,16787,199,52,-1101,-718,19.9,1524.4,7,6,5,2,1,1,0,16345,7,17505,212,40,1101,718,21.2,1634.5,red,1.14,2,18,21,red
4420481816,8,3,7,1,0,1,0,17574,7.2,19195,252,44,2774,2207,25.2,1757.4,3,8,2,1,1,0,0,14800,6.6,16988,225,47,-2774,-2207,22.5,1480,red,5,0.62,22,19,red
4412895789,8,11,9,0,0,0,0,16655,7,17831,222,44,-1806,-588,22.2,1665.5,11,8,13,2,1,1,0,18461,7,18419,215,55,1806,588,21.5,1846.1,red,1.55,3,24,16,red
4525114135,6,4,8,1,1,0,0,16855,7,18370,248,44,1265,1248,24.8,1685.5,4,6,4,1,0,1,0,15590,6.8,17122,207,52,-1265,-1248,20.7,1559,red,3.5,1.33,17,21,red
4496624699,6,14,4,0,0,0,0,15786,6.6,16995,200,46,-4443,-4140,20,1578.6,14,6,9,1,1,0,0,20229,7.6,21135,227,66,4443,4140,22.7,2022.9,blue,0.71,3.83,20,19,red
4522663961,3,5,1,0,0,0,0,15143,7.2,19080,233,59,-927,967,23.3,1514.3,5,3,7,1,1,0,0,16070,7,18113,216,48,927,-967,21.6,1607,red,0.8,4,22,20,red
4522251387,9,5,9,0,0,0,0,17309,7,18904,221,36,1425,728,22.1,1730.9,5,9,3,2,1,1,0,15884,6.8,18176,208,44,-1425,-728,20.8,1588.4,blue,3.6,0.89,15,16,blue
4472377536,6,4,6,1,1,0,0,16416,7.4,19684,211,60,1177,1161,21.1,1641.6,4,6,2,0,0,0,0,15239,7,18523,204,71,-1177,-1161,20.4,1523.9,blue,3,1,17,14,red
4466226469,2,7,2,1,1,0,0,15222,7,17812,231,64,-1586,410,23.1,1522.2,7,2,14,1,0,1,0,16808,6.8,17402,211,64,1586,-410,21.1,1680.8,blue,0.57,10.5,21,22,blue
4473936532,5,10,3,2,1,1,0,15526,6.8,17629,232,44,-2896,-2081,23.2,1552.6,10,5,6,0,0,0,0,18422,7.4,19710,236,76,2896,2081,23.6,1842.2,red,0.8,3.2,18,17,red
4524445302,12,9,10,0,0,0,0,17597,6.4,15938,143,48,905,1054,14.3,1759.7,9,12,9,0,0,0,0,16692,6.2,14884,181,40,-905,-1054,18.1,1669.2,blue,2.44,1.5,19,15,red
4459740551,9,17,17,0,0,0,0,16834,6.2,14815,187,29,-3887,-3392,18.7,1683.4,17,9,21,0,0,0,0,20721,7,18207,211,40,3887,3392,21.1,2072.1,red,1.53,4.22,18,32,blue
4463542711,12,6,12,1,1,0,0,19058,7.2,19575,202,47,3413,2984,20.2,1905.8,6,12,7,0,0,0,0,15645,6.6,16591,210,39,-3413,-2984,21,1564.5,blue,4,1.08,34,18,blue
4508629003,7,9,5,2,1,1,0,16806,7,18034,228,48,-256,-1580,22.8,1680.6,9,7,7,0,0,0,0,17062,7.4,19614,230,52,256,1580,23,1706.2,red,1.33,2.29,18,36,blue
4475094281,7,10,7,0,0,0,0,16643,6.8,17554,227,44,-1820,-1412,22.7,1664.3,10,7,11,0,0,0,0,18463,7.2,18966,231,45,1820,1412,23.1,1846.3,blue,1.4,3,24,24,blue
4513430767,6,4,12,1,1,0,0,16189,6.8,17737,224,39,625,-534,22.4,1618.9,4,6,4,0,0,0,0,15564,7,18271,217,48,-625,534,21.7,1556.4,blue,4.5,1.33,15,103,blue
4508634893,2,6,1,0,0,0,0,14095,6.8,17286,196,60,-3628,-2009,19.6,1409.5,6,2,4,1,1,0,0,17723,7,19295,266,60,3628,2009,26.6,1772.3,red,0.5,5,14,16,red
4522792360,5,5,7,1,0,1,0,16804,6.8,17544,217,67,769,480,21.7,1680.4,5,5,6,1,1,0,0,16035,6.4,17064,233,54,-769,-480,23.3,1603.5,red,2.4,2.2,36,20,blue
4507927084,8,8,8,1,1,0,0,17305,7,18192,229,43,-576,-682,22.9,1730.5,8,8,6,1,0,1,0,17881,7,18874,198,66,576,682,19.8,1788.1,red,2,1.75,23,21,red
4522505411,3,9,2,0,0,0,0,14539,6.4,16806,213,40,-3900,-3550,21.3,1453.9,9,3,8,1,1,0,0,18439,7.6,20356,255,51,3900,3550,25.5,1843.9,red,0.56,5.67,30,44,red
4454104215,9,8,10,1,1,0,0,17530,7,18299,192,43,-7,-231,19.2,1753,8,9,8,1,0,1,0,17537,7.2,18530,209,60,7,231,20.9,1753.7,blue,2.38,1.78,16,21,red
4516166112,10,7,10,0,0,0,0,18431,7.2,19562,207,44,1683,1433,20.7,1843.1,7,10,5,1,1,0,0,16748,7,18129,231,56,-1683,-1433,23.1,1674.8,blue,2.86,1.2,19,17,blue
4454239214,3,10,2,0,0,0,0,14032,6.8,16550,193,40,-4782,-3408,19.3,1403.2,10,3,11,1,1,0,0,18814,7.4,19958,245,51,4782,3408,24.5,1881.4,red,0.5,7,20,25,red
4517801069,9,7,11,1,1,0,0,17869,7,17810,205,40,636,-214,20.5,1786.9,7,9,9,0,0,0,0,17233,6.8,18024,215,48,-636,214,21.5,1723.3,blue,2.86,1.78,41,15,blue
4518738712,7,14,6,1,1,0,0,15974,6.2,16174,183,37,-3421,-2624,18.3,1597.4,14,7,12,0,0,0,0,19395,7.2,18798,219,49,3421,2624,21.9,1939.5,blue,0.93,3.71,41,17,red
4497571086,5,3,6,1,1,0,0,16108,7.2,18920,240,61,976,1599,24,1610.8,3,5,5,0,0,0,0,15132,6.8,17321,230,42,-976,-1599,23,1513.2,blue,3.67,1.6,23,42,red
4477243448,6,7,6,0,0,0,0,16302,6.8,17297,212,52,-211,-1305,21.2,1630.2,7,6,7,1,0,1,0,16513,7.2,18602,211,46,211,1305,21.1,1651.3,red,1.71,2.33,43,21,red
4386507847,7,5,6,0,0,0,0,16750,6.8,17603,215,52,1221,462,21.5,1675,5,7,5,0,0,0,0,15529,6.8,17141,197,48,-1221,-462,19.7,1552.9,blue,2.6,1.43,23,38,red
4474136526,7,1,8,0,0,0,0,16506,7.2,18669,226,36,2037,1291,22.6,1650.6,1,7,0,1,1,0,0,14469,6.6,17378,217,80,-2037,-1291,21.7,1446.9,blue,15,0.14,22,38,red
4523618632,6,3,11,1,1,0,0,16389,7,17937,241,36,817,-94,24.1,1638.9,3,6,3,0,0,0,0,15572,6.8,18031,229,58,-817,94,22.9,1557.2,blue,5.67,1,20,40,blue
4507859079,4,4,4,0,0,0,0,15760,7,18295,215,48,-137,-351,21.5,1576,4,4,1,1,1,0,0,15897,7,18646,227,72,137,351,22.7,1589.7,blue,2,1.25,20,16,blue
4524740998,4,7,4,1,1,0,0,15176,6.4,16820,226,33,-1539,-1497,22.6,1517.6,7,4,12,0,0,0,0,16715,7.2,18317,205,52,1539,1497,20.5,1671.5,blue,1.14,4.75,49,32,blue
4512162103,5,7,4,0,0,0,0,15196,6.4,16908,191,48,-1707,-1286,19.1,1519.6,7,5,10,1,1,0,0,16903,7,18194,216,51,1707,1286,21.6,1690.3,red,1.29,3.4,18,65,red
4465066223,6,9,2,1,1,0,0,16250,7,17537,228,55,-556,-235,22.8,1625,9,6,13,0,0,0,0,16806,6.8,17772,143,60,556,235,14.3,1680.6,blue,0.89,3.67,14,18,red
4523411488,9,7,15,1,1,0,0,16541,6.6,16779,199,37,-146,-717,19.9,1654.1,7,9,8,1,0,1,0,16687,6.8,17496,225,44,146,717,22.5,1668.7,blue,3.43,1.67,21,15,blue
4524017392,12,4,9,1,0,1,0,18657,7.2,19205,227,37,4083,2884,22.7,1865.7,4,12,1,1,1,0,0,14574,6.6,16321,191,52,-4083,-2884,19.1,1457.4,blue,5.25,0.42,16,17,blue
4513054107,5,5,6,0,0,0,0,16873,7.2,19105,223,64,1389,1418,22.3,1687.3,5,5,7,1,1,0,0,15484,6.8,17687,226,49,-1389,-1418,22.6,1548.4,blue,2.2,2.4,18,40,red
4478629184,3,4,3,1,1,0,0,14383,6.4,15898,211,55,-890,-528,21.1,1438.3,4,3,5,1,0,1,0,15273,6.4,16426,208,44,890,528,20.8,1527.3,red,1.5,3,32,18,red
4395598976,4,9,5,0,0,0,0,14420,6.4,15196,192,32,-2519,-1095,19.2,1442,9,4,15,0,0,0,0,16939,6.4,16291,194,46,2519,1095,19.4,1693.9,red,1,6,15,21,blue
4524952056,4,15,4,0,0,0,0,14720,6.2,15031,183,30,-4440,-4020,18.3,1472,15,4,14,0,0,0,0,19160,7.4,19051,201,51,4440,4020,20.1,1916,red,0.53,7.25,88,11,red
4453994009,7,6,7,0,0,0,0,17406,7.2,19761,251,64,1140,705,25.1,1740.6,6,7,4,2,1,1,0,16266,7.2,19056,190,56,-1140,-705,19,1626.6,blue,2.33,1.43,18,18,blue
4462358723,5,7,2,0,0,0,0,15210,6.4,15974,172,40,-1656,-1832,17.2,1521,7,5,3,0,0,0,0,16866,6.8,17806,219,51,1656,1832,21.9,1686.6,red,1,2,19,18,blue
4512811324,10,5,16,0,0,0,0,17272,6.4,15840,192,40,2171,-261,19.2,1727.2,5,10,6,2,1,1,0,15101,6.6,16101,199,40,-2171,261,19.9,1510.1,blue,5.2,1.1,26,39,red
4438263187,12,4,15,0,0,0,0,19358,7.2,19257,206,60,3841,2484,20.6,1935.8,4,12,3,0,0,0,0,15517,6.8,16773,216,56,-3841,-2484,21.6,1551.7,blue,6.75,0.58,19,16,blue
4483907436,4,11,5,1,0,1,1,16855,6.6,16360,232,40,-885,-2172,23.2,1685.5,11,4,15,1,1,0,0,17740,7.2,18532,216,36,885,2172,21.6,1774,blue,0.82,6.5,19,38,red
4521937261,3,8,4,2,1,1,0,15209,6.6,16256,191,60,-2752,-2286,19.1,1520.9,8,3,9,0,0,0,0,17961,7.2,18542,241,52,2752,2286,24.1,1796.1,red,0.88,5.67,18,21,red
4515587675,13,9,22,0,0,0,0,19542,7,17935,207,31,2081,466,20.7,1954.2,9,13,11,0,0,0,0,17461,7,17469,200,44,-2081,-466,20,1746.1,blue,3.89,1.54,20,21,blue
4517493567,4,3,4,0,0,0,0,15267,6.6,17321,232,53,453,-19,23.2,1526.7,3,4,3,0,0,0,0,14814,6.8,17340,209,51,-453,19,20.9,1481.4,red,2.67,1.5,20,18,blue
4469549199,3,1,3,1,1,0,0,15243,6.6,17194,224,56,830,-1002,22.4,1524.3,1,3,1,1,0,1,0,14413,6.8,18196,220,56,-830,1002,22,1441.3,red,6,0.67,17,44,blue
4500100836,8,8,3,0,0,0,0,16214,6.8,17234,203,48,94,-445,20.3,1621.4,8,8,6,0,0,0,0,16120,7,17679,168,48,-94,445,16.8,1612,red,1.38,1.75,23,21,red
4451727242,8,6,12,2,1,1,0,15976,7,18227,178,56,-722,891,17.8,1597.6,6,8,6,0,0,0,0,16698,6.6,17336,232,39,722,-891,23.2,1669.8,red,3.33,1.5,72,14,red
4462194525,6,7,10,1,0,1,0,16557,6.8,17632,230,47,-1491,-799,23,1655.7,7,6,11,1,1,0,0,18048,7,18431,222,53,1491,799,22.2,1804.8,red,2.29,3,19,43,red
4481415061,6,14,3,0,0,0,0,16142,6.8,16953,198,59,-3109,-1745,19.8,1614.2,14,6,16,2,1,1,0,19251,7,18698,201,37,3109,1745,20.1,1925.1,red,0.64,5,11,14,red
4519169394,7,11,9,0,0,0,0,17984,7.2,18708,230,56,537,-477,23,1798.4,11,7,11,1,1,0,0,17447,7.2,19185,178,51,-537,477,17.8,1744.7,red,1.45,3.14,19,20,blue
4449504375,13,5,10,2,1,1,0,20038,7.8,21588,222,71,4079,5568,22.2,2003.8,5,13,6,0,0,0,0,15959,6.6,16020,208,40,-4079,-5568,20.8,1595.9,blue,4.6,0.85,24,40,red
4468503240,10,5,13,0,0,0,1,19571,7.2,18463,213,50,4006,2081,21.3,1957.1,5,10,6,0,0,0,0,15565,6.6,16382,210,47,-4006,-2081,21,1556.5,blue,4.6,1.1,94,18,red
4495708706,3,10,4,0,0,0,0,14557,6.4,15128,200,48,-3582,-5395,20,1455.7,10,3,10,2,1,1,0,18139,7.6,20523,246,63,3582,5395,24.6,1813.9,red,0.7,6.67,20,16,blue
4505357300,6,6,5,0,0,0,0,16029,7,18567,205,56,-355,233,20.5,1602.9,6,6,5,1,1,0,0,16384,7,18334,224,48,355,-233,22.4,1638.4,blue,1.83,1.83,20,22,red
4523723534,7,6,8,0,0,0,1,18053,6.6,16741,207,46,3464,994,20.7,1805.3,6,7,6,0,0,0,0,14589,6.4,15747,178,22,-3464,-994,17.8,1458.9,blue,2.5,1.71,29,42,blue
4479157446,9,5,9,1,1,0,0,18098,7,18905,225,60,2217,2183,22.5,1809.8,5,9,3,1,0,1,0,15881,6.6,16722,229,32,-2217,-2183,22.9,1588.1,blue,3.6,0.89,18,13,blue
4518376722,8,3,9,2,1,1,0,18343,7.2,19519,235,59,3049,1511,23.5,1834.3,3,8,2,0,0,0,0,15294,7,18008,234,54,-3049,-1511,23.4,1529.4,blue,5.67,0.62,14,16,blue
4521259209,5,6,4,1,1,0,0,15596,7,17998,198,44,-305,-474,19.8,1559.6,6,5,7,0,0,0,0,15901,7,18472,199,40,305,474,19.9,1590.1,blue,1.5,2.6,15,27,red
4471123041,4,2,6,1,1,0,0,15812,7,17882,229,53,1325,479,22.9,1581.2,2,4,1,1,0,1,0,14487,7,17403,218,54,-1325,-479,21.8,1448.7,red,5,0.75,57,18,red
4524913184,6,6,10,0,0,0,0,15947,6.4,16477,221,44,-53,87,22.1,1594.7,6,6,9,1,1,0,0,16000,6.4,16390,203,52,53,-87,20.3,1600,blue,2.67,2.5,19,18,blue
4514301047,5,9,5,0,0,0,0,14997,6.6,16532,196,40,-2865,-1441,19.6,1499.7,9,5,7,1,1,0,0,17862,6.8,17973,237,32,2865,1441,23.7,1786.2,red,1.11,3.2,36,20,red
4512184541,7,7,5,0,0,0,0,16463,6.8,17576,215,42,-93,-561,21.5,1646.3,7,7,8,1,1,0,0,16556,7,18137,217,40,93,561,21.7,1655.6,red,1.71,2.14,11,33,blue
4517823800,6,7,7,0,0,0,0,16072,6.6,17054,225,46,-420,-1185,22.5,1607.2,7,6,10,1,1,0,0,16492,7.2,18239,212,50,420,1185,21.2,1649.2,red,1.86,2.83,24,18,blue
4518835789,7,3,6,1,1,0,0,19140,7.4,19579,253,64,5008,2355,25.3,1914,3,7,3,1,0,1,0,14132,6.8,17224,179,45,-5008,-2355,17.9,1413.2,blue,4.33,0.86,28,66,blue
4510355472,4,6,1,0,0,0,0,14547,6.4,15883,188,53,-2074,-1795,18.8,1454.7,6,4,5,2,1,1,0,16621,6.8,17678,196,56,2074,1795,19.6,1662.1,red,0.83,2.75,21,22,blue
4512067346,5,4,7,1,0,1,0,15644,6.8,17717,188,63,-3,1013,18.8,1564.4,4,5,7,0,0,0,0,15647,6.6,16704,190,48,3,-1013,19,1564.7,blue,3,2.2,19,23,red
4514106633,5,5,5,0,0,0,0,15734,7,17911,213,47,-837,-660,21.3,1573.4,5,5,7,2,1,1,0,16571,7,18571,249,47,837,660,24.9,1657.1,red,2,2.4,17,24,blue
4522399054,5,5,6,1,1,0,0,16794,6.8,17320,229,39,510,-747,22.9,1679.4,5,5,6,1,0,1,0,16284,7.2,18067,216,55,-510,747,21.6,1628.4,blue,2.2,2.2,40,41,blue
4519443312,6,11,8,1,1,0,0,15930,6.8,17257,200,43,-3549,-2407,20,1593,11,6,12,0,0,0,0,19479,7.4,19664,214,60,3549,2407,21.4,1947.9,red,1.27,3.83,19,18,red
4523035934,6,6,6,0,0,0,0,16936,7.2,18646,240,56,272,359,24,1693.6,6,6,7,1,1,0,0,16664,6.8,18287,199,68,-272,-359,19.9,1666.4,blue,2,2.17,21,58,red
4429486916,9,5,9,0,0,0,0,17941,7.2,19379,230,51,2187,2189,23,1794.1,5,9,5,0,0,0,0,15754,7,17190,206,52,-2187,-2189,20.6,1575.4,blue,3.6,1.11,20,48,blue
4482052361,2,8,4,0,0,0,0,13698,6.2,15671,222,33,-4907,-2556,22.2,1369.8,8,2,11,1,0,1,1,18605,7,18227,242,40,4907,2556,24.2,1860.5,red,0.75,9.5,25,25,red
4522798631,5,4,3,1,1,0,0,15943,7.4,19262,238,64,63,648,23.8,1594.3,4,5,5,0,0,0,0,15880,7,18614,210,64,-63,-648,21,1588,blue,2,1.8,17,17,blue
4477176627,4,8,6,1,0,1,0,15891,7,18304,222,68,-2132,-484,22.2,1589.1,8,4,13,1,1,0,0,18023,7,18788,230,47,2132,484,23,1802.3,blue,1.25,5.25,17,17,red
4475170098,5,6,5,1,0,1,0,16216,7,19002,211,71,-976,-964,21.1,1621.6,6,5,8,1,1,0,0,17192,7.6,19966,222,69,976,964,22.2,1719.2,red,1.67,2.8,16,17,red
4432091797,3,5,3,0,0,0,0,14754,6.6,17158,186,62,-1342,-1966,18.6,1475.4,5,3,6,1,1,0,0,16096,7.2,19124,218,54,1342,1966,21.8,1609.6,red,1.2,3.67,90,42,blue
4495710198,8,2,5,1,1,0,0,16909,7.2,18318,229,40,2304,2532,22.9,1690.9,2,8,2,0,0,0,0,14605,6.2,15786,208,44,-2304,-2532,20.8,1460.5,blue,6.5,0.5,17,17,blue
4520931258,10,2,11,0,0,0,0,18858,7.2,19691,218,70,4219,3379,21.8,1885.8,2,10,1,1,1,0,0,14639,6.6,16312,219,56,-4219,-3379,21.9,1463.9,blue,10.5,0.3,21,86,red
4424048842,6,7,7,0,0,0,0,15952,6.8,17112,180,45,-2049,-2340,18,1595.2,7,6,9,0,0,0,0,18001,7.2,19452,243,46,2049,2340,24.3,1800.1,red,1.86,2.67,29,52,blue
4512915759,1,5,2,0,0,0,0,13286,6.2,15085,187,48,-4179,-3823,18.7,1328.6,5,1,4,1,1,0,0,17465,7,18908,236,67,4179,3823,23.6,1746.5,red,0.6,9,20,24,red
4476065129,6,6,9,0,0,0,0,16812,7.2,18466,269,40,-66,-1073,26.9,1681.2,6,6,3,1,1,0,0,16878,7,19539,245,56,66,1073,24.5,1687.8,red,2.5,1.5,24,24,red
4494781192,9,7,13,2,1,1,0,17906,6.8,18001,178,60,510,142,17.8,1790.6,7,9,4,0,0,0,0,17396,6.8,17859,215,56,-510,-142,21.5,1739.6,blue,3.14,1.22,19,15,red
4525224702,4,3,2,1,0,1,0,16408,7.2,19181,263,53,2591,1567,26.3,1640.8,3,4,1,1,1,0,0,13817,6.8,17614,208,35,-2591,-1567,20.8,1381.7,red,2,1,18,17,blue
4475925954,4,12,5,0,0,0,0,15056,6.4,16369,198,46,-3772,-3034,19.8,1505.6,12,4,20,1,1,0,1,18828,7.4,19403,177,53,3772,3034,17.7,1882.8,red,0.75,8,15,14,blue
4516121686,6,6,11,1,1,0,0,17831,6.8,18269,240,43,965,-878,24,1783.1,6,6,7,0,0,0,0,16866,7,19147,233,51,-965,878,23.3,1686.6,red,2.83,2.17,26,19,blue
4420667626,1,5,1,0,0,0,0,13738,6.6,16678,223,34,-3468,-2158,22.3,1373.8,5,1,7,2,1,1,0,17206,7.4,18836,259,70,3468,2158,25.9,1720.6,red,0.4,12,12,16,red
4489494110,14,3,15,0,0,0,0,20317,7.4,20330,212,54,6153,3916,21.2,2031.7,3,14,4,0,0,0,0,14164,6.4,16414,196,45,-6153,-3916,19.6,1416.4,blue,9.67,0.5,30,17,blue
4523340688,0,5,0,0,0,0,0,14091,6.4,16184,233,60,-2216,-2730,23.3,1409.1,5,0,8,1,1,0,0,16307,7,18914,229,60,2216,2730,22.9,1630.7,red,0,12.65,15,58,red
4496344135,6,11,4,1,1,0,0,16036,6.6,16916,191,39,-2308,-1767,19.1,1603.6,11,6,14,0,0,0,0,18344,7.2,18683,206,28,2308,1767,20.6,1834.4,red,0.91,4.17,21,25,red
4524697287,6,6,5,1,0,1,0,17052,6.6,17392,210,54,1917,-179,21,1705.2,6,6,3,1,1,0,0,15135,7,17571,194,51,-1917,179,19.4,1513.5,blue,1.83,1.5,21,16,blue
4523386766,4,7,6,0,0,0,0,16354,7,18778,268,52,-1676,-1759,26.8,1635.4,7,4,8,1,1,0,0,18030,7.4,20537,244,84,1676,1759,24.4,1803,red,1.43,3.75,18,17,red
4518474732,10,5,8,1,1,0,0,18297,7.2,19476,242,48,2709,1259,24.2,1829.7,5,10,7,0,0,0,0,15588,6.8,18217,214,60,-2709,-1259,21.4,1558.8,blue,3.6,1.2,19,13,blue
4486453937,6,8,5,0,0,0,0,15748,6.6,16524,222,36,-1304,-552,22.2,1574.8,8,6,12,1,1,0,0,17052,6.8,17076,216,46,1304,552,21.6,1705.2,red,1.38,3.33,22,46,red
4496397328,8,5,10,1,1,0,0,17886,7.4,20099,229,59,1824,1409,22.9,1788.6,5,8,5,0,0,0,0,16062,7.2,18690,222,60,-1824,-1409,22.2,1606.2,blue,3.6,1.25,46,15,blue
4520768462,11,8,15,0,0,0,0,17069,6.6,16703,174,38,229,-45,17.4,1706.9,8,11,9,2,1,1,0,16840,6.8,16748,212,44,-229,45,21.2,1684,red,3.25,1.55,24,22,red
4518654959,4,4,4,1,0,1,0,16631,7.2,19310,252,57,1507,1667,25.2,1663.1,4,4,1,0,0,0,0,15124,7,17643,214,56,-1507,-1667,21.4,1512.4,blue,2,1.25,17,31,red
4519058321,1,5,3,1,1,0,0,14766,7,18364,231,65,-1787,-1135,23.1,1476.6,5,1,4,0,0,0,0,16553,7,19499,235,61,1787,1135,23.5,1655.3,red,0.8,9,15,20,red
4512960247,8,7,3,0,0,0,0,17113,7.2,19396,234,49,815,1397,23.4,1711.3,7,8,4,0,0,0,0,16298,6.8,17999,182,52,-815,-1397,18.2,1629.8,red,1.57,1.38,16,17,red
4445314635,5,14,6,1,1,0,0,15120,6.6,16713,167,48,-4767,-5061,16.7,1512,14,5,9,0,0,0,0,19887,7.8,21774,238,44,4767,5061,23.8,1988.7,red,0.79,4.6,15,16,red
4477030195,4,6,6,0,0,0,0,15339,6.6,16302,221,43,-1861,-2532,22.1,1533.9,6,4,10,1,1,0,0,17200,7,18834,262,64,1861,2532,26.2,1720,red,1.67,4,16,19,red
4497887298,1,14,1,1,1,0,0,13438,5.8,14164,174,53,-7655,-4485,17.4,1343.8,14,1,18,0,0,0,1,21093,7,18649,234,29,7655,4485,23.4,2109.3,red,0.14,32,68,19,red
4459403995,4,9,3,0,0,0,0,15582,6.8,17281,212,56,-2058,-2051,21.2,1558.2,9,4,11,0,0,0,0,17640,7.2,19332,224,54,2058,2051,22.4,1764,blue,0.78,5,21,18,red
4489079383,5,5,7,1,1,0,0,15441,6.6,17550,201,52,-575,-208,20.1,1544.1,5,5,3,0,0,0,0,16016,6.8,17758,213,64,575,208,21.3,1601.6,blue,2.4,1.6,19,19,red
4516695912,4,2,2,1,0,1,0,16002,7.2,18467,245,61,1765,701,24.5,1600.2,2,4,1,0,0,0,0,14237,6.8,17766,212,58,-1765,-701,21.2,1423.7,red,3,0.75,14,15,blue
4490435808,5,5,8,1,0,1,0,16009,6.8,18033,220,40,540,269,22,1600.9,5,5,8,1,1,0,0,15469,6.8,17764,185,54,-540,-269,18.5,1546.9,red,2.6,2.6,18,17,blue
4524895124,12,9,15,0,0,0,0,18106,6.6,16668,186,48,862,-442,18.6,1810.6,9,12,11,1,1,0,0,17244,6.8,17110,204,48,-862,442,20.4,1724.4,blue,3,1.67,19,21,red
4519469738,6,2,9,1,1,0,0,16501,6.6,18428,221,44,2761,1659,22.1,1650.1,2,6,1,0,0,0,0,13740,6.6,16769,201,40,-2761,-1659,20.1,1374,blue,7.5,0.5,38,16,blue
4523527200,3,8,3,0,0,0,0,15505,6.8,17721,227,61,-1249,-853,22.7,1550.5,8,3,5,1,1,0,0,16754,7.2,18574,214,44,1249,853,21.4,1675.4,red,0.75,4.33,16,88,red
4453080532,5,5,3,0,0,0,0,16195,7,19145,244,60,-75,655,24.4,1619.5,5,5,5,1,1,0,0,16270,7,18490,217,52,75,-655,21.7,1627,blue,1.6,2,37,21,red
4523303530,14,5,12,1,1,0,0,20294,6.8,18459,230,48,5805,4777,23,2029.4,5,14,6,0,0,0,0,14489,5.8,13682,178,28,-5805,-4777,17.8,1448.9,blue,5.2,0.79,21,18,blue
4495003373,5,7,3,1,0,1,0,15475,7,18145,198,59,-810,-305,19.8,1547.5,7,5,11,1,1,0,0,16285,7,18450,212,52,810,305,21.2,1628.5,red,1.14,3.6,26,18,red
4524303571,5,4,6,1,0,1,0,16243,7,18154,225,51,1034,706,22.5,1624.3,4,5,2,0,0,0,0,15209,6.8,17448,227,47,-1034,-706,22.7,1520.9,red,2.75,1.2,127,21,blue
4490487724,3,7,2,0,0,0,0,15065,6.6,17137,231,50,-2595,-2856,23.1,1506.5,7,3,6,1,0,1,0,17660,7.4,19993,260,51,2595,2856,26,1766,blue,0.71,4.33,19,25,blue
4515381064,1,2,3,0,0,0,0,14359,6.8,17258,228,55,-334,-73,22.8,1435.9,2,1,1,1,1,0,0,14693,6.6,17331,223,48,334,73,22.3,1469.3,blue,2,3,27,17,red
4512271556,11,4,8,2,1,1,1,19377,7.4,20008,233,44,3806,2161,23.3,1937.7,4,11,4,0,0,0,0,15571,7,17847,231,44,-3806,-2161,23.1,1557.1,blue,4.75,0.73,16,15,blue
4452824789,2,7,2,0,0,0,0,14135,6.8,17185,220,37,-2711,-2547,22,1413.5,7,2,7,0,0,0,0,16846,7.2,19732,230,58,2711,2547,23,1684.6,red,0.57,7,37,15,red
4481234929,8,4,8,0,0,0,0,17448,6.8,18315,242,48,2551,1754,24.2,1744.8,4,8,7,0,0,0,0,14897,6.6,16561,195,46,-2551,-1754,19.5,1489.7,blue,4,1.38,25,18,blue
4500668824,6,3,9,1,1,0,0,15958,6.6,17693,213,48,66,-446,21.3,1595.8,3,6,3,0,0,0,0,15892,6.8,18139,254,60,-66,446,25.4,1589.2,red,5,1,62,40,blue
4521663948,10,5,13,1,1,0,0,18287,7.2,18402,213,52,2242,727,21.3,1828.7,5,10,3,0,0,0,0,16045,6.8,17675,225,47,-2242,-727,22.5,1604.5,red,4.6,0.8,19,37,red
4525067275,2,5,2,1,0,1,0,15534,7,17975,252,51,-893,-213,25.2,1553.4,5,2,8,0,0,0,0,16427,7,18188,231,44,893,213,23.1,1642.7,red,0.8,6.5,15,17,red
4496503390,2,5,2,0,0,0,0,14935,7,17703,230,56,-1208,-152,23,1493.5,5,2,8,1,1,0,0,16143,7,17855,248,43,1208,152,24.8,1614.3,red,0.8,6.5,34,18,red
4519912865,12,4,11,0,0,0,0,19331,7.2,19387,255,50,4003,2566,25.5,1933.1,4,12,5,1,1,0,0,15328,6.8,16821,215,50,-4003,-2566,21.5,1532.8,blue,5.75,0.75,16,18,red
4447426572,8,6,7,1,1,0,0,17131,7.4,19719,240,43,819,2149,24,1713.1,6,8,9,0,0,0,0,16312,7,17570,206,52,-819,-2149,20.6,1631.2,blue,2.5,1.88,20,18,red
4493407357,9,3,10,0,0,0,0,17983,7,18340,230,52,4009,1935,23,1798.3,3,9,1,1,0,1,0,13974,6.6,16405,183,49,-4009,-1935,18.3,1397.4,blue,6.33,0.44,82,18,blue
4459426947,5,6,5,1,1,0,0,16842,7,18443,221,58,-259,-1001,22.1,1684.2,6,5,6,0,0,0,0,17101,7.4,19444,247,64,259,1001,24.7,1710.1,red,1.67,2.4,18,20,red
4519988685,9,6,13,0,0,0,0,17569,6.8,17101,212,40,1728,-738,21.2,1756.9,6,9,7,0,0,0,0,15841,7,17839,180,56,-1728,738,18,1584.1,red,3.67,1.44,24,13,blue
4519844846,5,5,3,1,0,1,0,15882,6.8,16956,241,48,474,393,24.1,1588.2,5,5,6,1,1,0,0,15408,6.4,16563,207,36,-474,-393,20.7,1540.8,red,1.6,2.2,20,17,red
4525070748,9,3,8,0,0,0,0,17049,6.8,17241,202,41,1863,328,20.2,1704.9,3,9,5,0,0,0,0,15186,6.8,16913,204,58,-1863,-328,20.4,1518.6,red,5.67,0.89,21,19,blue
4465204267,1,7,1,0,0,0,0,13556,6.8,16451,200,48,-3846,-2306,20,1355.6,7,1,7,1,1,0,0,17402,7.2,18757,253,52,3846,2306,25.3,1740.2,red,0.29,14,44,22,red
4517684472,1,3,1,0,0,0,0,14692,7,18342,227,47,-2373,-1592,22.7,1469.2,3,1,5,1,1,0,0,17065,7.2,19934,250,76,2373,1592,25,1706.5,red,0.67,8,14,18,red
4517646191,8,7,10,1,1,0,0,17000,6.6,16417,204,49,218,-204,20.4,1700,7,8,5,0,0,0,0,16782,6.8,16621,209,55,-218,204,20.9,1678.2,blue,2.57,1.5,17,19,red
4459901632,6,4,7,0,0,0,0,17200,7.2,18984,235,59,2208,1929,23.5,1720,4,6,5,0,0,0,0,14992,6.6,17055,215,40,-2208,-1929,21.5,1499.2,blue,3.25,1.5,33,21,blue
4495413031,5,7,2,1,1,0,0,15409,7.2,18408,217,64,-1440,-373,21.7,1540.9,7,5,9,0,0,0,0,16849,7.2,18781,241,52,1440,373,24.1,1684.9,red,1,3.2,46,21,red
4519612989,10,12,13,1,1,0,0,17283,6.4,16235,184,36,-845,-1743,18.4,1728.3,12,10,7,0,0,0,0,18128,6.8,17978,208,68,845,1743,20.8,1812.8,red,1.92,1.9,29,19,red
4406716520,5,9,5,0,0,0,0,15477,6.4,15965,173,47,-2635,-2694,17.3,1547.7,9,5,12,1,1,0,0,18112,7,18659,241,43,2635,2694,24.1,1811.2,red,1.11,4.2,16,15,red
4525184804,6,1,8,2,1,1,0,16763,7,18897,224,51,2817,2414,22.4,1676.3,1,6,1,0,0,0,0,13946,6.4,16483,207,56,-2817,-2414,20.7,1394.6,blue,14,0.33,58,40,red
4524569254,9,5,4,2,1,1,0,18434,7.4,20263,223,70,2812,2497,22.3,1843.4,5,9,3,0,0,0,0,15622,7.2,17766,226,55,-2812,-2497,22.6,1562.2,blue,2.6,0.89,16,18,red
4431143877,1,6,2,0,0,0,0,13731,6.6,16666,218,44,-3864,-2759,21.8,1373.1,6,1,10,1,1,0,0,17595,7.2,19425,263,48,3864,2759,26.3,1759.5,red,0.5,16,20,28,red
4446797537,5,6,6,1,1,0,0,17251,7.4,19984,233,76,334,955,23.3,1725.1,6,5,5,0,0,0,0,16917,7,19029,230,60,-334,-955,23,1691.7,blue,1.83,2.2,16,18,red
4524403652,7,6,5,1,1,0,0,17051,7,18864,246,44,1909,2436,24.6,1705.1,6,7,8,0,0,0,0,15142,6.4,16428,196,40,-1909,-2436,19.6,1514.2,blue,2,2,14,16,blue
4524260824,7,7,6,0,0,0,0,16346,7,18557,209,44,-346,-358,20.9,1634.6,7,7,7,0,0,0,0,16692,7.2,18915,182,67,346,358,18.2,1669.2,red,1.86,2,15,34,blue
4440119391,14,4,14,0,0,0,0,21095,7.6,21242,249,67,5802,5396,24.9,2109.5,4,14,5,1,1,0,0,15293,6.2,15846,186,44,-5802,-5396,18.6,1529.3,blue,7,0.64,27,18,blue
4518199999,6,4,3,1,1,0,0,16434,7,18641,228,47,1085,1048,22.8,1643.4,4,6,2,0,0,0,0,15349,6.6,17593,220,48,-1085,-1048,22,1534.9,blue,2.25,1,15,14,blue
4520967143,4,11,2,1,1,0,0,15834,6.8,18362,197,56,-2383,-1807,19.7,1583.4,11,4,7,0,0,0,0,18217,7.4,20169,182,59,2383,1807,18.2,1821.7,red,0.55,4.5,38,17,blue
4498216490,8,9,9,1,0,1,0,16968,7,18900,214,45,306,1895,21.4,1696.8,9,8,10,0,0,0,0,16662,6.6,17005,208,33,-306,-1895,20.8,1666.2,blue,1.89,2.38,47,29,red
4493677959,5,7,7,0,0,0,0,15949,6.8,17005,209,51,-1568,-1850,20.9,1594.9,7,5,8,1,1,0,0,17517,7.2,18855,215,71,1568,1850,21.5,1751.7,red,1.71,3,21,24,blue
4523093613,5,7,3,1,1,0,0,16056,6.8,17578,234,56,-1419,-1156,23.4,1605.6,7,5,13,1,0,1,0,17475,7,18734,227,52,1419,1156,22.7,1747.5,blue,1.14,4,20,41,red
4437257190,10,6,8,1,0,1,0,18392,6.8,18818,222,52,2263,1634,22.2,1839.2,6,10,5,1,1,0,0,16129,6.4,17184,213,60,-2263,-1634,21.3,1612.9,blue,3,1.1,32,19,blue
4521897707,6,2,9,0,0,0,0,16415,7.2,18271,230,43,1374,1225,23,1641.5,2,6,2,1,1,0,0,15041,6.8,17046,217,51,-1374,-1225,21.7,1504.1,blue,7.5,0.67,21,21,blue
4467164835,14,4,21,1,1,0,0,19948,7.4,20064,220,56,4301,3444,22,1994.8,4,14,4,0,0,0,0,15647,6.6,16620,205,60,-4301,-3444,20.5,1564.7,blue,8.75,0.57,23,68,red
4521542696,9,4,6,0,0,0,0,18189,7,19191,220,54,3905,3713,22,1818.9,4,9,3,0,0,0,0,14284,6.2,15478,181,52,-3905,-3713,18.1,1428.4,blue,3.75,0.78,13,18,blue
4495464440,3,8,4,0,0,0,0,14398,6.6,15990,194,42,-2919,-2318,19.4,1439.8,8,3,9,1,1,0,0,17317,7,18308,207,51,2919,2318,20.7,1731.7,blue,0.88,5.67,17,18,red
4452038425,6,0,8,1,1,0,0,17359,7.4,20592,265,59,2923,2787,26.5,1735.9,0,6,0,0,0,0,0,14436,6.8,17805,242,48,-2923,-2787,24.2,1443.6,blue,12.03,0,24,22,blue
4515821204,4,7,3,0,0,0,0,15817,6.8,17535,210,55,-1059,-951,21,1581.7,7,4,9,2,1,1,0,16876,7,18486,214,49,1059,951,21.4,1687.6,red,1,4,21,19,red
4502922066,3,5,3,1,0,1,0,15861,7,19121,270,52,-406,-14,27,1586.1,5,3,7,1,1,0,0,16267,7,19135,235,56,406,14,23.5,1626.7,red,1.2,4,12,15,red
4384241438,7,3,7,1,1,0,0,16355,7,18991,238,43,1143,1251,23.8,1635.5,3,7,2,0,0,0,0,15212,7,17740,216,59,-1143,-1251,21.6,1521.2,blue,4.67,0.71,17,11,red
4466040137,11,9,13,0,0,0,0,18333,7,18622,225,56,736,266,22.5,1833.3,9,11,9,1,1,0,0,17597,7.2,18356,205,44,-736,-266,20.5,1759.7,blue,2.67,1.64,60,17,red
4476661914,2,11,3,0,0,0,0,14562,6.8,16952,196,68,-4816,-3750,19.6,1456.2,11,2,12,1,1,0,0,19378,7.4,20702,259,48,4816,3750,25.9,1937.8,red,0.45,11.5,10,13,blue
4458282675,11,6,13,2,1,1,0,19677,7.6,20488,236,57,3977,3949,23.6,1967.7,6,11,12,0,0,0,0,15700,6.4,16539,208,32,-3977,-3949,20.8,1570,blue,4,1.64,22,41,red
4507871318,11,7,14,0,0,0,0,18793,7,18395,217,37,3026,3357,21.7,1879.3,7,11,8,1,1,0,0,15767,6.4,15038,174,37,-3026,-3357,17.4,1576.7,blue,3.57,1.36,23,22,red
4431970864,4,12,0,1,1,0,0,14276,6.8,16422,190,51,-4262,-2426,19,1427.6,12,4,14,0,0,0,0,18538,7.2,18848,224,40,4262,2426,22.4,1853.8,red,0.33,6.5,25,18,red
4516600859,4,1,4,1,0,1,1,16808,6.8,17831,227,46,2476,772,22.7,1680.8,1,4,0,1,1,0,0,14332,6.8,17059,248,53,-2476,-772,24.8,1433.2,red,8,0.25,19,17,blue
4499806829,3,9,3,0,0,0,0,15002,6.6,16448,217,41,-3545,-3206,21.7,1500.2,9,3,10,2,1,1,0,18547,7.4,19654,224,55,3545,3206,22.4,1854.7,red,0.67,6.33,17,41,red
4472532304,4,9,5,1,0,1,0,14354,6.4,15677,173,49,-4324,-2979,17.3,1435.4,9,4,13,1,1,0,0,18678,7,18656,213,55,4324,2979,21.3,1867.8,red,1,5.5,19,33,red
4444232401,5,6,6,1,1,0,0,15926,7.2,19262,223,63,-496,-837,22.3,1592.6,6,5,5,0,0,0,0,16422,7.4,20099,218,46,496,837,21.8,1642.2,blue,1.83,2.2,14,11,red
4521519484,3,5,5,0,0,0,0,14742,6.6,16162,241,38,-1620,-1442,24.1,1474.2,5,3,6,1,1,0,0,16362,7,17604,226,62,1620,1442,22.6,1636.2,red,1.6,3.67,21,19,red
4515353277,6,10,8,0,0,0,0,16481,6.8,17069,201,48,-1334,-1607,20.1,1648.1,10,6,12,1,1,0,0,17815,7.2,18676,198,44,1334,1607,19.8,1781.5,blue,1.4,3.67,21,18,blue
4524248852,9,8,5,0,0,0,0,16307,7,17660,194,32,-796,-217,19.4,1630.7,8,9,10,0,0,0,0,17103,6.8,17877,215,44,796,217,21.5,1710.3,red,1.75,2,40,24,blue
4521172111,6,2,3,1,1,0,0,16569,7.2,19120,238,44,1398,1804,23.8,1656.9,2,6,3,0,0,0,0,15171,6.6,17316,233,60,-1398,-1804,23.3,1517.1,blue,4.5,0.83,42,35,blue
4517776491,5,3,5,0,0,0,0,17322,7,19067,229,63,3005,1938,22.9,1732.2,3,5,4,0,0,0,0,14317,6.4,17129,197,32,-3005,-1938,19.7,1431.7,blue,3.33,1.4,21,20,blue
4519368335,3,8,2,0,0,0,0,14711,6.8,16559,222,40,-3156,-3287,22.2,1471.1,8,3,6,0,0,0,0,17867,7.2,19846,238,54,3156,3287,23.8,1786.7,red,0.62,4.67,22,22,blue
4523639973,3,5,3,2,1,1,0,16009,7.2,18511,268,55,-473,383,26.8,1600.9,5,3,7,0,0,0,0,16482,6.8,18128,246,46,473,-383,24.6,1648.2,blue,1.2,4,23,22,red
4522111616,5,10,4,0,0,0,0,15102,6.4,16437,196,36,-3397,-2282,19.6,1510.2,10,5,12,1,0,1,0,18499,7,18719,225,49,3397,2282,22.5,1849.9,red,0.9,4.4,18,24,red
4521188250,6,9,5,0,0,0,0,15499,6.8,17298,222,28,-1937,-1514,22.2,1549.9,9,6,12,1,1,0,0,17436,7,18812,204,59,1937,1514,20.4,1743.6,red,1.22,3.5,44,18,red
4493154896,10,4,10,0,0,0,0,18456,7.2,19319,218,48,3765,2661,21.8,1845.6,4,10,3,0,0,0,0,14691,6.8,16658,193,47,-3765,-2661,19.3,1469.1,blue,5,0.7,43,17,blue
4512775669,5,2,5,1,1,0,0,15767,7,17413,224,52,384,-690,22.4,1576.7,2,5,3,1,0,1,0,15383,7,18103,250,48,-384,690,25,1538.3,red,5,1,15,19,blue
4505100164,11,5,12,1,1,0,0,18890,7.2,19229,223,40,2708,682,22.3,1889,5,11,4,0,0,0,0,16182,7.2,18547,230,47,-2708,-682,23,1618.2,blue,4.6,0.82,17,20,blue
4439464616,4,8,3,0,0,0,0,14901,7,17696,209,42,-2427,-1462,20.9,1490.1,8,4,7,0,0,0,0,17328,7.2,19158,224,52,2427,1462,22.4,1732.8,red,0.88,3.75,19,16,blue
4515793486,6,3,7,1,1,0,0,16785,7.4,19346,245,45,1901,684,24.5,1678.5,3,6,2,0,0,0,0,14884,7,18662,211,68,-1901,-684,21.1,1488.4,blue,4.33,0.83,20,49,blue
4505809782,10,5,15,1,1,0,0,18786,7.2,18509,235,60,2480,1699,23.5,1878.6,5,10,8,1,0,1,0,16306,6.8,16810,221,40,-2480,-1699,22.1,1630.6,blue,5,1.3,37,16,red
4502875704,1,10,2,1,0,1,0,14727,6.6,16272,219,52,-3581,-2467,21.9,1472.7,10,1,15,1,1,0,0,18308,7,18739,248,31,3581,2467,24.8,1830.8,red,0.3,25,18,20,red
4475734964,10,5,14,2,1,1,0,18009,7.2,18763,200,55,2911,1378,20,1800.9,5,10,5,0,0,0,0,15098,6.8,17385,212,52,-2911,-1378,21.2,1509.8,blue,4.8,1,39,18,blue
4482233269,1,4,2,1,0,1,0,14526,6.8,17366,224,50,-1245,-1370,22.4,1452.6,4,1,4,1,1,0,0,15771,7,18736,241,53,1245,1370,24.1,1577.1,red,0.75,8,19,20,red
4511770317,8,6,8,1,1,0,0,16627,6.8,17397,212,50,166,-497,21.2,1662.7,6,8,6,1,0,1,0,16461,7,17894,209,53,-166,497,20.9,1646.1,red,2.67,1.5,17,14,red
4524067975,1,6,1,0,0,0,0,13075,6.4,15488,169,56,-6309,-3115,16.9,1307.5,6,1,5,0,0,0,1,19384,7.2,18603,270,48,6309,3115,27,1938.4,red,0.33,11,20,20,red
4474977192,5,11,4,0,0,0,0,16105,6.8,17502,214,35,-2047,-2555,21.4,1610.5,11,5,5,1,1,0,0,18152,7.6,20057,208,52,2047,2555,20.8,1815.2,red,0.82,3.2,17,142,red
4467242137,3,4,6,0,0,0,0,14782,6.8,16677,213,49,-1464,-1509,21.3,1478.2,4,3,4,1,1,0,0,16246,7,18186,238,56,1464,1509,23.8,1624.6,red,2.25,2.67,17,20,blue
4521516098,5,3,4,2,1,1,0,15889,7,18189,217,52,874,-302,21.7,1588.9,3,5,4,0,0,0,0,15015,7.2,18491,215,52,-874,302,21.5,1501.5,blue,3,1.4,16,41,blue
4475861894,2,5,3,1,1,0,0,15158,6.8,17387,250,43,-627,183,25,1515.8,5,2,9,0,0,0,0,15785,6.8,17204,243,24,627,-183,24.3,1578.5,red,1,7,28,53,blue
4473365528,3,3,4,0,0,0,0,15073,6.8,17578,227,54,-334,-292,22.7,1507.3,3,3,3,0,0,0,0,15407,6.8,17870,251,46,334,292,25.1,1540.7,red,2.33,2,19,15,red
4520554639,7,8,5,1,1,0,0,17125,7.2,18785,240,52,449,1210,24,1712.5,8,7,13,0,0,0,0,16676,7,17575,177,48,-449,-1210,17.7,1667.6,red,1.5,3,21,19,blue
4519562141,6,9,6,0,0,0,0,16377,6.6,16818,209,49,-780,-73,20.9,1637.7,9,6,14,0,0,0,0,17157,6.6,16891,200,32,780,73,20,1715.7,red,1.33,3.83,21,26,red
4477654399,4,6,4,1,0,1,0,15888,7.4,18421,234,65,-205,1064,23.4,1588.8,6,4,7,0,0,0,0,16093,7,17357,217,32,205,-1064,21.7,1609.3,red,1.33,3.25,24,20,red
4524744736,2,3,3,0,0,0,0,14414,6.8,17356,226,60,-1731,-1585,22.6,1441.4,3,2,3,0,0,0,0,16145,7,18941,268,56,1731,1585,26.8,1614.5,red,1.67,3,20,16,red
4437489184,10,9,9,1,1,0,0,18329,7,18315,219,53,947,-188,21.9,1832.9,9,10,11,0,0,0,0,17382,7.2,18503,194,48,-947,188,19.4,1738.2,red,2.11,2,36,50,red
4516668528,6,7,10,0,0,0,0,16245,6.8,16720,215,34,-713,-1111,21.5,1624.5,7,6,5,1,1,0,0,16958,6.8,17831,207,47,713,1111,20.7,1695.8,red,2.29,2,19,21,blue
4519159286,3,4,2,1,1,0,0,16120,6.8,17683,223,56,1171,-1140,22.3,1612,4,3,3,0,0,0,0,14949,7.2,18823,207,46,-1171,1140,20.7,1494.9,blue,1.25,2.33,16,15,blue
4519850833,5,7,8,0,0,0,0,15548,6.4,16604,191,52,-459,-307,19.1,1554.8,7,5,9,1,1,0,0,16007,6.8,16911,196,40,459,307,19.6,1600.7,red,1.86,3.2,11,18,blue
4517486439,8,2,12,0,0,0,0,17432,7.2,18495,209,44,2673,1388,20.9,1743.2,2,8,4,1,1,0,0,14759,6.6,17107,216,64,-2673,-1388,21.6,1475.9,blue,10,0.75,22,13,blue
4524983213,9,7,10,1,1,0,0,16922,6.8,17350,207,36,-251,-1675,20.7,1692.2,7,9,3,0,0,0,0,17173,7.2,19025,221,48,251,1675,22.1,1717.3,blue,2.71,1.11,22,18,blue
4518971056,5,2,5,0,0,0,0,16142,7.2,18818,245,49,534,634,24.5,1614.2,2,5,2,2,1,1,0,15608,6.8,18184,277,58,-534,-634,27.7,1560.8,red,5,0.8,31,19,blue
4519735486,2,8,2,1,1,0,0,14630,6.6,17694,211,60,-4005,-2248,21.1,1463,8,2,7,0,0,0,0,18635,7.4,19942,271,47,4005,2248,27.1,1863.5,red,0.5,7.5,17,19,red
4474578405,2,4,1,2,1,1,0,15131,7,18134,239,64,-318,86,23.9,1513.1,4,2,5,0,0,0,0,15449,6.8,18048,216,44,318,-86,21.6,1544.9,blue,0.75,4.5,17,20,blue
4495526731,8,5,7,1,0,1,0,17697,7.2,18512,203,59,2682,2118,20.3,1769.7,5,8,5,1,1,0,0,15015,6.6,16394,165,50,-2682,-2118,16.5,1501.5,red,3,1.25,14,15,blue
4523588445,4,3,5,1,1,0,0,16116,7,17653,244,47,2092,1763,24.4,1611.6,3,4,2,0,0,0,0,14024,6.4,15890,191,48,-2092,-1763,19.1,1402.4,red,3,1.25,20,15,blue
4496025643,10,7,9,0,0,0,0,18485,7.4,19949,228,52,2300,2148,22.8,1848.5,7,10,6,0,0,0,0,16185,7.2,17801,187,43,-2300,-2148,18.7,1618.5,blue,2.71,1.3,19,19,red
4449279281,6,3,4,1,1,0,0,16980,7,18593,241,44,2642,1346,24.1,1698,3,6,5,0,0,0,0,14338,6.6,17247,188,54,-2642,-1346,18.8,1433.8,blue,3.33,1.33,17,19,blue
4524290588,5,4,6,0,0,0,0,17066,6.8,17494,236,46,2833,220,23.6,1706.6,4,5,2,1,1,0,0,14233,7,17274,172,67,-2833,-220,17.2,1423.3,blue,2.75,1.2,16,12,blue
4481379221,8,8,9,0,0,0,0,17202,6.6,17447,214,40,-336,-1059,21.4,1720.2,8,8,9,1,1,0,0,17538,7,18506,214,71,336,1059,21.4,1753.8,red,2.12,2.12,17,14,blue
4497057886,1,8,2,1,1,0,0,14702,6.6,16461,214,55,-5136,-3713,21.4,1470.2,8,1,7,0,0,0,1,19838,7.6,20174,289,46,5136,3713,28.9,1983.8,red,0.38,15,17,17,red
4457248839,13,7,11,0,0,0,0,18692,7.4,19886,238,40,1872,3579,23.8,1869.2,7,13,11,0,0,0,0,16820,6.6,16307,215,36,-1872,-3579,21.5,1682,blue,3.43,1.38,16,15,red
4462529490,11,13,13,1,1,0,0,18549,6.8,16837,182,56,-1048,-450,18.2,1854.9,13,11,17,1,0,1,1,19597,6.8,17287,201,40,1048,450,20.1,1959.7,red,1.85,2.73,20,19,red
4511728953,4,5,3,1,1,0,0,15859,7.2,18390,242,59,-88,-932,24.2,1585.9,5,4,10,0,0,0,0,15947,7.2,19322,222,61,88,932,22.2,1594.7,blue,1.4,3.75,17,43,red
4455484063,4,9,5,0,0,0,0,16044,7,18226,224,56,-1427,-1008,22.4,1604.4,9,4,6,0,0,0,0,17471,7.2,19234,243,28,1427,1008,24.3,1747.1,blue,1,3.75,17,20,red
4492027887,8,11,6,1,0,1,0,15941,6.8,16613,180,37,-2440,-1603,18,1594.1,11,8,15,0,0,0,0,18381,6.8,18216,219,40,2440,1603,21.9,1838.1,blue,1.27,3.25,19,19,red
4500738441,5,9,4,0,0,0,0,15675,6.6,16844,229,39,-1614,-2256,22.9,1567.5,9,5,12,1,1,0,0,17289,7.2,19100,215,56,1614,2256,21.5,1728.9,red,1,4.2,25,17,blue
4472130589,4,7,2,1,1,0,0,15682,6.8,17438,234,60,-1075,73,23.4,1568.2,7,4,6,0,0,0,0,16757,6.8,17365,213,51,1075,-73,21.3,1675.7,blue,0.86,3.25,20,21,red
4509440283,7,8,7,2,1,1,0,15843,6.8,17154,190,44,-1799,-1304,19,1584.3,8,7,15,0,0,0,0,17642,6.8,18458,196,48,1799,1304,19.6,1764.2,blue,1.75,3.29,58,20,blue
4522207567,12,3,11,1,1,0,0,18248,7.4,19855,201,48,3296,3231,20.1,1824.8,3,12,3,0,0,0,0,14952,6.4,16624,201,47,-3296,-3231,20.1,1495.2,blue,7.67,0.5,19,12,blue
4492532758,4,7,3,0,0,0,0,15333,7,18073,201,68,-1942,57,20.1,1533.3,7,4,5,1,1,0,0,17275,6.8,18016,236,48,1942,-57,23.6,1727.5,blue,1,3,17,21,red
4521901284,8,4,10,1,1,0,0,17496,7.2,18253,246,31,2013,247,24.6,1749.6,4,8,3,0,0,0,0,15483,7,18006,229,60,-2013,-247,22.9,1548.3,blue,4.5,0.88,23,20,blue
4524952365,12,8,15,2,1,1,0,19809,7,18530,221,52,3574,1210,22.1,1980.9,8,12,11,0,0,0,0,16235,6.8,17320,166,45,-3574,-1210,16.6,1623.5,blue,3.38,1.58,20,24,blue
4506175906,13,3,9,1,1,0,0,19329,7,19021,246,36,6000,5033,24.6,1932.9,3,13,5,1,0,1,0,13329,6,13988,142,56,-6000,-5033,14.2,1332.9,blue,7.33,0.62,26,39,blue
4462044332,5,9,2,0,0,0,1,15600,6.2,14986,193,36,-3128,-2320,19.3,1560,9,5,9,1,0,1,1,18728,6.8,17306,232,46,3128,2320,23.2,1872.8,red,0.78,3.6,25,21,red
4490186049,4,4,1,2,1,1,0,16292,7.2,18889,274,50,1229,1059,27.4,1629.2,4,4,2,0,0,0,0,15063,7,17830,220,50,-1229,-1059,22,1506.3,blue,1.25,1.5,19,20,red
4484406104,5,10,6,1,0,1,0,17677,7,18225,269,51,1285,1300,26.9,1767.7,10,5,9,1,1,0,0,16392,6.6,16925,173,44,-1285,-1300,17.3,1639.2,red,1.1,3.8,28,23,blue
4525016329,5,10,6,0,0,0,0,15141,6.8,17635,176,48,-3274,-1385,17.6,1514.1,10,5,8,1,1,0,0,18415,7.2,19020,238,36,3274,1385,23.8,1841.5,red,1.1,3.6,40,27,red
4500061522,5,8,1,0,0,0,0,14897,7,17306,212,47,-1770,325,21.2,1489.7,8,5,9,1,1,0,0,16667,6.8,16981,191,46,1770,-325,19.1,1666.7,red,0.75,3.4,19,18,red
4519405060,8,3,14,1,1,0,0,17520,7,18610,211,55,1892,890,21.1,1752,3,8,4,0,0,0,0,15628,6.8,17720,250,52,-1892,-890,25,1562.8,blue,7.33,0.88,46,13,blue
4489107680,8,7,9,0,0,0,0,17164,7,18932,222,55,525,902,22.2,1716.4,7,8,7,0,0,0,0,16639,6.8,18030,215,55,-525,-902,21.5,1663.9,red,2.43,1.75,20,17,blue
4524853879,5,6,8,1,1,0,0,15999,6.6,17033,234,44,-415,-498,23.4,1599.9,6,5,8,0,0,0,0,16414,7,17531,226,48,415,498,22.6,1641.4,red,2.17,2.8,17,17,blue
4519652445,2,6,1,0,0,0,0,14542,6.8,17517,234,48,-1751,-1585,23.4,1454.2,6,2,4,1,1,0,0,16293,7,19102,229,56,1751,1585,22.9,1629.3,blue,0.5,5,12,16,red
4479492497,14,6,10,1,0,1,1,20225,6.6,17976,194,50,4453,2458,19.4,2022.5,6,14,6,1,1,0,0,15772,6.6,15518,189,40,-4453,-2458,18.9,1577.2,blue,4,0.86,14,19,blue
4477014254,11,6,10,1,1,0,0,18203,7,18175,199,56,1393,441,19.9,1820.3,6,11,2,0,0,0,0,16810,6.8,17734,224,52,-1393,-441,22.4,1681,red,3.5,0.73,19,33,blue
4474899637,6,5,4,2,1,1,0,16787,7.2,18618,253,52,534,154,25.3,1678.7,5,6,10,0,0,0,0,16253,7.2,18464,197,75,-534,-154,19.7,1625.3,blue,2,2.5,21,20,red
4448166002,2,11,2,0,0,0,0,14959,6.8,16588,226,54,-3301,-2246,22.6,1495.9,11,2,18,1,1,0,0,18260,7.4,18834,203,53,3301,2246,20.3,1826,red,0.36,14.5,22,18,blue
4518035441,4,7,4,2,1,1,0,15132,6.8,16489,190,64,-2022,-2023,19,1513.2,7,4,7,0,0,0,0,17154,7.2,18512,242,44,2022,2023,24.2,1715.4,blue,1.14,3.5,17,16,red
4524924561,3,6,4,0,0,0,0,16354,7,17848,252,46,176,-172,25.2,1635.4,6,3,7,1,1,0,0,16178,6.8,18020,202,55,-176,172,20.2,1617.8,red,1.17,4.33,16,54,red
4519402514,2,5,2,1,0,1,0,14652,6.8,17192,205,52,-458,-559,20.5,1465.2,5,2,3,1,1,0,0,15110,6.8,17751,210,52,458,559,21,1511,red,0.8,4,16,14,red
4439902649,4,2,7,0,0,0,0,15331,6.8,17540,182,61,676,-576,18.2,1533.1,2,4,1,1,1,0,0,14655,7.2,18116,216,54,-676,576,21.6,1465.5,red,5.5,0.75,43,68,blue
4471437748,6,4,5,1,1,0,0,17002,7.2,18755,218,71,2536,3339,21.8,1700.2,4,6,0,1,0,1,0,14466,6.4,15416,210,35,-2536,-3339,21,1446.6,blue,2.75,0.67,24,17,red
4452202569,7,11,10,0,0,0,0,16308,6.8,16771,189,44,-1751,-2784,18.9,1630.8,11,7,9,1,0,1,0,18059,7.4,19555,200,58,1751,2784,20,1805.9,blue,1.55,2.86,57,41,red
4519983082,7,10,9,0,0,0,0,16282,6.8,16826,198,45,-1516,-1467,19.8,1628.2,10,7,10,2,1,1,0,17798,6.8,18293,201,47,1516,1467,20.1,1779.8,blue,1.6,2.86,19,20,red
4514792667,3,7,3,0,0,0,0,14110,6.4,15832,162,48,-2566,-2246,16.2,1411,7,3,3,0,0,0,0,16676,6.8,18078,228,47,2566,2246,22.8,1667.6,red,0.86,3.33,16,17,blue
4524404606,4,8,5,0,0,0,0,15426,7,17467,226,47,-2023,-2678,22.6,1542.6,8,4,4,1,1,0,0,17449,7.4,20145,251,60,2023,2678,25.1,1744.9,red,1.12,3,88,18,blue
4517159658,5,6,4,1,0,1,0,15983,6.8,17562,222,51,-276,179,22.2,1598.3,6,5,8,0,0,0,0,16259,6.8,17383,189,48,276,-179,18.9,1625.9,red,1.5,2.8,16,19,red
4490111763,7,4,5,2,1,1,0,16801,7.2,18563,211,60,1574,1834,21.1,1680.1,4,7,3,0,0,0,0,15227,6.8,16729,200,43,-1574,-1834,20,1522.7,blue,3,1,22,13,blue
4511615760,6,3,10,0,0,0,0,17141,7.2,19142,232,54,2378,2190,23.2,1714.1,3,6,1,1,1,0,0,14763,6.8,16952,206,56,-2378,-2190,20.6,1476.3,blue,5.33,0.67,24,17,red
4460035354,4,9,4,0,0,0,0,15122,7,17694,195,48,-3223,-2518,19.5,1512.2,9,4,10,2,1,1,0,18345,7.4,20212,235,68,3223,2518,23.5,1834.5,red,0.89,4.75,19,14,blue
4524340253,5,5,7,0,0,0,0,16878,7,19372,238,63,808,1415,23.8,1687.8,5,5,8,1,1,0,0,16070,7,17957,214,56,-808,-1415,21.4,1607,red,2.4,2.6,19,43,red
4494288234,8,2,8,0,0,0,0,18274,7,18615,238,45,3803,2825,23.8,1827.4,2,8,6,0,0,0,0,14471,6.4,15790,201,51,-3803,-2825,20.1,1447.1,blue,8,1,38,15,blue
4503193235,2,8,3,0,0,0,0,14176,6.8,17054,194,48,-3360,-1842,19.4,1417.6,8,2,7,1,1,0,0,17536,7.2,18896,228,56,3360,1842,22.8,1753.6,red,0.62,7.5,22,22,red
4487544482,6,2,9,0,0,0,0,17549,7.2,19231,243,64,2397,1405,24.3,1754.9,2,6,1,1,0,1,0,15152,6.8,17826,248,44,-2397,-1405,24.8,1515.2,blue,7.5,0.5,20,24,red
4522841712,5,8,7,0,0,0,0,16049,6.6,16758,217,51,-883,-1828,21.7,1604.9,8,5,9,0,0,0,0,16932,7,18586,187,43,883,1828,18.7,1693.2,red,1.5,3.4,20,21,blue
4492447049,1,4,1,0,0,0,0,14017,6.4,15893,229,32,-2638,-2478,22.9,1401.7,4,1,5,2,1,1,0,16655,6.8,18371,231,56,2638,2478,23.1,1665.5,red,0.5,9,15,42,blue
4515497599,14,3,16,0,0,0,0,20139,7.8,21898,218,56,5035,5420,21.8,2013.9,3,14,5,0,0,0,0,15104,6.6,16478,223,40,-5035,-5420,22.3,1510.4,blue,10,0.57,21,17,blue
4515307399,5,8,5,0,0,0,0,16659,7,17777,234,60,-1003,-899,23.4,1665.9,8,5,7,2,1,1,0,17662,7,18676,217,59,1003,899,21.7,1766.2,red,1.25,3,19,16,blue
4520027205,5,8,4,0,0,0,0,15975,6.8,18165,227,56,-1963,-1151,22.7,1597.5,8,5,10,1,1,0,0,17938,7.2,19316,225,52,1963,1151,22.5,1793.8,red,1.12,3.6,15,16,blue
4525124678,6,7,7,0,0,0,0,16728,7.2,18284,221,66,-1071,-1471,22.1,1672.8,7,6,8,1,1,0,0,17799,7.4,19755,248,55,1071,1471,24.8,1779.9,red,1.86,2.5,37,18,red
4506399392,6,5,9,0,0,0,0,16693,7,18761,227,57,897,1090,22.7,1669.3,5,6,7,0,0,0,0,15796,7,17671,237,36,-897,-1090,23.7,1579.6,blue,3,2,22,20,blue
4520037654,5,2,4,2,1,1,0,15925,6.8,17913,228,56,1946,1292,22.8,1592.5,2,5,2,0,0,0,0,13979,6.8,16621,213,46,-1946,-1292,21.3,1397.9,blue,4.5,0.8,21,20,blue
4513253618,8,8,5,1,0,1,0,16763,6.8,17433,193,54,-219,-1440,19.3,1676.3,8,8,6,1,1,0,0,16982,7.2,18873,183,58,219,1440,18.3,1698.2,red,1.62,1.75,20,17,red
4523092782,6,4,7,0,0,0,0,16852,6.8,18660,239,44,1588,1331,23.9,1685.2,4,6,7,0,0,0,0,15264,6.8,17329,213,54,-1588,-1331,21.3,1526.4,blue,3.25,1.83,27,19,blue
4510100587,2,6,3,0,0,0,0,14950,7,18134,234,42,-1889,-723,23.4,1495,6,2,6,1,1,0,0,16839,7,18857,229,49,1889,723,22.9,1683.9,red,0.83,6,15,15,red
4522265559,2,4,2,1,1,0,0,14863,6.8,17436,195,72,-720,432,19.5,1486.3,4,2,4,0,0,0,0,15583,6.8,17004,223,36,720,-432,22.3,1558.3,blue,1,4,19,16,red
4502459201,3,12,2,0,0,0,0,15853,7,18223,220,68,-2388,-1978,22,1585.3,12,3,8,2,1,1,0,18241,7.6,20201,205,56,2388,1978,20.5,1824.1,red,0.42,6.67,16,19,blue
4449297701,3,13,1,0,0,0,0,13428,6,14121,167,46,-5668,-4786,16.7,1342.8,13,3,10,1,1,0,0,19096,7,18907,218,44,5668,4786,21.8,1909.6,red,0.31,7.67,20,22,red
4524992548,7,8,8,1,1,0,0,17570,7,18283,238,58,527,1493,23.8,1757,8,7,11,0,0,0,0,17043,6.8,16790,176,48,-527,-1493,17.6,1704.3,blue,1.88,2.71,19,18,red
4524182340,6,4,3,1,0,1,0,16561,7,17961,232,53,1496,-730,23.2,1656.1,4,6,4,1,1,0,0,15065,7,18691,191,55,-1496,730,19.1,1506.5,blue,2.25,1.33,23,61,blue
4522266897,8,14,4,0,0,0,0,15070,6.4,15375,142,40,-4245,-3073,14.2,1507,14,8,12,2,1,1,0,19315,7,18448,193,48,4245,3073,19.3,1931.5,red,0.86,3.25,21,20,red
4468741090,10,5,17,1,1,0,0,19190,7.2,18615,202,34,3386,2410,20.2,1919,5,10,8,1,0,1,0,15804,6.4,16205,224,48,-3386,-2410,22.4,1580.4,red,5.4,1.3,25,21,blue
4519229802,3,8,1,0,0,0,0,14269,6.6,16844,200,48,-3145,-2166,20,1426.9,8,3,10,1,1,0,0,17414,7.2,19010,235,53,3145,2166,23.5,1741.4,red,0.5,6,26,24,red
4464483348,1,5,0,1,1,0,0,14916,6.8,17511,239,59,-1325,-15,23.9,1491.6,5,1,8,0,0,0,0,16241,6.8,17526,251,33,1325,15,25.1,1624.1,red,0.2,13,20,22,red
4501451685,5,8,7,2,1,1,0,16256,7,17637,231,56,-1623,-1144,23.1,1625.6,8,5,9,0,0,0,0,17879,7,18781,243,48,1623,1144,24.3,1787.9,blue,1.5,3.4,18,14,red
4523922035,3,3,3,1,1,0,0,15231,7,17617,221,52,1076,759,22.1,1523.1,3,3,0,0,0,0,0,14155,6.8,16858,223,37,-1076,-759,22.3,1415.5,blue,2,1,21,26,red
4481186047,7,10,9,1,1,0,0,16070,6.6,16577,173,36,-1156,-667,17.3,1607,10,7,6,0,0,0,0,17226,6.6,17244,211,42,1156,667,21.1,1722.6,blue,1.6,2.29,21,20,red
4486987445,3,3,2,1,0,1,0,15416,6.8,17935,228,61,450,-9,22.8,1541.6,3,3,5,0,0,0,0,14966,6.8,17944,220,53,-450,9,22,1496.6,red,1.67,2.67,18,14,red
4509259241,7,5,4,1,0,1,2,19036,7,18857,246,47,4363,4467,24.6,1903.6,5,7,4,0,0,0,0,14673,5.8,14390,164,28,-4363,-4467,16.4,1467.3,blue,2.2,1.29,11,12,blue
4513456428,11,6,13,1,1,0,0,18214,7.2,19670,220,52,2262,2885,22,1821.4,6,11,6,0,0,0,0,15952,6.6,16785,228,34,-2262,-2885,22.8,1595.2,blue,4,1.09,23,22,blue
4507030336,6,9,7,0,0,0,0,17430,6.8,18068,212,63,-367,187,21.2,1743,9,6,9,0,0,0,0,17797,7.2,17881,205,60,367,-187,20.5,1779.7,red,1.44,3,22,18,blue
4520529866,6,3,7,0,0,0,0,16590,7.2,19041,228,39,1214,2080,22.8,1659,3,6,2,1,1,0,0,15376,6.8,16961,224,66,-1214,-2080,22.4,1537.6,blue,4.33,0.83,20,17,red
4525050175,4,1,6,1,1,0,0,15508,6.8,17062,217,48,1728,-337,21.7,1550.8,1,4,0,0,0,0,0,13780,6.8,17399,223,47,-1728,337,22.3,1378,blue,10,0.25,17,20,blue
4519754998,6,5,4,0,0,0,0,16789,7,19024,218,72,959,917,21.8,1678.9,5,6,5,1,1,0,0,15830,7,18107,213,52,-959,-917,21.3,1583,blue,2,1.67,28,20,blue
4439457123,5,5,6,1,0,1,0,16298,7,18210,230,60,924,323,23,1629.8,5,5,5,1,1,0,0,15374,6.8,17887,209,50,-924,-323,20.9,1537.4,blue,2.2,2,78,18,blue
4524643428,12,2,13,1,1,0,0,19320,7.4,20189,251,37,4544,3126,25.1,1932,2,12,2,0,0,0,0,14776,6.8,17063,206,52,-4544,-3126,20.6,1477.6,blue,12.5,0.33,23,21,blue
4521007618,4,11,4,2,1,1,0,14926,6.6,16530,210,45,-4847,-2983,21,1492.6,11,4,12,0,0,0,1,19773,7.4,19513,218,49,4847,2983,21.8,1977.3,red,0.73,5.75,15,34,red
4508648866,9,3,17,1,1,0,0,17496,7.4,18327,220,47,1849,669,22,1749.6,3,9,2,1,0,1,0,15647,6.8,17658,224,57,-1849,-669,22.4,1564.7,blue,8.67,0.56,80,18,blue
4481875944,7,11,7,0,0,0,0,15177,6.4,15795,152,36,-3891,-2689,15.2,1517.7,11,7,9,0,0,0,0,19068,7.2,18484,218,43,3891,2689,21.8,1906.8,blue,1.27,2.86,16,41,red
4481977173,6,9,8,0,0,0,0,17025,7,18038,231,40,-1314,-1942,23.1,1702.5,9,6,9,1,1,0,0,18339,7.4,19980,232,57,1314,1942,23.2,1833.9,red,1.56,3,16,19,blue
4524221277,9,5,14,0,0,0,0,18203,7.2,18324,223,48,2718,91,22.3,1820.3,5,9,5,0,0,0,0,15485,6.8,18233,216,48,-2718,-91,21.6,1548.5,blue,4.6,1.11,16,47,blue
4491767708,3,8,3,0,0,0,0,15160,7,17505,217,52,-2174,-1268,21.7,1516,8,3,12,2,1,1,0,17334,7.2,18773,227,64,2174,1268,22.7,1733.4,red,0.75,6.67,21,16,red
4513381950,4,1,2,1,1,0,0,15304,7,18188,228,48,1093,720,22.8,1530.4,1,4,1,0,0,0,0,14211,6.8,17468,215,56,-1093,-720,21.5,1421.1,blue,6,0.5,26,47,blue
4520706889,11,10,8,0,0,0,0,17503,6.8,17699,192,52,-215,-438,19.2,1750.3,10,11,13,0,0,0,0,17718,7,18137,210,42,215,438,21,1771.8,blue,1.9,2.09,20,56,red
4510979839,7,6,10,1,0,1,0,16468,6.4,15869,226,33,635,-1157,22.6,1646.8,6,7,6,1,1,0,0,15833,6.8,17026,228,54,-635,1157,22.8,1583.3,blue,2.83,1.71,18,54,blue
4497747862,10,10,10,0,0,0,0,19035,7.2,18221,219,38,120,1209,21.9,1903.5,10,10,10,1,0,1,1,18915,6.6,17012,208,31,-120,-1209,20.8,1891.5,blue,2,2,20,14,red
4499933829,10,9,11,1,1,0,0,18413,7.2,18554,219,60,194,661,21.9,1841.3,9,10,12,0,0,0,0,18219,6.8,17893,230,36,-194,-661,23,1821.9,blue,2.33,2.1,23,15,red
4444218395,9,2,21,1,1,0,0,18470,7.2,18925,263,51,3581,1578,26.3,1847,2,9,1,0,0,0,0,14889,6.8,17347,238,52,-3581,-1578,23.8,1488.9,blue,15,0.33,18,18,blue
4524806566,6,13,9,0,0,0,0,16291,6.6,16699,191,38,-3622,-2561,19.1,1629.1,13,6,12,0,0,0,0,19913,7,19260,223,39,3622,2561,22.3,1991.3,red,1.15,4.17,17,148,red
4462632051,6,6,9,1,1,0,0,16301,6.8,17430,210,51,-303,312,21,1630.1,6,6,11,1,0,1,0,16604,6.8,17118,210,59,303,-312,21,1660.4,blue,2.5,2.83,52,25,blue
4522260081,9,8,7,1,1,0,0,17183,7,18225,196,60,-1295,-305,19.6,1718.3,8,9,10,0,0,0,0,18478,7,18530,247,56,1295,305,24.7,1847.8,red,2,2,15,19,red
4455390955,1,5,1,0,0,0,0,13361,6.8,16819,174,48,-3006,-1880,17.4,1336.1,5,1,4,2,1,1,0,16367,7,18699,219,48,3006,1880,21.9,1636.7,red,0.4,9,40,15,red
4517939505,2,1,4,1,0,1,0,14807,6.8,17246,214,56,1090,371,21.4,1480.7,1,2,1,1,1,0,0,13717,6.6,16875,197,52,-1090,-371,19.7,1371.7,blue,6,1,43,18,blue
4524528416,4,3,1,1,1,0,0,15195,7,18358,217,70,324,1794,21.7,1519.5,3,4,2,0,0,0,0,14871,6.4,16564,228,35,-324,-1794,22.8,1487.1,blue,1.67,1.25,17,17,red
4525067296,3,7,2,0,0,0,0,14788,6.6,17345,215,48,-2025,-2448,21.5,1478.8,7,3,6,1,1,0,0,16813,7.2,19793,233,65,2025,2448,23.3,1681.3,blue,0.71,4.33,12,20,blue
4454069388,7,8,8,0,0,0,0,16604,6.6,17328,203,47,-416,-907,20.3,1660.4,8,7,11,1,1,0,0,17020,7,18235,201,55,416,907,20.1,1702,red,1.88,2.71,45,23,blue
4503433498,4,4,2,1,0,1,0,15661,7.2,18861,232,51,62,1154,23.2,1566.1,4,4,5,1,1,0,0,15599,6.8,17707,202,66,-62,-1154,20.2,1559.9,red,1.5,2.25,27,41,blue
4510734919,5,7,3,0,0,0,0,16259,6.6,17235,221,64,-67,-1341,22.1,1625.9,7,5,12,1,1,0,0,16326,7.2,18576,200,44,67,1341,20,1632.6,red,1.14,3.8,20,42,blue
4464447310,11,4,13,1,1,0,0,19716,7.2,19989,234,52,5163,3968,23.4,1971.6,4,11,4,0,0,0,0,14553,6.4,16021,182,51,-5163,-3968,18.2,1455.3,blue,6,0.73,23,15,red
4429977573,11,5,18,1,1,0,0,18612,7.2,19203,227,45,2728,1957,22.7,1861.2,5,11,6,0,0,0,0,15884,7,17246,225,48,-2728,-1957,22.5,1588.4,blue,5.8,1,21,15,blue
4522461341,3,9,1,1,1,0,0,14711,6.8,18284,204,52,-3559,-1400,20.4,1471.1,9,3,7,0,0,0,0,18270,7.2,19684,256,43,3559,1400,25.6,1827,red,0.44,5.33,28,45,red
4517741452,6,4,7,2,1,1,0,16886,6.8,18261,221,56,184,-131,22.1,1688.6,4,6,5,0,0,0,0,16702,7,18392,237,64,-184,131,23.7,1670.2,blue,3.25,1.5,38,20,blue
4500724758,4,7,4,1,1,0,0,14980,6.4,16983,206,39,-2040,-1012,20.6,1498,7,4,6,0,0,0,0,17020,7,17995,224,53,2040,1012,22.4,1702,red,1.14,3.25,20,18,blue
4494319705,6,1,9,1,1,0,0,16544,6.8,17551,208,56,2151,726,20.8,1654.4,1,6,3,0,0,0,0,14393,6.6,16825,222,51,-2151,-726,22.2,1439.3,blue,15,0.67,19,58,blue
4444096628,10,12,9,0,0,0,0,16174,6.6,16725,149,39,-2452,-1634,14.9,1617.4,12,10,8,0,0,0,0,18626,7,18359,210,35,2452,1634,21,1862.6,red,1.58,2,34,14,red
4521510642,7,4,7,2,1,1,0,18047,7.2,19362,228,64,3255,2259,22.8,1804.7,4,7,3,0,0,0,0,14792,6.8,17103,197,52,-3255,-2259,19.7,1479.2,blue,3.5,1,45,23,blue
4412240530,9,3,6,0,0,0,0,17484,7.4,20325,230,50,1128,858,23,1748.4,3,9,2,1,1,0,0,16356,7.4,19467,226,80,-1128,-858,22.6,1635.6,blue,5,0.56,36,18,blue
4420941972,6,5,7,1,0,1,1,17826,7.4,19427,225,67,1909,979,22.5,1782.6,5,6,3,0,0,0,0,15917,7,18448,220,48,-1909,-979,22,1591.7,blue,2.6,1.33,28,19,blue
4514097912,10,6,9,0,0,0,0,18673,6.8,18121,223,38,3397,1493,22.3,1867.3,6,10,8,0,0,0,0,15276,6.6,16628,186,44,-3397,-1493,18.6,1527.6,blue,3.17,1.4,20,17,red
4491135325,8,12,11,0,0,0,0,17540,7,17368,182,54,-3563,-1320,18.2,1754,12,8,22,1,1,0,0,21103,7.2,18688,198,74,3563,1320,19.8,2110.3,red,1.58,4.25,20,17,red
4488824515,7,9,4,1,1,0,0,16808,6.8,17370,231,38,-361,1686,23.1,1680.8,9,7,13,0,0,0,0,17169,6.4,15684,214,35,361,-1686,21.4,1716.9,red,1.22,3.14,19,20,blue
4515453856,4,3,3,1,0,1,0,15227,7,18442,203,60,-513,992,20.3,1522.7,3,4,4,0,0,0,0,15740,7,17450,226,57,513,-992,22.6,1574,blue,2.33,1.75,20,41,red
4420829528,11,4,12,0,0,0,0,19392,7.2,18570,239,48,4872,3076,23.9,1939.2,4,11,6,0,0,0,0,14520,6.2,15494,203,34,-4872,-3076,20.3,1452,blue,5.75,0.91,27,23,red
4503381304,6,7,5,1,0,1,0,17194,7.2,18397,234,62,985,2102,23.4,1719.4,7,6,7,0,0,0,0,16209,6.4,16295,215,51,-985,-2102,21.5,1620.9,red,1.57,2.33,36,17,red
4515654011,4,8,3,1,1,0,0,15672,7.2,17821,238,47,-1599,-1870,23.8,1567.2,8,4,9,1,0,1,0,17271,7.4,19691,236,48,1599,1870,23.6,1727.1,blue,0.88,4.25,18,22,blue
4492894390,11,4,15,1,1,0,0,18565,7.4,19562,216,58,1719,1703,21.6,1856.5,4,11,5,0,0,0,0,16846,7,17859,242,57,-1719,-1703,24.2,1684.6,blue,6.5,0.82,14,13,red
4472568378,1,6,0,0,0,0,0,13921,6.6,16963,207,56,-2641,-2207,20.7,1392.1,6,1,5,1,0,1,0,16562,7,19170,242,44,2641,2207,24.2,1656.2,red,0.17,11,18,19,red
4471422338,3,9,2,0,0,0,0,14521,6.6,16234,201,42,-2846,-2325,20.1,1452.1,9,3,11,2,1,1,0,17367,7.2,18559,229,48,2846,2325,22.9,1736.7,red,0.56,6.67,18,18,blue
4525151632,3,10,1,0,0,0,0,15049,6.6,17888,209,56,-3891,-2276,20.9,1504.9,10,3,12,1,1,0,0,18940,7.4,20164,221,78,3891,2276,22.1,1894,red,0.4,7.33,17,33,red
4519414547,13,4,11,1,1,0,0,20127,7,19575,234,48,6202,5368,23.4,2012.7,4,13,5,0,0,0,0,13925,6,14207,175,28,-6202,-5368,17.5,1392.5,blue,6,0.69,19,17,red
4440874432,3,2,5,0,0,0,0,17194,7.2,19539,253,68,2330,2167,25.3,1719.4,2,3,3,0,0,0,0,14864,6.8,17372,219,52,-2330,-2167,21.9,1486.4,blue,4,1.67,17,16,red
4471153063,9,7,8,0,0,0,0,19122,7.2,19334,238,56,3089,1750,23.8,1912.2,7,9,10,0,0,0,0,16033,6.8,17584,169,52,-3089,-1750,16.9,1603.3,red,2.43,1.89,16,13,blue
4522449120,7,6,7,0,0,0,0,16359,7,17998,198,41,540,867,19.8,1635.9,6,7,7,0,0,0,0,15819,6.6,17131,187,52,-540,-867,18.7,1581.9,blue,2.33,1.86,43,18,red
4501354453,5,4,5,1,0,1,0,17027,6.8,17816,213,56,508,-1704,21.3,1702.7,4,5,4,1,1,0,0,16519,7.4,19520,231,75,-508,1704,23.1,1651.9,blue,2.5,1.6,45,16,blue
4465050280,10,7,10,1,1,0,0,17665,7.4,18125,213,37,625,-1035,21.3,1766.5,7,10,4,0,0,0,0,17040,7.2,19160,228,71,-625,1035,22.8,1704,red,2.86,1.1,148,17,blue
4509589971,8,5,7,1,1,0,0,17209,7.2,18853,219,54,2481,1962,21.9,1720.9,5,8,3,0,0,0,0,14728,6.8,16891,195,46,-2481,-1962,19.5,1472.8,blue,3,1,46,21,blue
4505606908,10,5,9,1,1,0,0,19187,7.2,19762,211,64,2796,2669,21.1,1918.7,5,10,5,0,0,0,0,16391,6.6,17093,205,65,-2796,-2669,20.5,1639.1,blue,3.8,1,15,17,blue
4517684494,9,4,7,1,1,0,0,17482,7.2,19093,214,48,2089,2123,21.4,1748.2,4,9,4,0,0,0,0,15393,6.8,16970,222,43,-2089,-2123,22.2,1539.3,blue,4,0.89,24,17,red
4516180818,5,6,6,1,1,0,0,16035,6.8,16853,190,63,-608,-703,19,1603.5,6,5,8,0,0,0,0,16643,6.8,17556,210,48,608,703,21,1664.3,blue,1.83,2.8,21,53,blue
4524074861,7,9,6,0,0,0,0,16070,6.6,16510,199,44,-1923,-1753,19.9,1607,9,7,11,0,0,0,0,17993,7,18263,211,60,1923,1753,21.1,1799.3,red,1.44,2.86,15,18,blue
4524837884,5,5,5,0,0,0,0,15617,7,18169,209,48,-951,-546,20.9,1561.7,5,5,5,1,1,0,0,16568,7.2,18715,206,60,951,546,20.6,1656.8,red,2,2,12,45,red
4467397510,6,4,8,1,1,0,0,16130,6.8,17156,242,32,1428,701,24.2,1613,4,6,6,0,0,0,0,14702,6.6,16455,200,51,-1428,-701,20,1470.2,blue,3.5,1.67,22,23,blue
4498316560,8,5,9,1,1,0,0,17172,7,18972,196,60,1131,1145,19.6,1717.2,5,8,5,1,0,1,0,16041,6.8,17827,231,56,-1131,-1145,23.1,1604.1,red,3.4,1.25,19,15,blue
4494819577,4,7,4,1,0,1,0,15475,6.6,16428,195,56,-1972,-1010,19.5,1547.5,7,4,15,0,0,0,0,17447,6.8,17438,230,43,1972,1010,23,1744.7,red,1.14,5.5,47,18,red
4454214561,7,9,6,0,0,0,0,16248,7,18067,171,63,-2242,-1819,17.1,1624.8,9,7,12,1,1,0,0,18490,7.2,19886,229,45,2242,1819,22.9,1849,red,1.44,3,12,35,blue
4508718134,6,3,10,1,1,0,0,16745,6.6,17908,215,48,2287,-268,21.5,1674.5,3,6,3,1,0,1,0,14458,7,18176,180,68,-2287,268,18,1445.8,blue,5.33,1,16,15,blue
4518971206,7,4,8,0,0,0,0,16472,7.2,18966,219,53,1367,2396,21.9,1647.2,4,7,4,1,0,1,0,15105,6.6,16570,180,45,-1367,-2396,18,1510.5,red,3.75,1.14,23,19,red
4519649032,8,4,8,2,1,1,0,18133,7.4,20427,259,52,2580,2954,25.9,1813.3,4,8,4,0,0,0,0,15553,6.8,17473,214,52,-2580,-2954,21.4,1555.3,blue,4,1,17,18,blue
4487076086,11,7,20,1,1,0,0,17068,6.2,15357,153,32,786,-562,15.3,1706.8,7,11,8,0,0,0,0,16282,6.6,15919,199,40,-786,562,19.9,1628.2,red,4.43,1.36,100,18,red
4520419730,5,6,5,2,1,1,0,16635,7.4,19221,235,76,152,-57,23.5,1663.5,6,5,10,0,0,0,0,16483,7.4,19278,233,40,-152,57,23.3,1648.3,blue,1.67,3.2,20,40,blue
4510885108,8,4,9,0,0,0,0,17950,7.4,18805,226,44,2802,281,22.6,1795,4,8,3,1,1,0,0,15148,7,18524,213,56,-2802,-281,21.3,1514.8,blue,4.25,0.88,23,45,blue
4500739258,3,4,3,0,0,0,0,14494,6.4,15922,224,41,-1610,-1393,22.4,1449.4,4,3,2,1,1,0,0,16104,6.8,17315,239,53,1610,1393,23.9,1610.4,red,1.5,2,17,18,red
4524783374,14,10,9,0,0,0,0,18595,7,18307,199,48,1543,-21,19.9,1859.5,10,14,8,1,1,0,0,17052,7,18328,172,52,-1543,21,17.2,1705.2,blue,2.3,1.29,35,40,red
4465119134,15,11,14,0,0,0,0,19767,6.6,17678,180,42,1915,2606,18,1976.7,11,15,11,0,0,0,0,17852,6.4,15072,176,41,-1915,-2606,17.6,1785.2,blue,2.64,1.47,19,18,red
4515577349,4,3,7,1,1,0,0,14970,6.8,17530,212,52,-595,364,21.2,1497,3,4,1,0,0,0,0,15565,6.8,17166,238,51,595,-364,23.8,1556.5,blue,3.67,1,25,21,red
4465188797,6,7,5,0,0,0,0,15891,7,17964,207,41,-1190,-911,20.7,1589.1,7,6,4,0,0,0,0,17081,7,18875,224,54,1190,911,22.4,1708.1,red,1.57,1.83,15,15,blue
4523720024,5,1,3,1,0,1,0,16472,6.8,18393,252,48,1820,806,25.2,1647.2,1,5,2,1,1,0,0,14652,6.8,17587,239,60,-1820,-806,23.9,1465.2,blue,8,0.6,16,21,blue
4512168503,4,7,3,2,1,1,0,15210,6.8,17099,185,72,-2630,-2244,18.5,1521,7,4,6,0,0,0,0,17840,7.2,19343,222,71,2630,2244,22.2,1784,red,1,3.25,22,23,red
4441802146,8,8,9,0,0,0,0,16096,6.6,16891,175,36,-1327,-789,17.5,1609.6,8,8,9,1,1,0,0,17423,6.8,17680,198,56,1327,789,19.8,1742.3,blue,2.12,2.12,24,33,red
4525106974,8,4,10,0,0,0,0,16870,7.2,18433,207,36,1417,1016,20.7,1687,4,8,3,1,0,1,0,15453,6.8,17417,221,48,-1417,-1016,22.1,1545.3,blue,4.5,0.88,22,17,red
4519124601,4,4,3,1,1,0,0,15842,7,18640,240,60,71,409,24,1584.2,4,4,6,0,0,0,0,15771,7,18231,227,48,-71,-409,22.7,1577.1,red,1.75,2.5,20,22,blue
4469638547,5,4,0,0,0,0,0,15297,7,18319,202,57,17,1052,20.2,1529.7,4,5,2,1,1,0,0,15280,6.6,17267,210,48,-17,-1052,21,1528,blue,1.25,1.2,13,18,red
4520617571,8,7,8,2,1,1,0,16412,7,18381,212,44,151,840,21.2,1641.2,7,8,5,0,0,0,0,16261,7,17541,212,52,-151,-840,21.2,1626.1,red,2.29,1.5,18,15,blue
4520513993,10,3,9,1,1,0,0,19013,7.4,20151,225,60,4817,3220,22.5,1901.3,3,10,3,1,0,1,0,14196,6.8,16931,184,48,-4817,-3220,18.4,1419.6,blue,6.33,0.6,18,18,blue
4446190086,4,9,5,0,0,0,0,14842,6.6,16718,203,44,-3400,-2763,20.3,1484.2,9,4,11,1,1,0,0,18242,7.2,19481,241,66,3400,2763,24.1,1824.2,red,1,5,19,21,red
4479055235,6,8,5,0,0,0,0,16684,6.8,17071,213,46,-944,-556,21.3,1668.4,8,6,15,1,1,0,0,17628,6.8,17627,187,54,944,556,18.7,1762.8,red,1.38,3.83,18,37,blue
4525053035,4,8,6,1,1,0,0,15235,6.6,17625,195,49,-2839,18,19.5,1523.5,8,4,6,1,0,1,1,18074,7,17607,220,54,2839,-18,22,1807.4,red,1.25,3.5,16,14,red
4460529664,11,8,14,1,1,0,0,18159,6.8,17740,238,46,818,-165,23.8,1815.9,8,11,10,0,0,0,0,17341,6.8,17905,192,53,-818,165,19.2,1734.1,blue,3.12,1.64,17,65,blue
4489494920,2,9,4,0,0,0,0,13916,6.2,15087,166,49,-6286,-4733,16.6,1391.6,9,2,8,2,1,1,1,20202,7.6,19820,259,58,6286,4733,25.9,2020.2,red,0.67,8.5,13,35,red
4524863981,4,11,3,0,0,0,0,15107,6.6,16753,200,41,-3799,-3285,20,1510.7,11,4,10,1,1,0,0,18906,7.2,20038,226,45,3799,3285,22.6,1890.6,red,0.64,5.25,21,14,red
4508452416,8,2,4,2,1,1,1,18597,7.2,19612,243,52,4428,3489,24.3,1859.7,2,8,2,0,0,0,0,14169,6.6,16123,221,46,-4428,-3489,22.1,1416.9,blue,6,0.5,23,22,red
4518173580,9,1,9,0,0,0,0,18640,7.4,20923,249,63,4388,3527,24.9,1864,1,9,1,1,1,0,0,14252,6.8,17396,221,64,-4388,-3527,22.1,1425.2,blue,18,0.22,62,23,blue
4497643645,4,8,5,1,1,0,0,15483,6.6,17110,213,47,-3045,-1634,21.3,1548.3,8,4,11,0,0,0,0,18528,7.2,18744,249,40,3045,1634,24.9,1852.8,red,1.12,4.75,18,21,red
4496490767,2,4,3,0,0,0,0,15242,7,18202,260,56,-1497,-778,26,1524.2,4,2,9,1,0,1,0,16739,7.2,18980,257,52,1497,778,25.7,1673.9,red,1.25,6.5,18,19,red
4521137660,3,4,5,1,1,0,0,14945,6.4,16491,215,50,-1696,-2153,21.5,1494.5,4,3,3,0,0,0,0,16641,7,18644,226,53,1696,2153,22.6,1664.1,red,2,2.33,53,21,red
4522864178,8,7,8,0,0,0,0,17197,6.8,16987,185,48,733,-1480,18.5,1719.7,7,8,4,1,0,1,0,16464,7,18467,245,40,-733,1480,24.5,1646.4,blue,2.29,1.38,37,16,red
4418117776,9,10,11,1,1,0,0,17292,6.8,17127,200,50,-606,-1487,20,1729.2,10,9,10,0,0,0,0,17898,7,18614,197,50,606,1487,19.7,1789.8,blue,2,2.22,22,19,blue
4487261308,3,5,3,0,0,0,0,14822,7,18244,231,49,-2420,-753,23.1,1482.2,5,3,5,1,0,1,0,17242,7,18997,246,63,2420,753,24.6,1724.2,red,1.2,3.33,41,22,red
4472053682,3,8,2,0,0,0,0,15027,6.6,17054,211,56,-2037,110,21.1,1502.7,8,3,11,1,1,0,0,17064,6.6,16944,197,44,2037,-110,19.7,1706.4,red,0.62,6.33,16,21,red
4523322393,4,4,3,0,0,0,0,15502,6.6,17035,221,53,631,1404,22.1,1550.2,4,4,5,1,1,0,0,14871,6.4,15631,207,48,-631,-1404,20.7,1487.1,blue,1.75,2.25,18,23,red
4450801674,7,7,6,1,0,1,0,16931,7.2,18446,209,52,-1570,-2103,20.9,1693.1,7,7,9,1,1,0,0,18501,7.6,20549,228,80,1570,2103,22.8,1850.1,red,1.86,2.29,18,25,red
4518527027,7,7,11,1,1,0,0,16787,7.2,18466,201,55,-471,870,20.1,1678.7,7,7,9,0,0,0,0,17258,6.6,17596,229,38,471,-870,22.9,1725.8,blue,2.57,2.29,45,42,red
4515771570,3,4,4,0,0,0,0,15022,7,18105,220,48,-1211,-108,22,1502.2,4,3,5,0,0,0,0,16233,6.8,18213,216,67,1211,108,21.6,1623.3,blue,1.75,3,16,18,red
4503520980,7,2,6,1,0,1,0,17365,7.2,19227,245,44,2740,1708,24.5,1736.5,2,7,4,1,1,0,0,14625,7,17519,213,66,-2740,-1708,21.3,1462.5,blue,6.5,0.86,18,17,blue
4525008225,6,4,7,1,0,1,0,17658,7.2,19584,241,58,1947,2521,24.1,1765.8,4,6,6,0,0,0,0,15711,6.8,17063,247,42,-1947,-2521,24.7,1571.1,blue,3.25,1.67,30,38,red
4522447446,10,3,8,0,0,0,0,19549,7.4,20404,266,55,4712,3798,26.6,1954.9,3,10,1,0,0,0,0,14837,6.4,16606,203,56,-4712,-3798,20.3,1483.7,blue,6,0.4,19,30,blue
4500531155,5,4,6,1,1,0,0,16516,7.2,19033,224,52,1115,1256,22.4,1651.6,4,5,3,0,0,0,0,15401,7.2,17777,209,60,-1115,-1256,20.9,1540.1,red,2.75,1.4,41,41,blue
4524832772,4,5,5,0,0,0,0,15177,6.8,18017,189,55,-833,-116,18.9,1517.7,5,4,5,0,0,0,0,16010,7,18133,252,32,833,116,25.2,1601,blue,1.8,2.5,41,18,red
4521575223,11,7,9,0,0,0,0,18520,7.2,19054,220,48,564,633,22,1852,7,11,7,1,1,0,0,17956,6.8,18421,226,73,-564,-633,22.6,1795.6,blue,2.86,1.27,147,13,red
4502356627,10,10,11,1,0,1,0,18600,7.2,19763,183,83,-589,1794,18.3,1860,10,10,8,0,0,0,1,19189,7,17969,223,51,589,-1794,22.3,1918.9,red,2.1,1.8,40,16,blue
4502093881,9,4,8,0,0,0,0,18439,7,19278,249,38,3020,2593,24.9,1843.9,4,9,8,0,0,0,0,15419,6.6,16685,211,46,-3020,-2593,21.1,1541.9,blue,4.25,1.33,23,14,blue
4469976070,7,6,8,1,1,0,0,15632,6.2,15789,196,32,-1339,-2802,19.6,1563.2,6,7,8,1,0,1,0,16971,7,18591,216,67,1339,2802,21.6,1697.1,blue,2.5,2,16,19,blue
4515929996,10,4,17,1,1,0,0,17161,7,17817,157,48,1487,577,15.7,1716.1,4,10,3,1,0,1,0,15674,6.6,17240,203,68,-1487,-577,20.3,1567.4,red,6.75,0.7,23,19,blue
4522286152,5,3,5,2,1,1,0,15263,7,17693,216,36,579,-37,21.6,1526.3,3,5,1,0,0,0,0,14684,7,17730,245,45,-579,37,24.5,1468.4,blue,3.33,0.8,21,20,blue
4524966850,9,6,8,0,0,0,0,16396,6.6,17294,168,56,975,659,16.8,1639.6,6,9,4,0,0,0,0,15421,6.6,16635,191,48,-975,-659,19.1,1542.1,blue,2.83,1.11,12,19,blue
4491591979,10,6,11,1,1,0,0,17592,6.8,17430,186,47,1417,1171,18.6,1759.2,6,10,11,0,0,0,0,16175,6.6,16259,220,32,-1417,-1171,22,1617.5,blue,3.5,1.7,54,16,blue
4519588489,6,4,9,2,1,1,1,17802,7,18461,239,40,2768,1411,23.9,1780.2,4,6,3,0,0,0,0,15034,6.8,17050,211,60,-2768,-1411,21.1,1503.4,blue,3.75,1.17,25,19,blue
4520999253,13,6,25,0,0,0,0,20047,7.2,19339,226,56,3897,2558,22.6,2004.7,6,13,7,1,1,0,0,16150,6.6,16781,199,35,-3897,-2558,19.9,1615,blue,6.33,1,16,17,blue
4521050901,2,9,4,0,0,0,0,13795,6.6,16505,203,42,-4631,-3612,20.3,1379.5,9,2,11,1,1,0,0,18426,7.4,20117,229,66,4631,3612,22.9,1842.6,red,0.67,10,14,38,red
4516768081,4,5,4,0,0,0,0,15714,6.8,17852,243,63,-46,-458,24.3,1571.4,5,4,4,2,1,1,0,15760,7.2,18310,193,56,46,458,19.3,1576,red,1.6,2.25,19,16,red
4517685313,2,7,2,0,0,0,1,16418,7,17847,243,47,-258,-419,24.3,1641.8,7,2,9,1,1,0,0,16676,7,18266,211,40,258,419,21.1,1667.6,red,0.57,8,21,38,red
4502501913,9,3,8,1,1,0,0,18012,7.2,19378,261,60,2845,4032,26.1,1801.2,3,9,4,0,0,0,0,15167,6.2,15346,185,52,-2845,-4032,18.5,1516.7,blue,5.67,0.78,14,15,red
4518047197,3,10,3,0,0,0,0,14558,6.4,15833,194,42,-3177,-3271,19.4,1455.8,10,3,11,1,1,0,0,17735,7.2,19104,207,52,3177,3271,20.7,1773.5,red,0.6,7,18,37,red
4511912141,8,4,9,1,1,0,0,17779,6.8,18276,247,53,2988,398,24.7,1777.9,4,8,1,0,0,0,0,14791,7,17878,210,47,-2988,-398,21,1479.1,blue,4.25,0.62,15,15,blue
4489550843,6,3,5,1,1,0,0,16931,7,18085,225,54,2443,1566,22.5,1693.1,3,6,4,0,0,0,0,14488,6.4,16519,201,61,-2443,-1566,20.1,1448.8,blue,3.67,1.17,18,17,blue
4524701312,6,5,5,2,1,1,0,16555,6.8,18782,224,57,-11,-176,22.4,1655.5,5,6,5,0,0,0,0,16566,7.4,18958,227,56,11,176,22.7,1656.6,blue,2.2,1.67,18,19,blue
4490153462,5,6,8,1,1,0,0,16891,6.8,18030,185,48,286,17,18.5,1689.1,6,5,12,0,0,0,0,16605,6.8,18013,214,47,-286,-17,21.4,1660.5,blue,2.17,3.6,12,48,red
4502297992,6,7,6,2,1,1,0,16940,6.8,17580,222,39,90,-819,22.2,1694,7,6,5,0,0,0,0,16850,7,18399,219,48,-90,819,21.9,1685,red,1.71,2,31,42,blue
4491389277,7,6,5,0,0,0,0,17242,7.2,19085,236,53,403,1790,23.6,1724.2,6,7,9,0,0,0,0,16839,6.8,17295,216,47,-403,-1790,21.6,1683.9,blue,2,2.14,12,16,red
4522856174,8,1,12,0,0,0,0,17734,7.4,19335,207,52,3135,2622,20.7,1773.4,1,8,2,0,0,0,0,14599,6.6,16713,228,60,-3135,-2622,22.8,1459.9,blue,20,0.38,22,21,blue
4491480186,10,8,11,0,0,0,0,17982,7.2,18544,204,51,372,160,20.4,1798.2,8,10,8,1,1,0,0,17610,7,18384,223,50,-372,-160,22.3,1761,red,2.62,1.6,19,17,red
4518344857,6,8,10,1,1,0,0,16162,7,18095,211,48,-1636,-872,21.1,1616.2,8,6,14,0,0,0,0,17798,7.2,18967,226,60,1636,872,22.6,1779.8,blue,2,3.67,34,21,red
4515426111,12,1,11,2,1,1,0,18574,7.2,19415,227,56,5586,4058,22.7,1857.4,1,12,1,0,0,0,0,12988,6.4,15357,187,32,-5586,-4058,18.7,1298.8,blue,23,0.17,18,20,blue
4511966451,2,5,3,0,0,0,0,15123,6.8,17214,232,60,-2105,-1094,23.2,1512.3,5,2,6,1,1,0,0,17228,6.8,18308,234,48,2105,1094,23.4,1722.8,red,1,5.5,15,17,red
4519227071,6,8,4,1,0,1,0,16075,7,18425,211,60,-1374,-653,21.1,1607.5,8,6,8,1,1,0,0,17449,7.2,19078,237,43,1374,653,23.7,1744.9,blue,1.25,2.67,16,21,red
4493419240,3,8,4,0,0,0,0,14443,6.6,16433,198,40,-2166,-2885,19.8,1444.3,8,3,5,1,0,1,0,16609,7,19318,188,55,2166,2885,18.8,1660.9,red,0.88,4.33,16,23,red
4479961520,5,4,4,0,0,0,0,16656,7.2,18582,252,42,930,275,25.2,1665.6,4,5,6,0,0,0,0,15726,7.2,18307,205,48,-930,-275,20.5,1572.6,blue,2.25,2,16,16,red
4524526472,5,8,5,1,1,0,0,15938,6.8,17247,196,49,-950,-650,19.6,1593.8,8,5,8,0,0,0,0,16888,6.8,17897,185,65,950,650,18.5,1688.8,red,1.25,3.2,17,104,red
4464951728,1,2,2,1,1,0,0,14116,6.8,16837,217,51,-2421,-1685,21.7,1411.6,2,1,2,1,0,1,1,16537,6.8,18522,264,47,2421,1685,26.4,1653.7,blue,1.5,4,20,23,blue
4482394402,8,9,10,0,0,0,0,17054,7,17591,211,40,-891,-633,21.1,1705.4,9,8,13,1,1,0,0,17945,7,18224,219,32,891,633,21.9,1794.5,blue,2,2.75,22,16,red
4518002897,4,5,2,0,0,0,0,15306,7.2,17734,226,48,-211,232,22.6,1530.6,5,4,7,1,1,0,0,15517,7,17502,202,56,211,-232,20.2,1551.7,blue,1.2,3,41,20,red
4477006616,4,5,5,0,0,0,0,16193,7,18763,235,64,-405,-1523,23.5,1619.3,5,4,7,2,1,1,0,16598,7.4,20286,248,65,405,1523,24.8,1659.8,blue,1.8,3,15,21,blue
4440191249,10,7,8,0,0,0,0,18126,7.2,18581,222,40,2361,2502,22.2,1812.6,7,10,4,1,1,0,0,15765,6.2,16079,176,40,-2361,-2502,17.6,1576.5,blue,2.57,1.1,16,11,blue
4500995168,8,9,11,1,1,0,0,17592,6.8,17635,214,52,-134,-565,21.4,1759.2,9,8,10,0,0,0,0,17726,7,18200,221,45,134,565,22.1,1772.6,blue,2.11,2.38,17,21,red
4522793625,7,4,16,1,1,0,0,16282,6.4,16018,173,57,2062,1120,17.3,1628.2,4,7,9,0,0,0,0,14220,6.4,14898,174,44,-2062,-1120,17.4,1422,blue,5.75,1.86,19,17,blue
4474892602,6,3,7,1,0,1,0,17167,6.8,18274,247,59,2089,1771,24.7,1716.7,3,6,4,1,1,0,0,15078,6.4,16503,202,50,-2089,-1771,20.2,1507.8,blue,4.33,1.17,17,13,blue
4493006116,7,16,6,0,0,0,0,15679,6.4,16096,172,42,-5377,-3249,17.2,1567.9,16,7,22,2,1,1,0,21056,7.2,19345,230,60,5377,3249,23,2105.6,red,0.81,5.43,18,15,red
4524222412,7,7,5,1,1,0,0,16045,6.8,17256,216,48,-282,-79,21.6,1604.5,7,7,9,1,0,1,0,16327,7,17335,182,53,282,79,18.2,1632.7,blue,1.71,2.29,16,13,blue
4496972766,6,7,8,0,0,0,0,16564,7,18202,213,49,-443,-447,21.3,1656.4,7,6,4,0,0,0,0,17007,7,18649,216,46,443,447,21.6,1700.7,red,2,1.83,18,16,red
4520803035,2,8,3,0,0,0,0,14376,6.8,17660,208,60,-3122,-1229,20.8,1437.6,8,2,8,0,0,0,0,17498,7,18889,231,36,3122,1229,23.1,1749.8,red,0.62,8,15,41,red
4488885595,2,5,1,1,1,0,0,14128,6.6,16843,214,45,-2425,-1778,21.4,1412.8,5,2,4,0,0,0,0,16553,7.2,18621,233,55,2425,1778,23.3,1655.3,red,0.6,4.5,19,22,red
4487026164,3,5,2,0,0,0,0,14584,6.8,17432,201,45,-813,840,20.1,1458.4,5,3,5,1,1,0,0,15397,6.6,16592,195,52,813,-840,19.5,1539.7,blue,1,3.33,16,23,red
4473156248,9,8,8,0,0,0,0,18457,7.2,19590,218,64,1378,1678,21.8,1845.7,8,9,5,2,1,1,0,17079,6.8,17912,219,70,-1378,-1678,21.9,1707.9,blue,2.12,1.44,26,20,red
4518151873,7,7,6,0,0,0,0,18282,7,19001,240,56,1542,1059,24,1828.2,7,7,7,1,1,0,0,16740,7,17942,212,59,-1542,-1059,21.2,1674,red,1.86,2,36,20,red
4454844515,7,11,10,0,0,0,0,17130,7,18060,232,36,-1553,-424,23.2,1713,11,7,16,1,1,0,0,18683,7,18484,247,43,1553,424,24.7,1868.3,red,1.55,3.86,91,20,red
4524019093,8,0,12,1,1,0,0,17759,7.4,19034,249,55,4250,2686,24.9,1775.9,0,8,0,0,0,0,0,13509,6.4,16348,223,49,-4250,-2686,22.3,1350.9,blue,12.03,0,20,15,blue
4517744758,8,3,7,1,0,1,0,17194,7.2,18529,197,48,2772,2140,19.7,1719.4,3,8,3,0,0,0,0,14422,6.6,16389,188,44,-2772,-2140,18.8,1442.2,blue,5,0.75,17,59,blue
4472664560,6,6,8,1,1,0,0,16527,7,18240,225,59,-484,-1416,22.5,1652.7,6,6,5,0,0,0,0,17011,7.4,19656,221,67,484,1416,22.1,1701.1,blue,2.33,1.83,18,14,blue
4506715219,7,4,12,2,1,1,0,17915,7,18641,223,64,1110,-544,22.3,1791.5,4,7,6,0,0,0,0,16805,7.2,19185,235,72,-1110,544,23.5,1680.5,blue,4.75,1.43,20,15,blue
4525069847,5,4,6,1,0,1,1,17610,6.8,18110,232,57,1467,11,23.2,1761,4,5,6,1,1,0,0,16143,7,18099,222,56,-1467,-11,22.2,1614.3,red,2.75,2,20,47,red
4452361884,12,10,20,2,1,1,0,19453,6.8,18043,165,64,1095,94,16.5,1945.3,10,12,17,0,0,0,0,18358,6.8,17949,227,56,-1095,-94,22.7,1835.8,blue,3.2,2.25,18,16,blue
4440050075,7,1,5,1,1,0,1,18772,7.2,18771,255,55,5169,2153,25.5,1877.2,1,7,1,0,0,0,0,13603,6.6,16618,200,48,-5169,-2153,20,1360.3,blue,12,0.29,18,13,blue
4510518816,1,3,3,0,0,0,0,14626,6.6,17441,229,56,-1547,-916,22.9,1462.6,3,1,4,2,1,1,0,16173,7.2,18357,246,60,1547,916,24.6,1617.3,red,1.33,7,17,17,red
4496656923,13,3,21,0,0,0,0,20387,7,18610,232,35,5680,2175,23.2,2038.7,3,13,4,1,1,0,0,14707,6.4,16435,196,48,-5680,-2175,19.6,1470.7,blue,11.33,0.54,27,22,blue
4522525839,6,6,6,0,0,0,0,17256,7,18564,236,47,823,-164,23.6,1725.6,6,6,7,0,0,0,0,16433,7,18728,230,48,-823,164,23,1643.3,red,2,2.17,18,17,blue
4511649703,6,1,8,2,1,1,0,16601,7,18535,231,44,1799,442,23.1,1660.1,1,6,1,0,0,0,0,14802,6.8,18093,231,72,-1799,-442,23.1,1480.2,blue,14,0.33,64,15,blue
4451402051,1,3,1,1,0,1,0,14672,6.8,17598,247,50,-757,569,24.7,1467.2,3,1,3,1,1,0,0,15429,6.6,17029,242,48,757,-569,24.2,1542.9,red,0.67,6,25,23,red
4467311315,8,6,9,1,1,0,0,17001,6.8,17576,187,47,91,-339,18.7,1700.1,6,8,6,0,0,0,0,16910,7,17915,237,44,-91,339,23.7,1691,blue,2.83,1.5,93,22,blue
4515311611,8,11,6,1,0,1,1,18213,6.8,18240,217,55,-1538,-370,21.7,1821.3,11,8,16,1,1,0,1,19751,7.2,18610,225,48,1538,370,22.5,1975.1,red,1.27,3.38,44,29,red
4524615195,10,8,9,2,1,1,0,19862,7.8,20693,252,64,2228,1524,25.2,1986.2,8,10,8,0,0,0,0,17634,7.2,19169,228,57,-2228,-1524,22.8,1763.4,blue,2.38,1.6,14,15,red
4521321168,9,1,10,0,0,0,0,18179,7.2,19225,242,60,4869,3243,24.2,1817.9,1,9,0,1,1,0,0,13310,6.4,15982,210,44,-4869,-3243,21,1331,red,19,0.11,19,17,blue
4491850412,4,2,7,0,0,0,0,15796,6.8,17499,234,46,640,-120,23.4,1579.6,2,4,4,0,0,0,0,15156,7,17619,236,49,-640,120,23.6,1515.6,blue,5.5,1.5,23,22,red
4481745211,6,9,7,0,0,0,0,15377,6.6,16348,177,43,-1871,-1775,17.7,1537.7,9,6,6,0,0,0,0,17248,7,18123,227,32,1871,1775,22.7,1724.8,blue,1.44,2.5,35,28,red
4472572307,5,7,4,0,0,0,0,14874,6.6,16128,182,32,-2189,-1838,18.2,1487.4,7,5,7,1,1,0,0,17063,6.8,17966,207,61,2189,1838,20.7,1706.3,red,1.29,2.8,17,56,red
4522459455,7,9,8,0,0,0,0,17780,6.6,17456,245,40,474,-775,24.5,1778,9,7,10,0,0,0,0,17306,7,18231,207,51,-474,775,20.7,1730.6,red,1.67,2.71,22,16,blue
4513892324,7,12,8,0,0,0,0,16804,6.6,16732,184,52,-1072,-646,18.4,1680.4,12,7,16,0,0,0,0,17876,7,17378,194,24,1072,646,19.4,1787.6,red,1.25,4,16,15,red
4522503290,7,13,9,0,0,0,0,17372,6.8,17530,202,56,-2817,-1700,20.2,1737.2,13,7,17,1,1,0,0,20189,7.2,19230,218,58,2817,1700,21.8,2018.9,red,1.23,4.29,19,22,blue
4502582060,4,3,7,1,1,0,0,15162,6.6,16973,195,49,-243,-465,19.5,1516.2,3,4,4,0,0,0,0,15405,6.6,17438,235,53,243,465,23.5,1540.5,blue,3.67,1.75,21,23,red
4522240488,3,3,7,1,1,0,0,14742,6.6,16390,202,57,-1517,-1565,20.2,1474.2,3,3,5,0,0,0,0,16259,7,17955,255,49,1517,1565,25.5,1625.9,red,3.33,2.67,23,20,red
4448069997,0,6,0,0,0,0,0,13078,6.2,15827,184,61,-3205,-3400,18.4,1307.8,6,0,4,1,1,0,0,16283,7.4,19227,210,54,3205,3400,21,1628.3,red,0,12.65,14,35,red
4519920024,2,5,4,0,0,0,0,13886,6.6,17234,203,45,-2820,-2751,20.3,1388.6,5,2,1,1,1,0,0,16706,7.4,19985,255,72,2820,2751,25.5,1670.6,red,1.2,3,17,20,red
4524264644,7,3,13,1,1,0,0,16632,6.8,16709,212,32,1722,1010,21.2,1663.2,3,7,4,0,0,0,0,14910,6.2,15699,224,44,-1722,-1010,22.4,1491,blue,6.67,1,23,25,blue
4520641910,6,2,5,2,1,1,0,17215,7,19549,264,57,1978,1595,26.4,1721.5,2,6,2,0,0,0,0,15237,7,17954,199,71,-1978,-1595,19.9,1523.7,blue,5.5,0.67,14,14,blue
4505843833,11,9,8,0,0,0,0,17528,7,18271,191,48,171,618,19.1,1752.8,9,11,10,0,0,0,0,17357,6.6,17653,209,32,-171,-618,20.9,1735.7,blue,2.11,1.73,20,40,blue
4503939692,5,3,9,1,1,0,0,16555,7.2,19152,252,52,659,405,25.2,1655.5,3,5,3,1,0,1,0,15896,7,18747,238,57,-659,-405,23.8,1589.6,red,4.67,1.2,17,16,red
4521916214,6,11,7,1,1,0,0,15246,6.6,16135,174,43,-2974,-2746,17.4,1524.6,11,6,9,1,0,1,0,18220,7.2,18881,198,59,2974,2746,19.8,1822,blue,1.18,3.33,24,29,red
4506788897,3,9,3,0,0,0,0,14033,6.2,15049,184,44,-3078,-3306,18.4,1403.3,9,3,10,1,1,0,0,17111,7.4,18355,204,52,3078,3306,20.4,1711.1,red,0.67,6.33,97,24,red
4521424727,7,6,6,0,0,0,0,16778,7,17473,205,59,1153,282,20.5,1677.8,6,7,9,1,1,0,0,15625,6.6,17191,203,52,-1153,-282,20.3,1562.5,red,2.17,2.14,20,20,blue
4494894166,11,5,8,2,1,1,0,18960,7.4,20136,225,63,3878,2862,22.5,1896,5,11,3,0,0,0,0,15082,6.8,17274,204,43,-3878,-2862,20.4,1508.2,blue,3.8,0.73,17,18,blue
4518445145,5,1,5,2,1,1,0,17065,7,18930,220,54,2717,1557,22,1706.5,1,5,1,0,0,0,0,14348,7,17373,227,62,-2717,-1557,22.7,1434.8,blue,10,0.4,16,16,blue
4511985259,9,7,8,0,0,0,0,18283,7.4,19207,243,44,3038,3164,24.3,1828.3,7,9,5,1,1,0,0,15245,6.4,16043,147,52,-3038,-3164,14.7,1524.5,blue,2.43,1.33,92,28,blue
4470447299,4,7,6,0,0,0,0,15190,6.6,16345,196,47,-1903,-584,19.6,1519,7,4,14,1,1,0,0,17093,6.6,16929,206,64,1903,584,20.6,1709.3,red,1.43,5.25,20,46,red
4447747806,9,5,8,0,0,0,0,18192,6.8,18534,229,44,3518,2843,22.9,1819.2,5,9,7,1,1,0,0,14674,6.4,15691,188,32,-3518,-2843,18.8,1467.4,blue,3.4,1.33,15,12,blue
4492269154,7,7,12,0,0,0,0,17329,6.8,17342,212,60,216,259,21.2,1732.9,7,7,12,0,0,0,0,17113,6.8,17083,181,52,-216,-259,18.1,1711.3,blue,2.71,2.71,18,51,red
4463540440,5,8,3,0,0,0,0,16422,7,18934,247,52,-509,-196,24.7,1642.2,8,5,8,1,1,0,0,16931,6.8,19130,218,48,509,196,21.8,1693.1,red,1,3.2,36,16,blue
4445986200,9,6,14,0,0,0,0,17385,7,18061,208,36,978,372,20.8,1738.5,6,9,7,1,0,1,0,16407,7,17689,226,54,-978,-372,22.6,1640.7,red,3.83,1.44,13,21,red
4492063220,11,3,9,1,1,0,0,16663,7,18021,188,64,1884,1871,18.8,1666.3,3,11,2,0,0,0,0,14779,6.4,16150,208,40,-1884,-1871,20.8,1477.9,blue,6.67,0.45,55,18,blue
4519728493,10,4,13,1,0,1,0,17902,7.2,18882,186,50,2224,2062,18.6,1790.2,4,10,7,1,1,0,0,15678,6.6,16820,208,44,-2224,-2062,20.8,1567.8,blue,5.75,1.1,20,17,blue
4507920169,8,11,9,1,0,1,0,17398,7,18429,206,36,-1079,252,20.6,1739.8,11,8,7,1,1,0,0,18477,7,18177,233,44,1079,-252,23.3,1847.7,red,1.55,2.25,25,26,red
4517895985,5,7,6,0,0,0,0,15532,6.8,17712,201,40,-1768,-1778,20.1,1553.2,7,5,8,2,1,1,0,17300,7.4,19490,253,59,1768,1778,25.3,1730,red,1.57,3,16,18,red
4469859843,6,6,4,1,1,0,0,15412,6.8,17010,197,48,-886,-476,19.7,1541.2,6,6,8,0,0,0,0,16298,6.8,17486,205,52,886,476,20.5,1629.8,red,1.67,2.33,18,19,red
4494766750,9,3,16,0,0,0,0,17718,7,18091,209,48,3017,1450,20.9,1771.8,3,9,2,0,0,0,0,14701,6.8,16641,197,52,-3017,-1450,19.7,1470.1,blue,8.33,0.56,70,19,blue
4518283013,8,8,9,1,1,0,0,17055,7,17918,199,48,-431,120,19.9,1705.5,8,8,13,0,0,0,0,17486,7,17798,221,52,431,-120,22.1,1748.6,red,2.12,2.62,23,22,blue
4523501423,6,12,6,0,0,0,0,16020,6.8,17180,215,39,-2618,-2637,21.5,1602,12,6,7,0,0,0,0,18638,7.6,19817,212,52,2618,2637,21.2,1863.8,red,1,3.17,81,18,red
4498439649,6,6,6,2,1,1,0,16254,7,17969,203,48,-740,-665,20.3,1625.4,6,6,9,0,0,0,0,16994,7,18634,238,60,740,665,23.8,1699.4,red,2,2.5,23,20,blue
4521204334,12,5,13,1,0,1,0,19201,7.2,18883,214,67,3982,3457,21.4,1920.1,5,12,7,0,0,0,0,15219,6.2,15426,182,47,-3982,-3457,18.2,1521.9,blue,5,1,15,14,blue
4517631475,5,10,6,0,0,0,0,15994,6.8,17730,211,50,-2028,-1740,21.1,1599.4,10,5,7,1,1,0,0,18022,7.2,19470,242,58,2028,1740,24.2,1802.2,red,1.1,3.4,17,15,red
4524260253,10,4,8,1,0,1,2,20352,7.4,19537,232,57,5649,3668,23.2,2035.2,4,10,6,1,1,0,0,14703,6.4,15869,200,38,-5649,-3668,20,1470.3,blue,4.5,1,16,16,red
4516376461,0,9,0,0,0,0,0,12756,6.4,16250,190,54,-4949,-4010,19,1275.6,9,0,7,2,1,1,0,17705,7.4,20260,253,52,4949,4010,25.3,1770.5,red,0,12.65,10,17,red
4511656001,8,3,5,2,1,1,1,18661,7.4,19718,233,56,4867,4211,23.3,1866.1,3,8,7,0,0,0,0,13794,6.6,15507,169,40,-4867,-4211,16.9,1379.4,blue,4.33,1.25,18,15,blue
4504690323,2,6,2,2,1,1,0,15488,6.8,18660,265,67,-978,-226,26.5,1548.8,6,2,8,0,0,0,0,16466,7.2,18886,220,43,978,226,22,1646.6,red,0.67,7,22,22,red
4454879809,8,4,9,0,0,0,0,17547,7,18409,214,67,2425,1426,21.4,1754.7,4,8,6,0,0,0,0,15122,6.6,16983,233,38,-2425,-1426,23.3,1512.2,red,4.25,1.25,18,56,red
4524899991,12,6,11,1,1,0,0,19189,7.4,20302,227,49,3815,2726,22.7,1918.9,6,12,5,0,0,0,0,15374,6.6,17576,203,50,-3815,-2726,20.3,1537.4,blue,3.83,0.92,19,17,blue
4519607934,7,5,4,1,1,0,0,16749,7,18142,192,60,976,2257,19.2,1674.9,5,7,8,0,0,0,0,15773,6.6,15885,209,35,-976,-2257,20.9,1577.3,blue,2.2,1.86,47,15,blue
4497723883,5,4,6,1,1,0,0,16214,7.2,18139,257,54,862,-426,25.7,1621.4,4,5,3,0,0,0,0,15352,7,18565,219,56,-862,426,21.9,1535.2,blue,2.75,1.4,19,23,blue
4447721358,4,3,6,0,0,0,0,15500,7,18238,216,44,-403,-26,21.6,1550,3,4,3,1,1,0,0,15903,7,18264,242,54,403,26,24.2,1590.3,red,3.33,1.5,13,62,blue
4480073298,2,6,3,0,0,0,0,14735,7,17898,219,51,-2204,-1476,21.9,1473.5,6,2,5,1,0,1,0,16939,7.2,19374,243,52,2204,1476,24.3,1693.9,red,0.83,5.5,88,26,red
4524542194,9,9,11,1,1,0,0,17489,6.6,16724,221,40,-219,-1275,22.1,1748.9,9,9,13,0,0,0,0,17708,6.8,17999,226,44,219,1275,22.6,1770.8,blue,2.22,2.44,24,45,blue
4486943775,16,5,16,1,0,1,0,20380,7.2,20228,230,36,5330,4040,23,2038,5,16,3,1,1,0,0,15050,6.6,16188,173,44,-5330,-4040,17.3,1505,blue,6.4,0.5,15,20,blue
4470773670,9,4,12,2,1,1,0,18048,7,19194,227,61,3414,1608,22.7,1804.8,4,9,1,0,0,0,0,14634,6.8,17586,237,28,-3414,-1608,23.7,1463.4,blue,5.25,0.56,15,53,blue
4470307479,5,4,4,0,0,0,0,15843,6.6,16776,220,42,792,-622,22,1584.3,4,5,4,0,0,0,0,15051,6.8,17398,185,49,-792,622,18.5,1505.1,red,2.25,1.6,20,19,blue
4508403894,4,7,5,0,0,0,0,16810,7,18437,224,76,-146,-399,22.4,1681,7,4,8,2,1,1,0,16956,7,18836,235,49,146,399,23.5,1695.6,blue,1.29,3.75,26,24,blue
4497280145,5,5,5,1,0,1,0,15204,7,17694,182,40,-1578,-1724,18.2,1520.4,5,5,8,0,0,0,0,16782,7.2,19418,250,55,1578,1724,25,1678.2,red,2,2.6,17,18,blue
4484119748,5,6,5,0,0,0,0,16006,7,18385,225,40,-769,-701,22.5,1600.6,6,5,5,1,1,0,0,16775,7,19086,235,52,769,701,23.5,1677.5,blue,1.67,2.2,19,18,blue
4494270392,6,3,6,0,0,0,0,16746,7,17690,204,55,1860,1798,20.4,1674.6,3,6,5,0,0,0,0,14886,6.4,15892,225,38,-1860,-1798,22.5,1488.6,blue,4,1.33,16,16,red
4480070649,10,3,8,0,0,0,0,17648,7.2,18419,181,56,3525,2979,18.1,1764.8,3,10,4,0,0,0,0,14123,6.4,15440,183,44,-3525,-2979,18.3,1412.3,blue,6,0.7,20,17,blue
4514071420,12,8,18,1,1,0,0,18047,7,18071,202,44,679,-305,20.2,1804.7,8,12,7,1,0,1,0,17368,7,18376,206,44,-679,305,20.6,1736.8,blue,3.75,1.25,16,16,blue
4522475191,1,5,1,0,0,0,0,13976,6.6,17001,210,58,-2555,-1896,21,1397.6,5,1,4,1,1,0,0,16531,7.2,18897,234,68,2555,1896,23.4,1653.1,red,0.4,9,19,21,red
4521984962,11,6,5,0,0,0,0,17264,7.2,18859,196,38,765,425,19.6,1726.4,6,11,4,2,1,1,0,16499,7.2,18434,212,56,-765,-425,21.2,1649.9,red,2.67,0.91,73,24,blue
4461992783,6,8,6,0,0,0,0,16767,7,18062,228,53,-1221,-2380,22.8,1676.7,8,6,7,2,1,1,0,17988,7.4,20442,252,64,1221,2380,25.2,1798.8,red,1.5,2.5,61,17,blue
4498150653,10,6,10,0,0,0,0,19488,7.4,20329,230,67,4492,3211,23,1948.8,6,10,3,1,1,0,0,14996,6.8,17118,181,45,-4492,-3211,18.1,1499.6,blue,3.33,0.9,29,12,red
4523433938,3,4,4,0,0,0,0,15875,6.8,17351,241,42,186,-273,24.1,1587.5,4,3,4,0,0,0,0,15689,7.2,17624,232,45,-186,273,23.2,1568.9,red,1.75,2.67,16,43,red
4492342077,8,7,7,1,1,0,0,17717,7.4,19042,203,66,1227,996,20.3,1771.7,7,8,8,0,0,0,0,16490,6.8,18046,225,49,-1227,-996,22.5,1649,blue,2.14,1.88,15,14,blue
4520836773,5,7,1,1,0,1,0,16864,7,19251,240,57,-70,-456,24,1686.4,7,5,5,1,1,0,0,16934,7.6,19707,223,65,70,456,22.3,1693.4,blue,0.86,2.4,16,14,red
4473304091,3,4,3,0,0,0,0,14788,7,17425,227,46,-1605,-1335,22.7,1478.8,4,3,4,0,0,0,0,16393,7.2,18760,252,54,1605,1335,25.2,1639.3,red,1.5,2.67,41,20,red
4513103663,4,9,4,0,0,0,0,14743,6.4,15965,197,50,-3465,-3351,19.7,1474.3,9,4,10,1,1,0,0,18208,7.4,19316,224,74,3465,3351,22.4,1820.8,red,0.89,4.75,16,23,red
4469401946,11,10,20,1,0,1,0,17949,6.6,16183,172,41,-431,-1022,17.2,1794.9,10,11,10,1,1,0,0,18380,6.6,17205,207,48,431,1022,20.7,1838,red,3.1,1.82,20,46,blue
4525167024,8,7,9,0,0,0,0,17737,7.2,18303,193,50,1083,451,19.3,1773.7,7,8,2,0,0,0,0,16654,7.2,17852,207,44,-1083,-451,20.7,1665.4,blue,2.43,1.12,25,20,red
4523683062,5,6,5,0,0,0,0,15307,7,18407,218,39,-1259,-360,21.8,1530.7,6,5,12,0,0,0,0,16566,7.2,18767,250,47,1259,360,25,1656.6,red,1.67,3.6,18,26,red
4522023642,4,12,4,0,0,0,0,13973,6.2,15260,166,45,-6801,-4611,16.6,1397.3,12,4,14,1,0,1,1,20774,7.4,19871,234,44,6801,4611,23.4,2077.4,red,0.67,6.5,14,81,red
4454611264,7,10,8,1,1,0,0,18089,7.4,18770,225,77,1158,191,22.5,1808.9,10,7,8,1,0,1,0,16931,7.2,18579,202,38,-1158,-191,20.2,1693.1,blue,1.5,2.57,14,15,blue
4498185770,7,3,6,2,1,1,0,17224,7.2,18597,237,56,2053,1371,23.7,1722.4,3,7,4,0,0,0,0,15171,6.6,17226,237,43,-2053,-1371,23.7,1517.1,blue,4.33,1,21,20,blue
4491503560,11,7,12,0,0,0,0,17649,7.2,18664,187,42,604,1983,18.7,1764.9,7,11,8,1,1,0,0,17045,6.6,16681,187,62,-604,-1983,18.7,1704.5,blue,3.29,1.36,22,17,red
4520873803,3,7,5,1,0,1,1,16886,7,17965,244,53,75,616,24.4,1688.6,7,3,14,1,1,0,0,16811,7,17349,195,60,-75,-616,19.5,1681.1,blue,1.14,7,16,18,red
4525231930,2,4,2,0,0,0,0,14584,6.6,16647,235,47,-542,-927,23.5,1458.4,4,2,5,0,0,0,0,15126,6.8,17574,211,52,542,927,21.1,1512.6,red,1,4.5,19,15,blue
4525226675,9,7,13,0,0,0,0,17331,6.8,17982,201,59,1099,-98,20.1,1733.1,7,9,7,1,1,0,0,16232,6.8,18080,195,52,-1099,98,19.5,1623.2,blue,3.14,1.56,24,23,blue
4510119055,8,4,4,1,1,0,0,17763,7,18822,246,48,2183,263,24.6,1776.3,4,8,6,0,0,0,0,15580,7,18559,212,68,-2183,-263,21.2,1558,blue,3,1.25,92,15,blue
4522566957,4,4,5,2,1,1,0,16814,7,18549,220,70,791,224,22,1681.4,4,4,6,0,0,0,0,16023,7,18325,228,56,-791,-224,22.8,1602.3,blue,2.25,2.5,18,17,blue
4509204216,3,8,2,0,0,0,0,14500,6.6,16097,209,50,-3614,-3434,20.9,1450,8,3,10,1,0,1,0,18114,7.2,19531,222,60,3614,3434,22.2,1811.4,red,0.62,6,13,17,red
4429821639,11,2,9,2,1,1,0,17435,7,19432,236,52,1220,589,23.6,1743.5,2,11,2,0,0,0,0,16215,7,18843,241,68,-1220,-589,24.1,1621.5,red,10,0.36,13,16,blue
4458702644,4,5,3,0,0,0,0,14682,6.6,17105,199,50,-1827,-2059,19.9,1468.2,5,4,5,0,0,0,0,16509,7.4,19164,235,48,1827,2059,23.5,1650.9,red,1.4,2.5,15,18,blue
4474395162,8,5,8,0,0,0,0,16752,7,18737,229,32,583,751,22.9,1675.2,5,8,5,1,1,0,0,16169,7,17986,201,55,-583,-751,20.1,1616.9,red,3.2,1.25,19,16,red
4472343262,3,2,5,1,0,1,0,15649,7.2,18818,227,67,-334,-1054,22.7,1564.9,2,3,1,1,1,0,0,15983,7.4,19872,238,84,334,1054,23.8,1598.3,red,4,1,15,57,blue
4484797457,6,11,9,0,0,0,0,16124,7,17595,232,37,-2494,-1188,23.2,1612.4,11,6,18,1,1,0,0,18618,7,18783,230,50,2494,1188,23,1861.8,red,1.36,4.83,26,25,red
4469192486,18,13,6,0,0,0,1,21132,7.2,19294,236,44,2658,2407,23.6,2113.2,13,18,16,0,0,0,0,18474,6.6,16887,154,31,-2658,-2407,15.4,1847.4,blue,1.85,1.61,15,166,blue
4476350140,9,9,10,1,1,0,0,17569,6.8,17411,228,37,-116,-303,22.8,1756.9,9,9,11,1,0,1,0,17685,7,17714,207,45,116,303,20.7,1768.5,blue,2.11,2.22,21,22,red
4500418922,9,8,11,2,1,1,0,17097,6.8,16795,202,46,-197,-2391,20.2,1709.7,8,9,8,0,0,0,0,17294,7.2,19186,219,48,197,2391,21.9,1729.4,blue,2.5,1.78,19,79,blue
4516602474,7,5,8,0,0,0,0,16906,6.8,18034,218,52,760,521,21.8,1690.6,5,7,4,0,0,0,0,16146,6.8,17513,244,48,-760,-521,24.4,1614.6,red,3,1.29,19,18,red
4515880497,5,4,6,0,0,0,0,16632,7,18912,233,53,1224,1259,23.3,1663.2,4,5,5,1,1,0,0,15408,6.8,17653,228,40,-1224,-1259,22.8,1540.8,blue,2.75,1.8,19,42,red
4482285408,2,11,2,0,0,0,0,13449,6.4,15122,180,44,-6076,-3107,18,1344.9,11,2,12,1,0,1,1,19525,6.8,18229,193,55,6076,3107,19.3,1952.5,red,0.36,11.5,17,15,red
4509340231,8,11,9,1,1,0,0,16712,6.8,17809,190,35,-2339,-917,19,1671.2,11,8,19,0,0,0,0,19051,7.2,18726,228,40,2339,917,22.8,1905.1,red,1.55,3.75,14,42,red
4525224342,3,1,4,0,0,0,0,16372,7.2,18954,279,58,2590,1325,27.9,1637.2,1,3,0,1,1,0,0,13782,7,17629,226,53,-2590,-1325,22.6,1378.2,blue,7,0.33,15,23,blue
4450611631,9,5,6,1,1,0,0,17384,7.4,19286,235,56,2175,1409,23.5,1738.4,5,9,3,0,0,0,0,15209,7.2,17877,222,44,-2175,-1409,22.2,1520.9,red,3,0.89,19,26,blue
4519180415,6,7,10,1,1,0,0,17075,7,18328,229,57,1188,-284,22.9,1707.5,7,6,5,0,0,0,0,15887,7,18612,182,51,-1188,284,18.2,1588.7,red,2.29,2,18,12,blue
4458860802,11,7,7,0,0,0,0,18860,8,22224,233,60,1651,3902,23.3,1886,7,11,6,1,1,0,0,17209,7,18322,215,47,-1651,-3902,21.5,1720.9,red,2.57,1.18,22,21,red
4456272410,5,3,4,0,0,0,0,15381,7.2,19473,211,52,-187,2135,21.1,1538.1,3,5,5,1,1,0,0,15568,6.8,17338,238,48,187,-2135,23.8,1556.8,red,3,1.6,17,18,red
4524703970,2,9,2,0,0,0,0,13545,6.4,15716,180,51,-4868,-4160,18,1354.5,9,2,12,1,1,0,0,18413,7.4,19876,242,47,4868,4160,24.2,1841.3,red,0.44,10.5,17,17,red
4449048397,0,5,0,0,0,0,0,13256,6.4,16464,202,43,-4149,-3222,20.2,1325.6,5,0,4,1,0,1,0,17405,7,19686,272,48,4149,3222,27.2,1740.5,red,0,12.65,40,21,red
4492525886,3,6,1,0,0,0,0,14423,6.6,16966,219,48,-2602,-1426,21.9,1442.3,6,3,6,0,0,0,0,17025,7.2,18392,249,54,2602,1426,24.9,1702.5,red,0.67,4,14,19,red
4465850018,7,8,5,1,1,0,0,17551,7,18910,244,49,-1018,1114,24.4,1755.1,8,7,10,0,0,0,1,18569,7,17796,204,49,1018,-1114,20.4,1856.9,blue,1.5,2.57,20,28,blue
4502001730,11,6,12,0,0,0,0,19537,7,18358,189,60,2718,1185,18.9,1953.7,6,11,8,1,1,0,0,16819,7,17173,211,48,-2718,-1185,21.1,1681.9,blue,3.83,1.27,29,21,red
4468533756,17,5,16,1,1,0,0,20218,7.2,18620,199,40,4899,2415,19.9,2021.8,5,17,5,0,0,0,0,15319,6.4,16205,165,61,-4899,-2415,16.5,1531.9,blue,6.6,0.59,20,18,blue
4521433925,5,5,5,0,0,0,0,15191,6.6,16443,193,49,-1344,-2597,19.3,1519.1,5,5,4,1,1,0,0,16535,7,19040,207,76,1344,2597,20.7,1653.5,blue,2,1.8,20,15,red
4475994865,11,3,12,1,1,0,0,18802,7,18095,224,51,3781,1725,22.4,1880.2,3,11,2,0,0,0,0,15021,6.6,16370,222,44,-3781,-1725,22.2,1502.1,blue,7.67,0.45,25,20,blue
4514073335,7,3,3,1,1,0,0,17116,7.2,19290,237,65,3328,3696,23.7,1711.6,3,7,3,0,0,0,0,13788,6.4,15594,173,43,-3328,-3696,17.3,1378.8,blue,3.33,0.86,10,13,blue
4524501776,11,6,15,1,1,0,0,18230,6.8,17602,195,52,2114,75,19.5,1823,6,11,7,0,0,0,0,16116,6.8,17527,198,52,-2114,-75,19.8,1611.6,blue,4.33,1.18,20,16,blue
4523553248,6,7,3,1,1,0,0,15829,7,18055,228,48,-464,-47,22.8,1582.9,7,6,8,0,0,0,0,16293,7,18102,208,42,464,47,20.8,1629.3,red,1.29,2.5,27,52,blue
4520842765,4,2,2,2,1,1,0,14729,6.8,18508,228,40,-17,588,22.8,1472.9,2,4,1,0,0,0,0,14746,6.8,17920,192,69,17,-588,19.2,1474.6,blue,3,0.75,22,22,red
4519727542,8,7,9,0,0,0,0,17793,7,19086,208,77,1300,3056,20.8,1779.3,7,8,12,1,1,0,0,16493,6.4,16030,221,42,-1300,-3056,22.1,1649.3,blue,2.43,2.38,15,26,red
4521344335,7,0,15,2,1,1,0,17525,7.2,19534,240,53,3884,2315,24,1752.5,0,7,0,0,0,0,0,13641,6.8,17219,238,53,-3884,-2315,23.8,1364.1,blue,12.03,0,47,35,blue
4450770211,8,9,13,1,1,0,0,17579,7.2,18266,224,41,475,1006,22.4,1757.9,9,8,10,0,0,0,0,17104,6.8,17260,205,36,-475,-1006,20.5,1710.4,red,2.33,2.38,24,24,red
4498636614,7,4,7,2,1,1,0,18227,7.2,19568,256,61,2689,2827,25.6,1822.7,4,7,4,0,0,0,0,15538,6.6,16741,224,36,-2689,-2827,22.4,1553.8,blue,3.5,1.14,17,16,blue
4497665020,4,6,1,1,0,1,0,14898,7,17842,192,48,-1367,-197,19.2,1489.8,6,4,10,0,0,0,0,16265,6.8,18039,219,43,1367,197,21.9,1626.5,red,0.83,4,20,15,red
4464521946,4,8,3,1,1,0,0,15769,6.8,17360,222,59,-2999,-1476,22.2,1576.9,8,4,11,0,0,0,1,18768,7,18836,232,60,2999,1476,23.2,1876.8,red,0.88,4.75,21,21,blue
4523877309,12,12,17,1,0,1,1,19272,6.8,16786,188,36,-967,-965,18.8,1927.2,12,12,23,0,0,0,1,20239,7,17751,222,56,967,965,22.2,2023.9,red,2.42,2.92,31,21,red
4471300267,7,4,8,1,1,0,0,17788,7.2,19078,255,58,1969,1497,25.5,1778.8,4,7,4,1,0,1,0,15819,6.8,17581,234,49,-1969,-1497,23.4,1581.9,red,3.75,1.14,18,18,blue
4513704975,3,11,4,0,0,0,0,14738,6.4,17148,197,63,-4199,-3186,19.7,1473.8,11,3,7,1,1,0,0,18937,7.6,20334,241,56,4199,3186,24.1,1893.7,red,0.64,6,14,19,red
4524643923,5,6,2,0,0,0,0,16113,6.8,17058,231,39,-105,-896,23.1,1611.3,6,5,6,1,1,0,0,16218,7,17954,217,50,105,896,21.7,1621.8,blue,1.17,2.4,21,19,blue
4517829998,9,5,11,1,0,1,1,18967,7.2,17807,231,42,3652,1542,23.1,1896.7,5,9,7,0,0,0,0,15315,6.4,16265,194,44,-3652,-1542,19.4,1531.5,red,4,1.33,15,41,blue
4413023613,2,3,4,0,0,0,0,15416,7,18096,253,64,-83,-64,25.3,1541.6,3,2,3,1,1,0,0,15499,7.2,18160,230,68,83,64,23,1549.9,red,2,3,27,17,red
4499920365,9,5,8,0,0,0,0,18096,7.2,18969,232,36,2526,1379,23.2,1809.6,5,9,4,1,1,0,0,15570,6.8,17590,194,49,-2526,-1379,19.4,1557,red,3.4,1,17,18,blue
4506295504,3,6,1,1,1,0,0,14411,6.8,16806,210,54,-1864,-1945,21,1441.1,6,3,6,1,0,1,0,16275,7.2,18751,198,66,1864,1945,19.8,1627.5,red,0.67,4,15,19,red
4523734569,4,3,2,1,0,1,0,15668,7,18873,250,48,787,481,25,1566.8,3,4,1,1,1,0,0,14881,7,18392,221,60,-787,-481,22.1,1488.1,blue,2,1,20,20,blue
4512964599,7,7,8,1,0,1,0,16288,6.8,17321,193,68,-1222,-2334,19.3,1628.8,7,7,9,1,1,0,0,17510,7.2,19655,221,56,1222,2334,22.1,1751,red,2.14,2.29,20,16,blue
4508119465,11,11,13,0,0,0,0,18575,7.2,18974,198,49,-204,1350,19.8,1857.5,11,11,10,1,1,0,1,18779,6.8,17624,211,36,204,-1350,21.1,1877.9,red,2.18,1.91,17,41,blue
4456002030,6,5,4,1,1,0,0,17379,7.2,19080,251,64,1759,1710,25.1,1737.9,5,6,5,1,0,1,0,15620,6.8,17370,220,44,-1759,-1710,22,1562,red,2,1.67,18,62,blue
4518231271,3,8,3,1,1,0,0,15222,6.8,17667,220,55,-1650,-1358,22,1522.2,8,3,9,1,0,1,0,16872,7.2,19025,217,52,1650,1358,21.7,1687.2,red,0.75,5.67,15,71,red
4516926779,5,5,6,1,1,0,0,16191,7.2,18795,238,46,290,617,23.8,1619.1,5,5,3,0,0,0,0,15901,7.2,18178,242,44,-290,-617,24.2,1590.1,blue,2.2,1.6,20,18,blue
4506972533,2,5,3,1,1,0,0,14930,6.8,17328,231,61,-3418,-2689,23.1,1493,5,2,3,0,0,0,1,18348,7.4,20017,263,65,3418,2689,26.3,1834.8,red,1,4,9,16,blue
4460890614,7,4,8,0,0,0,0,17062,7.2,19299,238,58,1922,1870,23.8,1706.2,4,7,4,0,0,0,0,15140,6.8,17429,191,44,-1922,-1870,19.1,1514,red,3.75,1.14,17,21,blue
4519568140,4,8,5,0,0,0,0,14763,6.6,16159,205,44,-3584,-2457,20.5,1476.3,8,4,13,1,1,0,0,18347,7,18616,254,54,3584,2457,25.4,1834.7,red,1.12,5.25,16,16,red
4497751825,7,10,5,0,0,0,0,15351,6,13858,169,52,-2827,-2675,16.9,1535.1,10,7,11,1,1,0,0,18178,6.4,16533,181,52,2827,2675,18.1,1817.8,red,1.2,3,20,22,blue
4521417680,11,7,8,0,0,0,0,17625,7,18727,212,43,817,2322,21.2,1762.5,7,11,7,1,0,1,0,16808,6.6,16405,209,49,-817,-2322,20.9,1680.8,red,2.71,1.27,24,23,red
4510713012,3,3,5,0,0,0,0,15933,7.2,19079,259,52,75,536,25.9,1593.3,3,3,4,1,1,0,0,15858,7.2,18543,262,56,-75,-536,26.2,1585.8,blue,2.67,2.33,27,16,red
4509854436,11,14,8,0,0,0,0,18229,7.2,19238,198,48,-1502,-321,19.8,1822.9,14,11,14,1,1,0,0,19731,7.4,19559,186,43,1502,321,18.6,1973.1,red,1.36,2.55,15,12,red
4500976861,2,7,2,0,0,0,0,15356,7,17995,230,60,-1706,-1004,23,1535.6,7,2,7,1,1,0,0,17062,7,18999,209,71,1706,1004,20.9,1706.2,blue,0.57,7,39,23,red
4522637791,7,9,6,1,0,1,0,17005,6.8,18098,216,56,274,1018,21.6,1700.5,9,7,10,1,1,0,0,16731,6.6,17080,200,44,-274,-1018,20,1673.1,blue,1.44,2.71,18,22,red
4495935822,7,5,8,0,0,0,0,16747,6.8,18344,198,40,1058,1735,19.8,1674.7,5,7,9,1,1,0,0,15689,6.6,16609,198,46,-1058,-1735,19.8,1568.9,blue,3,2,24,27,red
4518693297,6,7,9,0,0,0,0,16060,6.6,16426,187,50,-1776,-3265,18.7,1606,7,6,7,0,0,0,0,17836,7.2,19691,248,60,1776,3265,24.8,1783.6,red,2.14,2.33,14,15,red
4496300604,5,9,8,0,0,0,0,14998,6.2,15234,197,40,-2698,-3640,19.7,1499.8,9,5,11,1,1,0,0,17696,7.2,18874,232,44,2698,3640,23.2,1769.6,red,1.44,4,18,18,blue
4522794083,6,7,7,0,0,0,0,16182,6.8,17791,221,49,-95,-1113,22.1,1618.2,7,6,11,1,1,0,0,16277,7,18904,216,60,95,1113,21.6,1627.7,red,1.86,3,28,22,blue
4520699104,8,8,7,1,0,1,0,17065,7.6,19772,214,51,519,1006,21.4,1706.5,8,8,6,1,1,0,0,16546,7,18766,204,51,-519,-1006,20.4,1654.6,red,1.88,1.75,14,15,blue
4510367501,3,4,4,1,1,0,0,15544,6.8,18579,222,80,-873,300,22.2,1554.4,4,3,2,0,0,0,0,16417,7,18279,240,56,873,-300,24,1641.7,red,1.75,2,19,18,blue
4505447619,4,9,8,1,1,0,0,16541,7,18666,225,60,-1514,-629,22.5,1654.1,9,4,8,0,0,0,0,18055,7.4,19295,239,45,1514,629,23.9,1805.5,blue,1.33,4.25,22,21,red
4471698975,6,5,9,1,1,0,0,15112,6.6,16369,184,43,-973,-674,18.4,1511.2,5,6,4,0,0,0,0,16085,6.8,17043,231,50,973,674,23.1,1608.5,blue,3,1.5,26,18,red
4434486038,8,11,7,0,0,0,0,17550,7,18186,229,48,-1499,-1282,22.9,1755,11,8,14,1,0,1,0,19049,7,19468,247,32,1499,1282,24.7,1904.9,red,1.36,3.12,19,18,red
4498511846,8,2,9,2,1,1,0,18323,7.4,20458,262,52,4011,2732,26.2,1832.3,2,8,0,0,0,0,0,14312,6.6,17726,208,58,-4011,-2732,20.8,1431.2,blue,8.5,0.25,25,23,blue
4524081937,6,1,5,2,1,1,2,18553,7,18785,248,48,4957,3218,24.8,1855.3,1,6,0,0,0,0,0,13596,6.4,15567,214,53,-4957,-3218,21.4,1359.6,blue,11,0.17,21,15,blue
4445293450,4,4,5,0,0,0,0,15252,6.8,17517,225,46,-615,-347,22.5,1525.2,4,4,3,1,1,0,0,15867,6.6,17864,229,54,615,347,22.9,1586.7,red,2.25,1.75,15,19,red
4513310043,7,8,3,0,0,0,0,16863,6.8,17725,206,42,783,-301,20.6,1686.3,8,7,7,1,1,0,0,16080,7,18026,186,44,-783,301,18.6,1608,blue,1.25,2.14,25,23,blue
4500568578,1,4,2,1,1,0,0,13925,7,18363,216,60,-3617,-1967,21.6,1392.5,4,1,5,0,0,0,0,17542,7.4,20330,260,80,3617,1967,26,1754.2,red,0.75,9,19,79,red
4524214463,7,5,8,0,0,0,0,16828,6.8,17273,217,35,912,-241,21.7,1682.8,5,7,5,1,1,0,0,15916,6.6,17514,217,60,-912,241,21.7,1591.6,blue,3,1.43,18,22,blue
4505836757,4,9,6,1,0,1,0,15391,6.6,16275,189,46,-2746,-2775,18.9,1539.1,9,4,7,0,0,0,0,18137,7,19050,247,43,2746,2775,24.7,1813.7,red,1.11,4,16,28,blue
4475217801,5,2,4,0,0,0,0,16350,7,18701,245,53,1290,1337,24.5,1635,2,5,2,0,0,0,0,15060,6.8,17364,236,54,-1290,-1337,23.6,1506,blue,4.5,0.8,24,43,blue
4488970376,6,6,7,0,0,0,0,17159,7.2,19172,223,56,-71,994,22.3,1715.9,6,6,8,1,1,0,0,17230,6.8,18178,229,43,71,-994,22.9,1723,blue,2.17,2.33,19,34,red
4524090743,4,8,3,1,0,1,0,15484,7.2,18316,226,50,-2528,-882,22.6,1548.4,8,4,11,1,1,0,0,18012,7.2,19198,236,56,2528,882,23.6,1801.2,red,0.88,4.75,18,43,red
4523042890,5,6,4,0,0,0,0,17024,7.2,19195,254,63,901,1182,25.4,1702.4,6,5,7,0,0,0,0,16123,6.8,18013,214,48,-901,-1182,21.4,1612.3,blue,1.5,2.6,18,14,blue
4517636777,10,6,13,0,0,0,0,18680,7.2,19206,220,61,2013,1022,22,1868,6,10,8,2,1,1,0,16667,6.8,18184,210,43,-2013,-1022,21,1666.7,blue,3.83,1.4,29,22,blue
4476445956,4,11,2,2,1,1,0,14657,6.8,16983,188,59,-3113,-1771,18.8,1465.7,11,4,20,0,0,0,0,17770,7.2,18754,201,45,3113,1771,20.1,1777,red,0.55,7.75,18,21,red
4490257266,6,9,5,1,1,0,0,15550,6.8,17134,191,44,-1467,-1916,19.1,1555,9,6,5,0,0,0,0,17017,7.2,19050,213,40,1467,1916,21.3,1701.7,red,1.22,2.33,13,17,blue
4524954038,6,12,3,1,1,0,0,15861,6.6,17082,208,47,-3197,-1400,20.8,1586.1,12,6,20,0,0,0,0,19058,7.4,18482,208,48,3197,1400,20.8,1905.8,red,0.75,5.33,25,19,red
4515523477,2,4,2,0,0,0,0,15202,7.2,19256,225,60,-31,849,22.5,1520.2,4,2,3,1,1,0,0,15233,7.2,18407,218,60,31,-849,21.8,1523.3,blue,1,3.5,24,76,red
4452314277,4,7,5,1,0,1,0,15214,6.8,16970,211,40,-802,-842,21.1,1521.4,7,4,6,1,1,0,0,16016,6.8,17812,209,52,802,842,20.9,1601.6,red,1.29,3.25,21,20,red
4523108166,8,8,12,1,1,0,0,16171,6.6,16898,214,43,-1642,-2040,21.4,1617.1,8,8,9,1,0,1,0,17813,7.2,18938,235,60,1642,2040,23.5,1781.3,red,2.5,2.12,22,20,blue
4520687269,9,4,5,0,0,0,0,18184,7.4,20169,238,52,2989,4519,23.8,1818.4,4,9,6,0,0,0,0,15195,6.4,15650,192,44,-2989,-4519,19.2,1519.5,red,3.5,1.11,69,41,red
4524971748,5,3,8,1,1,0,0,16751,6.8,17829,247,39,2197,1707,24.7,1675.1,3,5,1,0,0,0,0,14554,6.2,16122,193,60,-2197,-1707,19.3,1455.4,blue,4.33,0.8,24,12,blue
4523428789,6,1,8,1,1,0,0,16973,7,18787,250,55,2983,1577,25,1697.3,1,6,1,1,0,1,0,13990,6.8,17210,199,48,-2983,-1577,19.9,1399,red,14,0.33,17,17,red
4521032277,7,7,7,2,1,1,0,17239,7.4,19174,222,48,1167,2368,22.2,1723.9,7,7,7,0,0,0,0,16072,6.6,16806,182,58,-1167,-2368,18.2,1607.2,blue,2,2,19,14,red
4492093382,2,11,4,0,0,0,0,14660,6.6,17284,232,52,-3941,-2386,23.2,1466,11,2,19,1,1,0,0,18601,7.4,19670,195,56,3941,2386,19.5,1860.1,red,0.55,15,18,21,red
4520567149,9,8,11,1,1,0,0,17429,6.8,17309,211,48,720,-183,21.1,1742.9,8,9,10,0,0,0,0,16709,6.8,17492,210,50,-720,183,21,1670.9,red,2.5,2,23,20,blue
4455316787,8,3,8,0,0,0,0,18513,7.2,18739,250,40,4098,1004,25,1851.3,3,8,4,0,0,0,0,14415,6.8,17735,194,60,-4098,-1004,19.4,1441.5,blue,5.33,0.88,18,12,blue
4524702479,5,2,6,1,1,0,0,16225,6.8,17742,231,56,2430,2023,23.1,1622.5,2,5,2,0,0,0,0,13795,6.6,15719,179,52,-2430,-2023,17.9,1379.5,blue,5.5,0.8,18,17,blue
4516718833,5,5,5,1,1,0,0,16267,7,17908,247,60,206,-364,24.7,1626.7,5,5,5,0,0,0,0,16061,6.8,18272,228,54,-206,364,22.8,1606.1,red,2,2,17,18,blue
4476068972,3,4,4,0,0,0,0,15478,6.8,17551,233,59,-1003,-1571,23.3,1547.8,4,3,4,0,0,0,0,16481,7.2,19122,236,64,1003,1571,23.6,1648.1,red,1.75,2.67,18,16,blue
4468615107,7,3,10,2,1,1,0,16335,7.2,18087,212,56,600,-81,21.2,1633.5,3,7,3,0,0,0,0,15735,7,18168,246,56,-600,81,24.6,1573.5,red,5.67,0.86,90,18,red
4525109552,4,5,2,0,0,0,0,14826,6.8,16660,204,49,-1596,-1318,20.4,1482.6,5,4,7,1,0,1,0,16422,7,17978,214,57,1596,1318,21.4,1642.2,blue,1.2,3,20,20,red
4482138912,9,7,19,0,0,0,0,19092,7.2,19183,226,44,2035,1188,22.6,1909.2,7,9,8,1,1,0,0,17057,7,17995,214,56,-2035,-1188,21.4,1705.7,blue,4,1.67,21,20,blue
4523702225,10,7,9,1,0,1,0,17619,7.2,18563,186,49,1273,622,18.6,1761.9,7,10,4,1,1,0,0,16346,7,17941,186,57,-1273,-622,18.6,1634.6,red,2.71,1.1,22,18,blue
4524183803,9,8,9,0,0,0,0,16872,7,17906,199,36,-1232,-272,19.9,1687.2,8,9,6,1,1,0,0,18104,7,18178,225,48,1232,272,22.5,1810.4,blue,2.25,1.56,16,18,red
4524856340,8,5,9,1,1,0,0,17265,6.8,17683,233,43,1726,1423,23.3,1726.5,5,8,11,0,0,0,0,15539,6.4,16260,192,48,-1726,-1423,19.2,1553.9,blue,3.4,2,28,19,blue
4487632164,11,7,12,0,0,0,0,19308,7.2,18764,243,49,2036,2183,24.3,1930.8,7,11,9,0,0,0,0,17272,6.6,16581,164,44,-2036,-2183,16.4,1727.2,blue,3.29,1.45,22,19,blue
4506468475,7,8,8,1,1,0,0,16535,7,17930,230,28,-1123,-1665,23,1653.5,8,7,7,1,0,1,0,17658,7,19595,225,68,1123,1665,22.5,1765.8,blue,1.88,2.14,21,16,blue
4513861752,6,8,8,0,0,0,0,16606,7,18604,226,43,-1325,64,22.6,1660.6,8,6,11,1,1,0,0,17931,7.2,18540,233,56,1325,-64,23.3,1793.1,red,1.75,3.17,23,23,red
4424200095,9,9,10,1,1,0,0,17168,6.8,17668,212,40,-25,1849,21.2,1716.8,9,9,10,0,0,0,0,17193,6.6,15819,196,32,25,-1849,19.6,1719.3,red,2.11,2.11,19,24,blue
4518551407,4,4,6,0,0,0,0,14839,6.6,17555,215,41,-1089,-782,21.5,1483.9,4,4,1,0,0,0,0,15928,7,18337,225,63,1089,782,22.5,1592.8,red,2.5,1.25,33,41,red
4499657757,7,6,8,0,0,0,0,17812,7,18372,244,56,1745,1180,24.4,1781.2,6,7,10,1,1,0,0,16067,6.8,17192,216,60,-1745,-1180,21.6,1606.7,blue,2.5,2.29,17,17,blue
4498640810,3,5,4,0,0,0,0,14827,7,17341,201,41,-1838,-1584,20.1,1482.7,5,3,4,1,1,0,0,16665,7,18925,230,67,1838,1584,23,1666.5,red,1.4,3,20,39,red
4523696498,4,6,4,1,0,1,0,15578,6.8,17702,229,46,-1018,-1124,22.9,1557.8,6,4,6,0,0,0,0,16596,7,18826,240,51,1018,1124,24,1659.6,blue,1.33,3,21,22,red
4519675150,7,3,8,1,1,0,0,16628,6.8,17255,215,52,-105,1234,21.5,1662.8,3,7,5,1,0,1,1,16733,6.2,16021,213,46,105,-1234,21.3,1673.3,red,5,1.14,24,20,red
4522797583,3,4,6,1,1,0,0,14609,6.8,16875,218,37,-2141,-2439,21.8,1460.9,4,3,4,1,0,1,0,16750,7.2,19314,253,51,2141,2439,25.3,1675,red,2.25,2.67,19,44,blue
4492936245,1,7,1,0,0,0,0,13325,6.6,16064,171,52,-3573,-2497,17.1,1332.5,7,1,12,2,1,1,0,16898,7.2,18561,230,51,3573,2497,23,1689.8,red,0.29,19,43,21,red
4482256172,3,7,3,0,0,0,0,15277,6.8,17286,234,52,-2105,-88,23.4,1527.7,7,3,15,1,1,0,0,17382,7,17374,191,54,2105,88,19.1,1738.2,blue,0.86,7.33,24,22,red
4525023717,6,5,4,0,0,0,0,16287,6.6,17787,226,52,25,2,22.6,1628.7,5,6,9,0,0,0,0,16262,6.8,17785,226,45,-25,-2,22.6,1626.2,red,2,2.33,16,15,blue
4511080723,1,14,1,1,1,0,0,12747,6,14396,180,39,-6435,-5116,18,1274.7,14,1,10,0,0,0,0,19182,7.4,19512,227,57,6435,5116,22.7,1918.2,red,0.14,24,59,16,red
4477916243,9,9,7,1,1,0,0,17687,6.8,18503,206,56,-609,-504,20.6,1768.7,9,9,13,0,0,0,0,18296,7,19007,225,60,609,504,22.5,1829.6,red,1.78,2.44,13,17,blue
4489899716,8,4,6,1,0,1,0,17187,7,18382,232,39,1546,61,23.2,1718.7,4,8,3,0,0,0,0,15641,7.2,18321,240,55,-1546,-61,24,1564.1,blue,3.5,0.88,23,27,blue
4516181057,3,12,4,0,0,0,0,14015,6.4,15677,178,36,-4929,-3345,17.8,1401.5,12,3,16,1,1,0,0,18944,7.2,19022,228,48,4929,3345,22.8,1894.4,red,0.58,9.33,14,18,red
4506113045,6,6,5,0,0,0,0,16291,6.8,18130,228,44,164,-222,22.8,1629.1,6,6,6,0,0,0,0,16127,7,18352,227,40,-164,222,22.7,1612.7,blue,1.83,2,21,16,blue
4525159735,4,2,9,0,0,0,0,16289,7.4,19421,229,72,1025,1276,22.9,1628.9,2,4,1,2,1,1,0,15264,7,18145,271,48,-1025,-1276,27.1,1526.4,blue,6.5,0.75,16,18,red
4470997235,8,5,9,0,0,0,0,17234,7.2,18799,228,52,1474,1001,22.8,1723.4,5,8,5,0,0,0,0,15760,6.8,17798,201,60,-1474,-1001,20.1,1576,blue,3.4,1.25,19,16,blue
4470087448,3,8,4,0,0,0,0,14663,6.6,15749,201,41,-2454,-3816,20.1,1466.3,8,3,8,1,0,1,0,17117,7.4,19565,213,50,2454,3816,21.3,1711.7,red,0.88,5.33,20,17,blue
4465542010,5,5,4,1,0,1,0,16278,7,18389,244,56,269,480,24.4,1627.8,5,5,5,0,0,0,0,16009,7,17909,219,60,-269,-480,21.9,1600.9,blue,1.8,2,19,15,blue
4519070159,14,17,18,1,0,1,0,19025,6.8,16965,150,47,-524,-904,15,1902.5,17,14,9,1,1,0,0,19549,7,17869,185,60,524,904,18.5,1954.9,blue,1.88,1.86,18,17,red
4524509004,3,5,3,0,0,0,0,15366,7,17861,230,55,-1364,-87,23,1536.6,5,3,7,1,1,0,0,16730,6.8,17948,243,40,1364,87,24.3,1673,blue,1.2,4,18,17,red
4488138739,0,5,0,0,0,0,0,14526,6.8,17736,246,64,-2320,-1718,24.6,1452.6,5,0,6,1,1,0,0,16846,7.4,19454,248,60,2320,1718,24.8,1684.6,red,0,12.65,20,18,red
4494341320,4,2,8,1,1,0,0,16547,7.2,19666,259,64,1268,1705,25.9,1654.7,2,4,3,0,0,0,0,15279,7,17961,249,44,-1268,-1705,24.9,1527.9,blue,6,1.25,19,31,blue
4525085237,2,5,1,1,1,0,0,14936,7.2,17688,231,53,-1543,-509,23.1,1493.6,5,2,8,0,0,0,0,16479,7,18197,250,40,1543,509,25,1647.9,blue,0.6,6.5,13,16,blue
4522863300,5,11,3,1,1,0,0,15594,6.6,16987,213,55,-2997,-2029,21.3,1559.4,11,5,14,0,0,0,0,18591,7.2,19016,222,46,2997,2029,22.2,1859.1,red,0.73,5,18,24,red
4436047173,9,6,11,0,0,0,0,17416,7.2,18429,208,44,-367,-1771,20.8,1741.6,6,9,6,1,1,0,0,17783,7.4,20200,243,68,367,1771,24.3,1778.3,red,3.33,1.33,18,17,blue
4506779668,4,7,4,1,1,0,0,15722,6.8,17329,221,53,-3309,-2741,22.1,1572.2,7,4,9,0,0,0,1,19031,7.4,20070,230,60,3309,2741,23,1903.1,red,1.14,4,42,22,red
4524617778,3,2,2,1,0,1,0,16091,7.6,20383,256,76,1188,2851,25.6,1609.1,2,3,3,1,1,0,0,14903,7,17532,244,56,-1188,-2851,24.4,1490.3,red,2.5,1.67,45,22,blue
4472611324,6,3,6,0,0,0,0,15048,7,17356,183,34,-1138,-867,18.3,1504.8,3,6,3,1,1,0,0,16186,7,18223,253,54,1138,867,25.3,1618.6,red,4,1,32,24,blue
4457404294,17,10,25,0,0,0,1,23335,7.6,20839,239,52,6790,5348,23.9,2333.5,10,17,11,0,0,0,0,16545,6.4,15491,129,26,-6790,-5348,12.9,1654.5,blue,4.2,1.24,21,14,blue
4492916042,8,3,10,1,0,1,0,18272,7.2,19342,233,58,3723,3777,23.3,1827.2,3,8,3,1,1,0,0,14549,6.4,15565,196,51,-3723,-3777,19.6,1454.9,blue,6,0.75,21,16,blue
4481561513,5,5,6,1,1,0,0,16270,7.2,18195,223,54,748,-77,22.3,1627,5,5,5,0,0,0,0,15522,6.8,18272,208,55,-748,77,20.8,1552.2,red,2.2,2,27,46,red
4492740165,8,7,8,0,0,0,0,17298,6.4,16912,233,43,326,1472,23.3,1729.8,7,8,11,1,1,0,0,16972,6.4,15440,210,32,-326,-1472,21,1697.2,blue,2.29,2.25,21,18,red
4508812859,4,2,6,2,1,1,1,17230,6.6,17823,244,56,1449,-530,24.4,1723,2,4,5,0,0,0,0,15781,7,18353,229,77,-1449,530,22.9,1578.1,blue,5,1.75,22,42,blue
4481763565,10,9,9,1,1,0,0,17098,6.8,17045,201,35,-635,-1011,20.1,1709.8,9,10,9,0,0,0,0,17733,7.2,18056,208,54,635,1011,20.8,1773.3,red,2.11,1.8,19,24,blue
4524656242,8,6,11,1,0,1,0,17380,7,18220,211,64,1060,488,21.1,1738,6,8,9,1,1,0,0,16320,7,17732,215,56,-1060,-488,21.5,1632,red,3.17,1.88,23,27,blue
4520625705,6,9,4,1,0,1,1,16829,6.8,17978,198,48,-489,188,19.8,1682.9,9,6,11,1,1,0,0,17318,6.8,17790,216,47,489,-188,21.6,1731.8,red,1.11,3.33,12,21,red
4446002931,3,5,6,0,0,0,0,14538,6.8,16871,218,39,-2335,-2787,21.8,1453.8,5,3,6,1,1,0,0,16873,7.4,19658,236,80,2335,2787,23.6,1687.3,red,1.8,3.67,18,22,blue
4445858545,4,7,6,1,1,0,0,15159,6.6,17115,217,43,-2496,-2174,21.7,1515.9,7,4,6,1,0,1,0,17655,7.2,19289,240,52,2496,2174,24,1765.5,blue,1.43,3.25,26,20,blue
4479142877,5,8,3,0,0,0,0,14874,6.6,16504,177,44,-2695,-1042,17.7,1487.4,8,5,14,1,1,0,0,17569,6.8,17546,249,44,2695,1042,24.9,1756.9,red,1,4.4,29,23,red
4523771457,9,6,9,2,1,1,0,17721,7,18253,226,57,1160,939,22.6,1772.1,6,9,7,0,0,0,0,16561,6.8,17314,213,62,-1160,-939,21.3,1656.1,red,3,1.44,22,23,blue
4469758473,9,3,10,1,1,0,1,20273,7.2,19742,254,51,4982,1971,25.4,2027.3,3,9,4,0,0,0,0,15291,6.8,17771,195,74,-4982,-1971,19.5,1529.1,blue,6.33,0.78,18,39,blue
4500666491,13,6,13,1,1,0,1,20103,6.8,17668,220,32,4688,983,22,2010.3,6,13,4,0,0,0,0,15415,6.8,16685,172,44,-4688,-983,17.2,1541.5,blue,4.33,0.77,14,13,blue
4442547798,7,5,10,0,0,0,0,16491,6.8,17031,199,45,1774,1305,19.9,1649.1,5,7,5,0,0,0,0,14717,6.4,15726,170,34,-1774,-1305,17,1471.7,blue,3.4,1.43,21,21,blue
4497467264,8,3,8,1,1,0,0,17640,7.2,19566,233,56,2768,2761,23.3,1764,3,8,2,0,0,0,0,14872,6.6,16805,220,52,-2768,-2761,22,1487.2,blue,5.33,0.62,19,20,blue
4523849056,5,4,8,1,1,0,0,15518,6.6,16862,197,50,-686,-619,19.7,1551.8,4,5,5,1,0,1,0,16204,6.8,17481,249,49,686,619,24.9,1620.4,blue,3.25,1.8,28,25,blue
4448360530,7,5,5,2,1,1,0,17381,7,18495,220,52,1418,544,22,1738.1,5,7,5,0,0,0,0,15963,6.8,17951,225,56,-1418,-544,22.5,1596.3,red,2.4,1.43,14,15,blue
4519032722,3,3,1,1,1,0,0,15127,7,17750,238,52,-5,-269,23.8,1512.7,3,3,3,0,0,0,0,15132,7,18019,203,60,5,269,20.3,1513.2,red,1.33,2,19,39,red
4513335453,3,5,4,0,0,0,0,13794,6,14884,183,38,-4000,-2533,18.3,1379.4,5,3,5,0,0,0,1,17794,6.8,17417,245,44,4000,2533,24.5,1779.4,red,1.4,3.33,19,19,red
4489679008,3,4,0,0,0,0,0,15139,6.8,17354,240,48,-243,799,24,1513.9,4,3,10,1,1,0,0,15382,6.6,16555,206,52,243,-799,20.6,1538.2,blue,0.75,4.67,18,18,red
4496154110,3,5,6,0,0,0,0,15929,7.2,18460,229,64,-709,-147,22.9,1592.9,5,3,10,1,1,0,0,16638,7,18607,232,68,709,147,23.2,1663.8,red,1.8,5,20,19,blue
4524013226,2,5,3,2,1,1,0,14974,7,18286,224,60,-726,-31,22.4,1497.4,5,2,5,0,0,0,0,15700,7,18317,216,61,726,31,21.6,1570,blue,1,5,24,20,red
4524662465,11,4,18,1,1,0,0,19695,7.2,19512,258,48,3936,2111,25.8,1969.5,4,11,4,1,0,1,0,15759,7,17401,205,68,-3936,-2111,20.5,1575.9,blue,7.25,0.73,17,14,red
4518466773,4,4,0,1,1,0,0,15154,6.6,17000,219,54,-277,208,21.9,1515.4,4,4,7,0,0,0,0,15431,6.6,16792,224,43,277,-208,22.4,1543.1,blue,1,2.75,21,45,blue
4503636843,4,8,7,1,1,0,0,14766,6.6,16507,190,53,-2769,-820,19,1476.6,8,4,11,0,0,0,0,17535,6.8,17327,229,44,2769,820,22.9,1753.5,red,1.38,4.75,56,20,red
4515642015,9,4,11,1,1,0,0,17341,7,18528,209,48,1513,1585,20.9,1734.1,4,9,8,0,0,0,0,15828,7,16943,222,40,-1513,-1585,22.2,1582.8,red,5,1.33,20,25,red
4524429870,4,5,0,2,1,1,0,15464,7,17833,218,71,-736,-94,21.8,1546.4,5,4,9,0,0,0,0,16200,7,17927,223,60,736,94,22.3,1620,blue,0.8,3.5,15,27,blue
4450237694,8,9,9,0,0,0,0,18529,7.2,19610,251,63,1334,656,25.1,1852.9,9,8,11,1,1,0,0,17195,7,18954,202,60,-1334,-656,20.2,1719.5,blue,1.89,2.5,24,42,blue
4523092582,9,4,17,0,0,0,0,18149,7,18067,202,52,3036,1766,20.2,1814.9,4,9,5,1,1,0,0,15113,6.6,16301,222,40,-3036,-1766,22.2,1511.3,blue,6.5,1,18,19,red
4509907014,3,2,6,1,0,1,0,15840,6.6,16848,212,40,1811,-631,21.2,1584,2,3,1,1,1,0,0,14029,6.8,17479,221,48,-1811,631,22.1,1402.9,red,4.5,1,32,47,blue
4517834263,8,6,8,0,0,0,0,17915,7.2,19197,215,56,1451,1985,21.5,1791.5,6,8,9,0,0,0,0,16464,7,17212,222,47,-1451,-1985,22.2,1646.4,blue,2.67,1.88,15,16,blue
4420577274,5,5,7,1,0,1,0,16242,7,18244,235,56,-598,-146,23.5,1624.2,5,5,11,1,1,0,0,16840,7,18390,229,59,598,146,22.9,1684,red,2.4,3.2,22,26,blue
4496483924,10,6,10,1,1,0,0,18498,7.2,20017,238,56,1446,1597,23.8,1849.8,6,10,5,0,0,0,0,17052,7,18420,229,56,-1446,-1597,22.9,1705.2,blue,3.33,1.1,16,17,blue
4491903202,10,9,15,1,1,0,1,19120,6.8,17735,219,55,1618,393,21.9,1912,9,10,10,0,0,0,0,17502,6.8,17342,207,46,-1618,-393,20.7,1750.2,red,2.78,1.9,21,21,blue
4521293628,10,11,13,1,1,0,0,17948,6.6,16194,193,35,93,-1276,19.3,1794.8,11,10,13,0,0,0,0,17855,6.8,17470,219,40,-93,1276,21.9,1785.5,blue,2.09,2.4,19,20,red
4519886887,6,5,8,0,0,0,0,16517,6.6,17531,219,56,1183,887,21.9,1651.7,5,6,7,0,0,0,0,15334,6.6,16644,192,40,-1183,-887,19.2,1533.4,red,2.8,2,30,18,red
4494464754,3,7,0,0,0,0,0,13452,6.4,15569,170,37,-3453,-720,17,1345.2,7,3,10,1,1,0,0,16905,6.6,16289,212,46,3453,720,21.2,1690.5,red,0.43,5.67,23,22,red
4519903603,5,10,3,0,0,0,0,15687,6.6,17057,210,58,-1655,-1323,21,1568.7,10,5,12,1,1,0,0,17342,7.2,18380,215,45,1655,1323,21.5,1734.2,red,0.8,4.4,18,18,red
4506004524,5,11,4,1,1,0,0,14763,6.8,16834,179,47,-4462,-2990,17.9,1476.3,11,5,11,0,0,0,0,19225,7.2,19824,255,51,4462,2990,25.5,1922.5,red,0.82,4.4,45,15,red
4494780528,7,6,8,0,0,0,0,16417,6.6,16981,211,56,557,1061,21.1,1641.7,6,7,9,0,0,0,0,15860,6.8,15920,194,48,-557,-1061,19.4,1586,red,2.5,2.14,15,17,red
4524049652,9,4,10,0,0,0,0,18168,7.4,20892,254,45,2527,3473,25.4,1816.8,4,9,6,0,0,0,0,15641,6.8,17419,220,52,-2527,-3473,22,1564.1,blue,4.75,1.11,17,14,blue
4516959176,7,8,9,0,0,0,0,15903,6.8,17263,189,40,-1831,-2604,18.9,1590.3,8,7,11,2,1,1,0,17734,7.2,19867,226,72,1831,2604,22.6,1773.4,red,2,2.71,19,16,red
4520642578,2,1,1,1,0,1,0,14702,6.6,16741,244,43,649,69,24.4,1470.2,1,2,1,1,1,0,0,14053,6.8,16672,214,42,-649,-69,21.4,1405.3,blue,3,1,23,25,blue
4484713894,11,5,10,0,0,0,0,18874,7.2,19652,224,41,3091,2498,22.4,1887.4,5,11,7,0,0,0,0,15783,6.6,17154,215,37,-3091,-2498,21.5,1578.3,red,4.2,1.09,17,22,red
4449831560,3,10,3,1,1,0,0,15225,7,17939,211,58,-2707,-1826,21.1,1522.5,10,3,11,0,0,0,0,17932,7.4,19765,209,52,2707,1826,20.9,1793.2,red,0.6,7,18,16,red
4464836293,4,5,7,0,0,0,0,15858,6.8,17491,246,44,-512,-844,24.6,1585.8,5,4,6,2,1,1,0,16370,7,18335,241,52,512,844,24.1,1637,red,2.2,2.75,21,23,red
4524322157,4,9,6,0,0,0,0,14693,6.6,15883,169,41,-3874,-2423,16.9,1469.3,9,4,13,0,0,0,0,18567,7,18306,223,43,3874,2423,22.3,1856.7,red,1.11,5.5,18,17,red
4519807655,3,2,3,1,1,0,0,15574,6.8,17686,217,68,-100,219,21.7,1557.4,2,3,2,0,0,0,0,15674,6.6,17467,240,48,100,-219,24,1567.4,blue,3,1.33,18,20,blue
4523790678,3,5,2,0,0,0,0,15692,6.6,17765,221,67,506,1580,22.1,1569.2,5,3,8,1,1,0,0,15186,6.8,16185,182,40,-506,-1580,18.2,1518.6,red,1,4.33,69,21,red
4481146678,9,1,13,0,0,0,0,18297,7.2,19315,251,52,4796,3112,25.1,1829.7,1,9,0,0,0,0,0,13501,6.4,16203,203,53,-4796,-3112,20.3,1350.1,blue,22,0.11,14,13,blue
4382920718,15,16,10,2,1,1,0,19247,6.8,16835,205,44,-1709,-1585,20.5,1924.7,16,15,16,0,0,0,0,20956,7,18420,182,44,1709,1585,18.2,2095.6,blue,1.56,2.13,24,86,red
4522131517,1,7,1,0,0,0,0,15414,6.8,17341,236,54,-553,-114,23.6,1541.4,7,1,8,0,0,0,0,15967,7,17455,194,48,553,114,19.4,1596.7,red,0.29,15,14,17,red
4522409502,10,7,15,1,1,0,0,19601,7.4,20002,227,76,3190,2346,22.7,1960.1,7,10,8,1,0,1,0,16411,6.8,17656,214,44,-3190,-2346,21.4,1641.1,blue,3.57,1.5,23,17,red
4522867011,3,6,0,1,0,1,0,15189,6.6,17014,225,56,-1720,-2056,22.5,1518.9,6,3,3,1,1,0,0,16909,7.2,19070,248,61,1720,2056,24.8,1690.9,red,0.5,3,16,16,red
4489166333,5,9,3,0,0,0,0,16452,6.6,17540,232,51,-480,353,23.2,1645.2,9,5,10,0,0,0,0,16932,6.8,17187,192,32,480,-353,19.2,1693.2,red,0.89,3.8,17,16,blue
4521309700,2,5,3,0,0,0,0,14899,6.8,17481,238,40,-1081,-631,23.8,1489.9,5,2,6,1,1,0,0,15980,6.8,18112,209,60,1081,631,20.9,1598,red,1,5.5,17,25,red
4522235409,9,1,9,1,1,0,0,18964,7.2,19620,255,44,5436,3459,25.5,1896.4,1,9,1,0,0,0,0,13528,6.4,16161,183,50,-5436,-3459,18.3,1352.8,blue,18,0.22,18,26,blue
4487639972,12,1,14,1,1,0,0,18923,7,18586,236,44,5323,2352,23.6,1892.3,1,12,1,0,0,0,0,13600,6.4,16234,191,56,-5323,-2352,19.1,1360,blue,26,0.17,24,56,blue
4495602033,7,8,8,0,0,0,0,17472,6.8,18276,229,52,-214,-356,22.9,1747.2,8,7,9,2,1,1,0,17686,7,18632,211,52,214,356,21.1,1768.6,red,1.88,2.43,19,16,red
4521631816,3,9,2,1,1,0,0,14665,6.2,15990,188,42,-2705,-1757,18.8,1466.5,9,3,9,0,0,0,0,17370,7.2,17747,226,32,2705,1757,22.6,1737,red,0.56,6,18,19,red
4451877968,5,3,4,1,0,1,0,16415,6.8,17432,213,38,1419,82,21.3,1641.5,3,5,2,1,1,0,0,14996,6.8,17350,223,52,-1419,-82,22.3,1499.6,blue,3,1,17,27,blue
4511243744,2,11,2,0,0,0,0,13960,6.4,15286,191,48,-5431,-4681,19.1,1396,11,2,10,0,0,0,1,19391,7.4,19967,200,57,5431,4681,20,1939.1,red,0.36,10.5,22,39,red
4448363210,2,11,3,0,0,0,0,14773,6.6,16673,202,53,-4125,-2712,20.2,1477.3,11,2,11,1,1,0,0,18898,7.2,19385,237,50,4125,2712,23.7,1889.8,red,0.45,11,16,23,red
4521244850,11,5,11,2,1,1,0,19181,7.4,19634,247,50,3153,3196,24.7,1918.1,5,11,10,0,0,0,0,16028,6.6,16438,185,61,-3153,-3196,18.5,1602.8,blue,4.4,1.36,13,14,blue
4464253176,5,8,1,1,1,0,0,14528,6.4,16282,175,49,-3991,-3529,17.5,1452.8,8,5,3,0,0,0,0,18519,7.4,19811,239,71,3991,3529,23.9,1851.9,red,0.75,2.2,16,35,blue
4473903480,6,7,3,0,0,0,0,15827,6.6,17709,218,47,-1694,-603,21.8,1582.7,7,6,6,1,0,1,0,17521,7,18312,239,50,1694,603,23.9,1752.1,red,1.29,2.17,18,15,red
4508507583,6,4,4,1,0,1,0,16179,6.8,17928,215,52,989,631,21.5,1617.9,4,6,3,0,0,0,0,15190,6.8,17297,212,44,-989,-631,21.2,1519,red,2.5,1.17,20,28,red
4453485597,3,5,5,1,1,0,0,15049,6.8,17760,247,45,-1564,-953,24.7,1504.9,5,3,4,0,0,0,0,16613,7.2,18713,242,67,1564,953,24.2,1661.3,blue,1.6,3,20,16,red
4444095470,3,8,2,0,0,0,0,15453,7.2,18464,209,63,-664,615,20.9,1545.3,8,3,8,1,1,0,0,16117,7,17849,180,48,664,-615,18,1611.7,red,0.62,5.33,20,21,red
4510669887,1,2,0,1,1,0,0,14645,7.2,18690,256,52,-1377,-180,25.6,1464.5,2,1,2,1,0,1,0,16022,7.2,18870,289,56,1377,180,28.9,1602.2,blue,0.5,4,42,52,red
4510131144,6,7,10,1,1,0,0,15766,6.8,16285,197,40,-1089,-2134,19.7,1576.6,7,6,6,0,0,0,0,16855,7,18419,226,38,1089,2134,22.6,1685.5,red,2.29,2.17,17,17,red
4514754903,7,2,10,2,1,1,1,18890,7.2,18772,227,67,4234,1695,22.7,1889,2,7,3,0,0,0,0,14656,6.6,17077,214,48,-4234,-1695,21.4,1465.6,blue,8.5,0.71,18,58,blue
4521127128,6,7,7,1,0,1,0,16450,7,18541,238,48,-702,-89,23.8,1645,7,6,10,1,1,0,0,17152,7,18630,226,47,702,89,22.6,1715.2,red,1.86,2.83,19,14,red
4517995576,6,5,5,1,0,1,0,16490,6.8,17576,225,48,-508,-1394,22.5,1649,5,6,3,1,1,0,0,16998,7.2,18970,257,72,508,1394,25.7,1699.8,red,2.2,1.33,39,17,blue
4525139840,10,4,13,0,0,0,0,17408,7.2,18740,193,47,2366,1147,19.3,1740.8,4,10,5,1,1,0,0,15042,6.8,17593,231,44,-2366,-1147,23.1,1504.2,blue,5.75,0.9,19,18,blue
4481425277,6,6,12,1,1,0,0,16951,7,18426,229,49,248,-219,22.9,1695.1,6,6,7,1,0,1,0,16703,6.8,18645,245,60,-248,219,24.5,1670.3,blue,3,2.17,19,16,red
4508272671,9,5,11,1,1,0,0,17120,7,17636,163,56,1426,128,16.3,1712,5,9,2,0,0,0,0,15694,6.8,17508,207,52,-1426,-128,20.7,1569.4,blue,4,0.78,18,21,blue
4521954992,2,2,2,0,0,0,0,14310,7,17797,207,44,-740,76,20.7,1431,2,2,2,1,1,0,0,15050,7,17721,242,47,740,-76,24.2,1505,red,2,2,19,19,red
4506951089,2,4,2,2,1,1,0,14689,6.8,18046,241,44,-1724,-262,24.1,1468.9,4,2,4,0,0,0,0,16413,7,18308,260,52,1724,262,26,1641.3,red,1,4,20,30,red
4513445048,8,4,10,1,1,0,0,18341,7.4,19070,217,76,3311,2682,21.7,1834.1,4,8,3,0,0,0,0,15030,6.6,16388,228,44,-3311,-2682,22.8,1503,blue,4.5,0.88,18,14,blue
4519606068,6,3,10,0,0,0,0,17772,7.2,19337,251,68,3401,2392,25.1,1777.2,3,6,2,1,1,0,0,14371,6.6,16945,204,53,-3401,-2392,20.4,1437.1,red,5.33,0.83,15,53,blue
4518115415,4,7,4,0,0,0,0,16262,7,18551,224,70,-1293,-625,22.4,1626.2,7,4,5,0,0,0,0,17555,7.2,19176,243,50,1293,625,24.3,1755.5,red,1.14,3,42,14,blue
4452789398,5,3,7,0,0,0,0,16239,7.2,18466,189,60,906,1767,18.9,1623.9,3,5,3,1,1,0,0,15333,6.6,16699,221,60,-906,-1767,22.1,1533.3,blue,4,1.2,27,14,red
4493650518,6,12,9,0,0,0,0,16944,7,17663,193,52,-2761,-2375,19.3,1694.4,12,6,12,1,1,0,0,19705,7.4,20038,227,52,2761,2375,22.7,1970.5,red,1.25,4,20,17,red
4501126526,6,4,12,2,1,1,0,16939,7,17733,211,56,1419,731,21.1,1693.9,4,6,6,0,0,0,0,15520,6.6,17002,227,54,-1419,-731,22.7,1552,blue,4.5,1.67,14,21,blue
4522814344,2,4,3,0,0,0,0,14615,7,18302,221,47,-1530,-1114,22.1,1461.5,4,2,5,1,1,0,0,16145,7.4,19416,243,71,1530,1114,24.3,1614.5,red,1.25,4.5,21,20,blue
4470759747,8,8,11,0,0,0,0,17706,6.8,18475,231,35,216,1250,23.1,1770.6,8,8,7,0,0,0,0,17490,6.8,17225,204,53,-216,-1250,20.4,1749,blue,2.38,1.88,42,21,red
4454170468,8,5,7,1,1,0,0,17727,7.2,18993,217,64,1521,1915,21.7,1772.7,5,8,7,1,0,1,0,16206,6.8,17078,198,60,-1521,-1915,19.8,1620.6,red,3,1.5,18,13,blue
4478080352,0,8,0,0,0,0,0,12988,6.2,14678,153,78,-5264,-4627,15.3,1298.8,8,0,10,2,1,1,0,18252,7.2,19305,273,44,5264,4627,27.3,1825.2,red,0,12.65,17,26,red
4521135230,8,1,8,1,1,0,0,17613,7.2,19092,234,48,3949,2440,23.4,1761.3,1,8,2,0,0,0,0,13664,6.6,16652,216,44,-3949,-2440,21.6,1366.4,blue,16,0.38,17,43,blue
4512913824,11,5,12,1,1,0,0,18632,7.2,19093,227,44,2907,1175,22.7,1863.2,5,11,8,0,0,0,0,15725,7,17918,204,53,-2907,-1175,20.4,1572.5,blue,4.6,1.18,19,45,blue
4521918813,5,6,2,1,1,0,0,15476,7,18246,233,47,-706,-873,23.3,1547.6,6,5,7,0,0,0,0,16182,7.4,19119,244,36,706,873,24.4,1618.2,blue,1.17,2.6,18,28,blue
4477806643,4,5,5,0,0,0,0,15717,6.8,17679,224,44,-527,-208,22.4,1571.7,5,4,9,1,1,0,0,16244,6.8,17887,199,75,527,208,19.9,1624.4,red,1.8,3.5,22,66,blue
4509514810,8,8,8,1,1,0,0,18253,6.8,17351,240,50,1683,-172,24,1825.3,8,8,6,0,0,0,0,16570,6.8,17523,203,41,-1683,172,20.3,1657,blue,2,1.75,21,22,red
4525028145,3,5,2,0,0,0,0,14349,6.6,16271,205,36,-1005,-251,20.5,1434.9,5,3,3,0,0,0,0,15354,6.4,16522,228,40,1005,251,22.8,1535.4,red,1,2.67,51,21,blue
4522170496,4,6,6,1,1,0,0,15407,6.6,17007,232,24,-1122,-302,23.2,1540.7,6,4,8,0,0,0,0,16529,6.8,17309,214,52,1122,302,21.4,1652.9,red,1.67,3.5,19,16,red
4499816860,4,5,4,1,1,0,0,15273,6.8,17539,211,60,-808,-311,21.1,1527.3,5,4,6,0,0,0,0,16081,7.2,17850,238,45,808,311,23.8,1608.1,red,1.6,2.75,29,21,blue
4524879680,4,6,5,0,0,0,0,14868,6.6,16330,182,48,-2281,-1594,18.2,1486.8,6,4,9,1,1,0,0,17149,6.8,17924,209,72,2281,1594,20.9,1714.9,red,1.5,3.75,15,14,blue
4525084228,4,4,4,0,0,0,0,14892,6.8,17899,199,49,-1750,-628,19.9,1489.2,4,4,4,1,1,0,0,16642,7.2,18527,250,61,1750,628,25,1664.2,blue,2,2,24,23,red
4521347328,10,4,12,0,0,0,0,18509,7.6,20432,223,72,2974,1421,22.3,1850.9,4,10,5,1,1,0,0,15535,7.4,19011,213,64,-2974,-1421,21.3,1553.5,blue,5.5,0.9,125,16,blue
4497825054,6,4,9,0,0,0,0,17096,7.2,19253,241,63,419,462,24.1,1709.6,4,6,5,1,1,0,0,16677,7.2,18791,247,60,-419,-462,24.7,1667.7,blue,3.75,1.5,22,18,red
4520913464,6,3,10,2,1,1,0,17377,7.2,19245,247,68,2101,1596,24.7,1737.7,3,6,5,0,0,0,0,15276,6.8,17649,193,59,-2101,-1596,19.3,1527.6,blue,5.33,1.33,16,77,red
4503284837,7,7,5,1,1,0,0,16554,7,18512,235,33,-776,166,23.5,1655.4,7,7,14,0,0,0,0,17330,6.8,18346,259,36,776,-166,25.9,1733,red,1.71,3,20,19,red
4519863035,4,5,6,0,0,0,0,15256,6.8,16513,210,41,-957,-2267,21,1525.6,5,4,5,1,1,0,0,16213,7.2,18780,235,64,957,2267,23.5,1621.3,blue,2,2.5,19,24,red
4467388375,9,1,7,2,1,1,0,17710,7.2,19233,230,55,4311,3239,23,1771,1,9,0,0,0,0,0,13399,6.6,15994,201,44,-4311,-3239,20.1,1339.9,blue,16,0.11,18,13,blue
4494893980,4,5,3,1,1,0,0,15041,7,16622,214,43,-1207,-1748,21.4,1504.1,5,4,3,0,0,0,0,16248,7,18370,228,60,1207,1748,22.8,1624.8,red,1.4,2,17,16,red
4516572931,9,3,9,2,1,1,0,19027,7.2,19029,247,41,4616,2050,24.7,1902.7,3,9,1,0,0,0,0,14411,6.6,16979,187,54,-4616,-2050,18.7,1441.1,blue,6,0.44,14,14,blue
4462648496,10,6,16,2,1,1,0,18718,7.4,18807,214,71,2404,927,21.4,1871.8,6,10,6,0,0,0,0,16314,7,17880,228,60,-2404,-927,22.8,1631.4,blue,4.33,1.2,18,17,blue
4484087846,7,5,10,1,1,0,0,16938,7.2,19399,231,48,600,824,23.1,1693.8,5,7,8,1,0,1,0,16338,7,18575,229,60,-600,-824,22.9,1633.8,red,3.4,1.86,17,16,red
4507768381,7,3,3,0,0,0,0,16772,7,18456,255,47,1936,1799,25.5,1677.2,3,7,4,1,1,0,0,14836,6.6,16657,205,55,-1936,-1799,20.5,1483.6,blue,3.33,1,18,16,blue
4517503916,6,13,9,1,1,0,0,16035,6.6,16424,160,52,-4685,-3600,16,1603.5,13,6,23,0,0,0,0,20720,7.6,20024,244,51,4685,3600,24.4,2072,blue,1.15,6,20,23,red
4520894733,3,3,5,1,1,0,0,15518,6.6,16768,234,52,315,-61,23.4,1551.8,3,3,4,0,0,0,0,15203,6.6,16829,216,51,-315,61,21.6,1520.3,red,2.67,2.33,16,20,red
4458889473,7,7,12,1,0,1,0,17543,7,17748,195,51,994,-547,19.5,1754.3,7,7,11,1,1,0,0,16549,7,18295,215,36,-994,547,21.5,1654.9,red,2.71,2.57,66,43,blue
4523961179,3,4,4,1,0,1,0,15829,7,17924,242,56,450,661,24.2,1582.9,4,3,5,1,1,0,0,15379,6.6,17263,239,48,-450,-661,23.9,1537.9,blue,1.75,3,20,15,red
4466045865,5,8,6,1,0,1,0,17389,7,18695,231,63,110,-402,23.1,1738.9,8,5,9,0,0,0,0,17279,7.2,19097,231,59,-110,402,23.1,1727.9,blue,1.38,3.4,13,16,red
4516642389,7,7,7,0,0,0,0,16683,7.2,18315,231,48,-396,481,23.1,1668.3,7,7,5,2,1,1,0,17079,6.8,17834,246,42,396,-481,24.6,1707.9,blue,2,1.71,21,13,red
4518790705,6,8,8,0,0,0,0,16985,7,18802,240,43,-805,254,24,1698.5,8,6,10,1,1,0,0,17790,7,18548,221,53,805,-254,22.1,1779,red,1.75,3,10,16,red
4508511932,2,8,2,0,0,0,0,14904,6.6,15958,222,50,-1302,-1959,22.2,1490.4,8,2,6,2,1,1,0,16206,7,17917,194,50,1302,1959,19.4,1620.6,red,0.5,7,17,24,blue
4450404129,8,5,12,1,1,0,0,17551,6.6,17463,237,43,1763,-239,23.7,1755.1,5,8,6,0,0,0,0,15788,7,17702,213,45,-1763,239,21.3,1578.8,red,4,1.38,25,24,blue
4484243751,5,9,3,1,1,0,0,15278,6.4,16785,186,43,-1993,-2178,18.6,1527.8,9,5,5,0,0,0,0,17271,7,18963,211,49,1993,2178,21.1,1727.1,red,0.89,2.8,40,20,red
4523449093,6,6,5,2,1,1,0,15539,6.8,17101,191,56,8,572,19.1,1553.9,6,6,8,0,0,0,0,15531,6.4,16529,208,48,-8,-572,20.8,1553.1,red,1.83,2.33,27,19,red
4485983759,11,8,16,0,0,0,0,17860,6.8,17606,172,48,1240,-349,17.2,1786,8,11,6,1,0,1,0,16620,6.8,17955,202,51,-1240,349,20.2,1662,blue,3.38,1.27,41,16,blue
4456033648,3,5,2,1,1,0,0,15156,6.6,17247,207,61,-1063,-2035,20.7,1515.6,5,3,4,0,0,0,0,16219,7.2,19282,229,44,1063,2035,22.9,1621.9,blue,1,3,17,15,blue
4451994271,9,6,11,1,1,0,0,18152,7,18823,223,47,22,1773,22.3,1815.2,6,9,10,1,0,1,1,18130,6.6,17050,200,47,-22,-1773,20,1813,blue,3.33,1.78,30,26,blue
4523813027,5,4,9,0,0,0,0,16587,7,18340,252,48,-16,497,25.2,1658.7,4,5,5,2,1,1,0,16603,7,17843,242,53,16,-497,24.2,1660.3,blue,3.5,1.8,18,24,blue
4522528300,4,3,5,1,1,0,0,15562,7.2,18694,235,62,-526,496,23.5,1556.2,3,4,2,0,0,0,0,16088,7,18198,219,63,526,-496,21.9,1608.8,red,3,1.25,23,19,red
4525010379,4,6,4,0,0,0,0,14944,6.8,16969,200,40,-916,-659,20,1494.4,6,4,8,1,1,0,0,15860,7,17628,193,63,916,659,19.3,1586,blue,1.33,3.5,32,50,red
4523893279,5,10,8,1,1,0,0,15269,6.6,16739,194,37,-2793,-1055,19.4,1526.9,10,5,13,0,0,0,0,18062,6.8,17794,204,45,2793,1055,20.4,1806.2,red,1.3,4.6,17,16,red
4521767558,7,9,7,0,0,0,0,17166,7.2,18945,224,52,-1561,925,22.4,1716.6,9,7,10,2,1,1,1,18727,7,18020,177,47,1561,-925,17.7,1872.7,red,1.56,2.71,151,45,red
4513468208,5,11,6,0,0,0,0,14813,6.8,16945,182,43,-3707,-1742,18.2,1481.3,11,5,10,2,1,1,0,18520,7.2,18687,225,60,3707,1742,22.5,1852,blue,1,4.2,19,22,red
4509940974,6,10,7,0,0,0,0,15787,6.8,16711,205,37,-2457,-1625,20.5,1578.7,10,6,10,1,0,1,0,18244,7,18336,238,53,2457,1625,23.8,1824.4,red,1.3,3.33,24,28,blue
4523594807,6,8,4,0,0,0,0,14795,6.4,15646,172,50,-2348,-1246,17.2,1479.5,8,6,10,1,1,0,0,17143,6.6,16892,193,37,2348,1246,19.3,1714.3,red,1.25,3,70,18,red
4522596312,15,2,15,1,1,0,0,19848,7.2,19712,224,52,5275,3662,22.4,1984.8,2,15,0,0,0,0,0,14573,6.6,16050,227,56,-5275,-3662,22.7,1457.3,blue,15,0.13,55,15,blue
4517041040,1,7,1,0,0,0,0,13886,6.6,15720,222,36,-3413,-3079,22.2,1388.6,7,1,3,1,1,0,0,17299,7.2,18799,245,46,3413,3079,24.5,1729.9,red,0.29,10,19,21,blue
4518695015,6,10,4,0,0,0,0,16149,6.8,17146,212,44,-1286,-848,21.2,1614.9,10,6,14,0,0,0,0,17435,7,17994,190,35,1286,848,19,1743.5,blue,1,4,18,19,red
4500037487,7,7,4,0,0,0,0,15312,6.6,16667,174,36,-1785,-1581,17.4,1531.2,7,7,4,2,1,1,0,17097,7,18248,216,68,1785,1581,21.6,1709.7,blue,1.57,1.57,39,13,red
4521886513,7,2,10,1,1,0,0,17267,7.2,18482,224,44,3107,2096,22.4,1726.7,2,7,0,0,0,0,0,14160,6.6,16386,218,40,-3107,-2096,21.8,1416,blue,8.5,0.29,44,21,blue
4516044973,5,4,3,1,1,0,0,15961,7,17670,224,44,-41,-1008,22.4,1596.1,4,5,2,0,0,0,0,16002,7.2,18678,233,60,41,1008,23.3,1600.2,red,2,1.2,13,16,red
4521934653,9,7,12,0,0,0,0,17704,7,18183,196,68,639,1171,19.6,1770.4,7,9,10,0,0,0,0,17065,6.4,17012,208,39,-639,-1171,20.8,1706.5,blue,3,1.89,16,16,blue
4498314967,1,6,2,0,0,0,0,14808,7.2,18642,240,64,-2041,-1090,24,1480.8,6,1,6,1,1,0,0,16849,7.4,19732,227,64,2041,1090,22.7,1684.9,red,0.5,12,16,16,red
4518877029,5,4,3,1,1,0,0,16374,7.2,18711,227,55,412,93,22.7,1637.4,4,5,1,0,0,0,0,15962,7.2,18618,234,64,-412,-93,23.4,1596.2,red,2,1,19,36,blue
4519742974,6,1,11,0,0,0,0,16933,7.2,18512,242,52,2836,448,24.2,1693.3,1,6,0,1,0,1,0,14097,6.8,18064,207,56,-2836,-448,20.7,1409.7,red,17,0.17,18,17,blue
4519564214,11,8,12,0,0,0,0,18156,7.2,18548,208,52,957,469,20.8,1815.6,8,11,5,2,1,1,0,17199,6.8,18079,218,52,-957,-469,21.8,1719.9,blue,2.88,1.18,15,38,blue
4520320166,12,9,9,0,0,0,0,19397,7,19301,232,44,2287,2551,23.2,1939.7,9,12,4,0,0,0,0,17110,6.6,16750,184,52,-2287,-2551,18.4,1711,blue,2.33,1.08,22,20,red
4524732459,7,9,10,0,0,0,0,17033,6.8,16630,209,45,-462,-1186,20.9,1703.3,9,7,9,0,0,0,0,17495,7,17816,213,43,462,1186,21.3,1749.5,red,1.89,2.57,22,23,blue
4519790060,11,10,7,1,1,0,0,19061,7.2,19093,236,50,1362,1592,23.6,1906.1,10,11,11,0,0,0,0,17699,6.8,17501,191,46,-1362,-1592,19.1,1769.9,blue,1.8,1.91,25,86,red
4456330802,7,6,3,1,0,1,0,16653,7.4,19603,229,72,140,1737,22.9,1665.3,6,7,5,0,0,0,0,16513,7,17866,229,31,-140,-1737,22.9,1651.3,blue,1.67,1.57,23,131,red
4524273849,5,8,5,1,1,0,0,16781,6.6,17452,237,50,633,-295,23.7,1678.1,8,5,13,0,0,0,0,16148,6.8,17747,180,44,-633,295,18,1614.8,blue,1.25,4.2,13,18,blue
4478063031,5,6,5,0,0,0,0,15978,6.8,18068,210,52,-323,214,21,1597.8,6,5,6,1,1,0,0,16301,7,17854,203,48,323,-214,20.3,1630.1,red,1.67,2.4,34,35,red
4494869975,3,6,3,0,0,0,0,15859,7,19145,241,72,-1296,227,24.1,1585.9,6,3,7,1,1,0,0,17155,7.2,18918,257,40,1296,-227,25.7,1715.5,blue,1,4.33,14,18,red
4424078266,6,14,6,0,0,0,0,16205,6.4,16887,196,56,-3622,-1908,19.6,1620.5,14,6,16,2,1,1,0,19827,7,18795,224,40,3622,1908,22.4,1982.7,blue,0.86,5,16,16,red
4490705012,10,10,11,0,0,0,0,17528,6.8,17194,197,34,-541,546,19.7,1752.8,10,10,11,1,1,0,0,18069,6.6,16648,223,36,541,-546,22.3,1806.9,blue,2.1,2.1,17,19,red
4523350637,8,6,9,0,0,0,0,17154,7,18697,202,55,1933,2792,20.2,1715.4,6,8,6,0,0,0,0,15221,6.6,15905,174,44,-1933,-2792,17.4,1522.1,blue,2.83,1.5,55,20,blue
4515573007,4,7,6,0,0,0,0,16112,7.2,18339,247,46,-692,-758,24.7,1611.2,7,4,7,2,1,1,0,16804,7.2,19097,223,50,692,758,22.3,1680.4,red,1.43,3.5,21,40,red
4524001627,5,3,7,0,0,0,0,16210,7.2,17888,226,36,766,-662,22.6,1621,3,5,2,0,0,0,0,15444,6.8,18550,202,72,-766,662,20.2,1544.4,red,4,1,18,38,red
4520769690,6,4,10,1,0,1,0,18369,7.4,20686,276,68,2334,1835,27.6,1836.9,4,6,2,1,1,0,0,16035,7.2,18851,249,68,-2334,-1835,24.9,1603.5,blue,4,1,45,30,blue
4521194399,5,7,4,0,0,0,0,16097,6.8,17793,243,52,-143,462,24.3,1609.7,7,5,8,0,0,0,0,16240,6.6,17331,198,48,143,-462,19.8,1624,blue,1.29,3,22,22,blue
4459264476,1,11,2,0,0,0,0,13196,6.4,15515,194,49,-5525,-5585,19.4,1319.6,11,1,8,0,0,0,0,18721,7.8,21100,252,55,5525,5585,25.2,1872.1,red,0.27,19,19,16,red
4442070152,5,4,8,0,0,0,0,15552,6.6,17234,201,37,-1493,-1179,20.1,1555.2,4,5,5,1,1,0,0,17045,7,18413,250,68,1493,1179,25,1704.5,red,3.25,1.8,19,20,red
4519232603,11,6,21,1,1,0,0,17597,6.8,17045,190,50,2534,2539,19,1759.7,6,11,5,0,0,0,0,15063,6.2,14506,188,32,-2534,-2539,18.8,1506.3,blue,5.33,1,19,13,blue
4503234599,5,15,6,0,0,0,0,15709,6.8,17397,216,49,-5900,-4872,21.6,1570.9,15,5,8,2,1,1,0,21609,7.8,22269,270,67,5900,4872,27,2160.9,red,0.73,4.6,13,41,red
4452824310,5,6,8,2,1,1,0,17035,7,18139,230,63,851,327,23,1703.5,6,5,6,0,0,0,0,16184,6.6,17812,219,52,-851,-327,21.9,1618.4,red,2.17,2.4,19,24,blue
4520335099,3,3,2,2,1,1,0,15000,7,17972,229,52,198,726,22.9,1500,3,3,3,0,0,0,0,14802,6.8,17246,220,40,-198,-726,22,1480.2,blue,1.67,2,21,21,red
4460509130,9,9,7,0,0,0,0,18426,7.6,20198,240,63,380,-674,24,1842.6,9,9,6,1,1,0,0,18046,7.6,20872,211,64,-380,674,21.1,1804.6,blue,1.78,1.67,18,43,red
4494350446,8,4,7,2,1,1,0,17634,7,19000,242,46,2018,2261,24.2,1763.4,4,8,2,0,0,0,0,15616,6.6,16739,233,50,-2018,-2261,23.3,1561.6,blue,3.75,0.75,17,32,blue
4485746291,11,1,13,1,0,1,1,20251,7.4,20985,263,61,6942,6381,26.3,2025.1,1,11,1,1,1,0,0,13309,6.2,14604,186,42,-6942,-6381,18.6,1330.9,blue,24,0.18,23,25,red
4522462611,7,7,13,1,1,0,0,16034,6.6,16642,199,40,-754,-729,19.9,1603.4,7,7,12,0,0,0,0,16788,6.8,17371,224,50,754,729,22.4,1678.8,red,2.86,2.71,18,15,blue
4521336289,2,5,4,0,0,0,0,14147,6.6,16605,226,52,-1400,-1716,22.6,1414.7,5,2,9,1,1,0,0,15547,7,18321,197,60,1400,1716,19.7,1554.7,red,1.2,7,151,40,blue
4523036176,9,8,11,1,1,0,0,18304,7.2,19032,237,42,1606,1036,23.7,1830.4,8,9,9,1,0,1,0,16698,7,17996,198,41,-1606,-1036,19.8,1669.8,red,2.5,1.89,27,90,red
4523330702,5,5,6,1,1,0,0,15104,6.6,17002,186,51,-2130,-2032,18.6,1510.4,5,5,3,0,0,0,0,17234,7.2,19034,259,60,2130,2032,25.9,1723.4,red,2.2,1.6,19,18,red
4468356736,10,10,17,1,1,0,0,18847,7.2,19480,213,76,987,642,21.3,1884.7,10,10,8,0,0,0,0,17860,7.2,18838,206,56,-987,-642,20.6,1786,red,2.7,1.8,16,15,blue
4463063111,2,2,1,0,0,0,0,15782,6.8,18460,253,66,1344,1195,25.3,1578.2,2,2,1,0,0,0,0,14438,6.8,17265,236,52,-1344,-1195,23.6,1443.8,blue,1.5,1.5,45,64,red
4517535335,6,5,6,1,1,0,0,16893,7,18950,238,64,568,1096,23.8,1689.3,5,6,6,0,0,0,0,16325,7,17854,231,48,-568,-1096,23.1,1632.5,blue,2.4,1.83,36,51,red
4448433475,10,5,12,1,0,1,0,18545,7.2,19051,200,64,2621,2001,20,1854.5,5,10,5,1,1,0,0,15924,6.8,17050,206,35,-2621,-2001,20.6,1592.4,red,4.4,1,14,15,red
4516228247,6,8,5,0,0,0,0,16918,7,18911,233,51,-403,-575,23.3,1691.8,8,6,5,1,1,0,0,17321,7.2,19486,225,61,403,575,22.5,1732.1,red,1.38,2.17,22,20,red
4498040102,13,4,14,1,1,0,0,18722,6.8,18343,187,46,3593,727,18.7,1872.2,4,13,6,0,0,0,0,15129,6.8,17616,209,49,-3593,-727,20.9,1512.9,blue,6.75,0.77,22,38,blue
4466272322,6,3,8,1,1,0,1,18247,7,18839,235,59,3400,2400,23.5,1824.7,3,6,3,1,0,1,0,14847,6.6,16439,209,48,-3400,-2400,20.9,1484.7,blue,4.67,1,19,40,blue
4498466711,6,5,8,1,1,0,1,17471,6.8,17895,217,56,1019,37,21.7,1747.1,5,6,4,0,0,0,0,16452,6.8,17858,206,55,-1019,-37,20.6,1645.2,red,2.8,1.5,15,18,red
4516594207,7,6,4,0,0,0,0,17641,7.2,19312,237,50,1496,1352,23.7,1764.1,6,7,4,1,1,0,0,16145,7,17960,214,43,-1496,-1352,21.4,1614.5,blue,1.83,1.43,22,20,red
4444307438,4,9,6,0,0,0,0,14605,6.6,16395,181,40,-3921,-3284,18.1,1460.5,9,4,12,1,1,0,0,18526,7,19679,242,50,3921,3284,24.2,1852.6,red,1.11,5.25,18,20,red
4524924917,6,3,4,0,0,0,0,16249,6.6,17860,224,41,675,377,22.4,1624.9,3,6,4,1,1,0,0,15574,7,17483,220,56,-675,-377,22,1557.4,blue,3.33,1.17,16,16,blue
4471072375,6,9,8,0,0,0,0,17157,7,17928,226,41,-702,-2110,22.6,1715.7,9,6,5,2,1,1,0,17859,7.6,20038,208,68,702,2110,20.8,1785.9,red,1.56,2.33,21,47,blue
4461136941,4,5,5,0,0,0,0,15165,6.8,17251,218,49,-1286,-1695,21.8,1516.5,5,4,5,1,1,0,0,16451,7.2,18946,244,52,1286,1695,24.4,1645.1,blue,1.8,2.5,20,18,blue
4511783197,5,4,5,0,0,0,0,15427,6.8,17722,215,50,-174,-503,21.5,1542.7,4,5,4,1,1,0,0,15601,7,18225,229,48,174,503,22.9,1560.1,red,2.5,1.6,36,22,red
4501108199,10,5,10,0,0,0,0,17878,7,18248,214,52,2301,603,21.4,1787.8,5,10,5,0,0,0,0,15577,6.8,17645,203,44,-2301,-603,20.3,1557.7,blue,4,1,16,38,blue
4465596531,10,6,4,0,0,0,0,18000,7.4,19946,236,48,2504,2361,23.6,1800,6,10,7,0,0,0,0,15496,7,17585,191,43,-2504,-2361,19.1,1549.6,red,2.33,1.3,15,17,blue
4524568896,5,7,9,0,0,0,0,15851,7,19296,215,61,-1341,445,21.5,1585.1,7,5,6,1,1,0,0,17192,7,18851,237,38,1341,-445,23.7,1719.2,blue,2,2.6,24,25,red
4478702787,5,9,3,1,1,0,0,15832,6.6,17750,229,60,-2174,-325,22.9,1583.2,9,5,11,0,0,0,0,18006,7,18075,221,39,2174,325,22.1,1800.6,red,0.89,4,26,28,red
4437799907,10,10,14,1,1,0,0,18931,7.2,18806,222,52,1804,820,22.2,1893.1,10,10,10,0,0,0,0,17127,7,17986,211,36,-1804,-820,21.1,1712.7,red,2.4,2,14,18,blue
4469372506,7,4,6,0,0,0,0,16157,6.8,17238,201,44,68,-369,20.1,1615.7,4,7,7,1,1,0,0,16089,7,17607,213,58,-68,369,21.3,1608.9,red,3.25,1.57,17,18,blue
4459817582,11,6,12,0,0,0,0,18354,6.8,17746,207,39,1775,-5,20.7,1835.4,6,11,3,0,0,0,0,16579,6.8,17751,208,54,-1775,5,20.8,1657.9,blue,3.83,0.82,24,42,blue
4522510134,7,5,10,0,0,0,0,17274,7.4,20199,246,56,424,1050,24.6,1727.4,5,7,4,1,1,0,0,16850,7.2,19149,245,72,-424,-1050,24.5,1685,red,3.4,1.29,84,18,red
4427951118,4,11,5,1,0,1,0,15372,6.8,17002,213,57,-2585,204,21.3,1537.2,11,4,12,1,1,0,0,17957,6.8,16798,209,40,2585,-204,20.9,1795.7,red,0.82,5.75,19,20,red
4522319938,13,12,17,1,1,0,0,20175,7.4,20673,215,72,1610,2488,21.5,2017.5,12,13,13,0,0,0,0,18565,6.8,18185,212,36,-1610,-2488,21.2,1856.5,blue,2.5,1.92,47,28,red
4522616210,5,3,5,1,0,1,0,15486,7,17388,205,52,904,195,20.5,1548.6,3,5,3,1,1,0,0,14582,6.8,17193,216,44,-904,-195,21.6,1458.2,red,3.33,1.2,19,20,red
4523566320,4,9,4,1,0,1,0,16074,7,18077,237,55,-855,227,23.7,1607.4,9,4,10,1,1,0,0,16929,7,17850,211,48,855,-227,21.1,1692.9,blue,0.89,4.75,91,36,blue
4520933584,7,3,7,0,0,0,0,16849,7,18439,231,44,1991,1977,23.1,1684.9,3,7,3,1,1,0,0,14858,6.4,16462,223,49,-1991,-1977,22.3,1485.8,blue,4.67,0.86,23,19,red
4514399530,6,10,9,0,0,0,0,16291,6.8,17343,188,52,-2893,-2027,18.8,1629.1,10,6,15,2,1,1,0,19184,7.2,19370,236,60,2893,2027,23.6,1918.4,red,1.5,4.17,12,16,red
4472185629,5,8,4,0,0,0,0,16164,7,17971,233,44,-2274,-2172,23.3,1616.4,8,5,10,1,1,0,0,18438,7.4,20143,240,60,2274,2172,24,1843.8,red,1.12,3.6,21,20,red
4524877536,7,8,6,1,1,0,0,17002,7,17795,221,51,-154,-612,22.1,1700.2,8,7,4,1,0,1,0,17156,7,18407,225,48,154,612,22.5,1715.6,blue,1.62,1.71,17,23,red
4515306616,5,9,4,0,0,0,0,15342,6.8,17286,194,50,-1630,-130,19.4,1534.2,9,5,12,1,1,0,0,16972,7,17416,216,40,1630,130,21.6,1697.2,red,1,4.2,21,19,red
4524480759,1,9,2,0,0,0,0,13119,6.2,15498,199,36,-6878,-4956,19.9,1311.9,9,1,9,2,1,1,1,19997,7.4,20454,275,56,6878,4956,27.5,1999.7,red,0.33,18,20,26,red
4502625560,8,7,7,1,1,0,0,17472,7.2,18967,224,52,1177,763,22.4,1747.2,7,8,7,0,0,0,0,16295,7.2,18204,183,68,-1177,-763,18.3,1629.5,blue,2.14,1.75,16,16,blue
4521238149,3,2,1,0,0,0,0,15681,7,19274,231,52,919,1527,23.1,1568.1,2,3,2,1,1,0,0,14762,7,17747,230,58,-919,-1527,23,1476.2,blue,2,1.33,24,60,red
4513598574,8,6,7,0,0,0,0,18634,7,19500,239,56,2077,1804,23.9,1863.4,6,8,12,1,1,0,0,16557,6.8,17696,196,71,-2077,-1804,19.6,1655.7,blue,2.5,2.25,15,20,blue
4518314539,1,6,0,0,0,0,0,13881,6.8,16550,209,47,-2973,-1940,20.9,1388.1,6,1,13,1,1,0,0,16854,7,18490,222,56,2973,1940,22.2,1685.4,red,0.17,19,17,17,red
4489658562,10,16,10,1,0,1,0,18145,6.6,17219,199,46,-3228,-2075,19.9,1814.5,16,10,13,1,1,0,0,21373,7.2,19294,237,38,3228,2075,23.7,2137.3,red,1.25,2.9,14,18,blue
4482124456,9,10,16,1,1,0,0,17308,6.8,16748,203,50,-999,-1466,20.3,1730.8,10,9,13,1,0,1,0,18307,7.2,18214,212,48,999,1466,21.2,1830.7,blue,2.5,2.56,19,20,blue
4521449532,2,13,0,0,0,0,0,13049,6.2,14294,163,52,-6395,-4800,16.3,1304.9,13,2,20,2,1,1,0,19444,7.2,19094,239,52,6395,4800,23.9,1944.4,red,0.15,16.5,14,59,red
4524994987,14,4,15,0,0,0,0,20075,7,18552,220,53,5853,3870,22,2007.5,4,14,6,0,0,0,0,14222,6.2,14682,179,36,-5853,-3870,17.9,1422.2,blue,7.25,0.71,18,15,blue
4455125565,3,11,2,0,0,0,0,14377,6.4,15120,158,44,-5141,-4745,15.8,1437.7,11,3,12,1,1,0,1,19518,7.4,19865,241,59,5141,4745,24.1,1951.8,red,0.45,7.67,19,23,red
4522531124,9,3,9,0,0,0,0,17270,6.6,17435,213,43,2318,1656,21.3,1727,3,9,3,0,0,0,0,14952,6.6,15779,220,44,-2318,-1656,22,1495.2,blue,6,0.67,26,23,blue
4498726341,12,5,6,0,0,0,0,18967,7.6,19855,240,48,3595,2595,24,1896.7,5,12,3,1,1,0,0,15372,6.8,17260,217,56,-3595,-2595,21.7,1537.2,blue,3.6,0.67,21,14,blue
4520588877,2,10,2,0,0,0,0,14044,6.6,16501,191,56,-6604,-2014,19.1,1404.4,10,2,6,2,1,1,2,20648,7.2,18515,236,48,6604,2014,23.6,2064.8,red,0.4,8,17,21,red
4522556160,4,6,5,0,0,0,0,16467,7.2,18715,261,56,-530,-123,26.1,1646.7,6,4,8,1,1,0,0,16997,7,18838,227,64,530,123,22.7,1699.7,red,1.5,3.5,26,22,red
4502024676,8,13,5,0,0,0,0,17846,6.8,18045,198,51,-796,-594,19.8,1784.6,13,8,12,0,0,0,0,18642,7.2,18639,194,50,796,594,19.4,1864.2,blue,1,3.12,11,17,blue
4494811413,12,6,17,2,1,1,1,19993,7,17656,203,34,3439,913,20.3,1999.3,6,12,8,0,0,0,0,16554,6.8,16743,209,68,-3439,-913,20.9,1655.4,blue,4.83,1.17,17,14,blue
4522599677,4,1,4,1,1,0,0,16223,7.2,19667,232,66,1423,1022,23.2,1622.3,1,4,1,1,0,1,0,14800,7,18645,242,68,-1423,-1022,24.2,1480,red,8,0.5,18,19,blue
4513586711,2,8,3,1,1,0,0,14071,6.4,16382,202,59,-3952,-2015,20.2,1407.1,8,2,8,0,0,0,0,18023,7,18397,228,36,3952,2015,22.8,1802.3,red,0.62,8,28,122,blue
4492904211,3,3,3,2,1,1,0,15284,7.2,18267,245,51,-884,-471,24.5,1528.4,3,3,2,0,0,0,0,16168,7.2,18738,227,71,884,471,22.7,1616.8,blue,2,1.67,17,18,blue
4525183831,4,0,3,1,0,1,0,16346,7,19072,272,50,2655,1326,27.2,1634.6,0,4,0,1,1,0,0,13691,6.8,17746,218,69,-2655,-1326,21.8,1369.1,red,12.03,0,50,16,blue
4524995748,2,7,3,1,1,0,0,14358,6.6,16775,225,53,-2031,-1121,22.5,1435.8,7,2,6,0,0,0,0,16389,7,17896,223,37,2031,1121,22.3,1638.9,red,0.71,6.5,21,19,red
4496611472,7,2,7,1,0,1,0,17206,7.4,20071,248,66,2893,3588,24.8,1720.6,2,7,4,1,1,0,0,14313,6.6,16483,218,56,-2893,-3588,21.8,1431.3,blue,7,0.86,17,13,blue
4466270705,2,4,3,0,0,0,0,14767,7.2,18018,236,58,-976,-1408,23.6,1476.7,4,2,4,1,0,1,0,15743,7.2,19426,215,59,976,1408,21.5,1574.3,blue,1.25,4,16,29,blue
4489674580,12,7,13,0,0,0,0,18291,7.2,18548,176,53,2182,1012,17.6,1829.1,7,12,4,0,0,0,0,16109,6.8,17536,210,48,-2182,-1012,21,1610.9,blue,3.57,0.92,14,15,blue
4517551883,3,5,5,0,0,0,0,14979,6.8,17163,203,52,-1968,-2932,20.3,1497.9,5,3,6,1,1,0,0,16947,7.2,20095,238,72,1968,2932,23.8,1694.7,red,1.6,3.67,14,41,red
4512229508,7,9,6,0,0,0,0,17214,7,18251,231,49,-1806,123,23.1,1721.4,9,7,13,1,1,0,1,19020,7,18128,204,54,1806,-123,20.4,1902,blue,1.44,3.14,21,29,red
4520364684,7,16,11,0,0,0,0,16461,6.4,15402,177,52,-5941,-4097,17.7,1646.1,16,7,18,2,1,1,2,22402,7.2,19499,241,48,5941,4097,24.1,2240.2,red,1.12,4.86,29,19,red
4487211504,3,5,2,0,0,0,0,14027,6.6,16596,219,32,-2105,-1815,21.9,1402.7,5,3,4,0,0,0,0,16132,7,18411,261,44,2105,1815,26.1,1613.2,blue,1,3,23,23,red
4490245782,7,5,6,0,0,0,0,17432,7.4,19324,224,56,993,593,22.4,1743.2,5,7,11,0,0,0,0,16439,7.4,18731,209,52,-993,-593,20.9,1643.9,blue,2.6,2.29,16,59,red
4519269898,6,8,5,0,0,0,0,15969,6.8,17938,231,40,-809,10,23.1,1596.9,8,6,8,0,0,0,0,16778,6.6,17928,216,35,809,-10,21.6,1677.8,blue,1.38,2.67,17,12,blue
4477778320,7,11,5,0,0,0,0,16308,6.8,17166,195,42,-1903,-1398,19.5,1630.8,11,7,10,1,1,0,0,18211,7.2,18564,214,36,1903,1398,21.4,1821.1,red,1.09,3,18,19,blue
4525005015,2,5,2,0,0,0,0,14119,6.6,16231,216,50,-2325,-2078,21.6,1411.9,5,2,9,1,1,0,0,16444,6.8,18309,235,46,2325,2078,23.5,1644.4,red,0.8,7,14,40,red
4515619374,6,4,4,2,1,1,0,16044,7.2,19133,214,48,-100,-1205,21.4,1604.4,4,6,2,0,0,0,0,16144,7.6,20338,234,75,100,1205,23.4,1614.4,blue,2.5,1,17,19,blue
4520909280,4,11,2,1,1,0,0,15011,6.6,16617,183,60,-4396,-2703,18.3,1501.1,11,4,16,0,0,0,0,19407,7.2,19320,245,40,4396,2703,24.5,1940.7,red,0.55,6.75,18,17,red
4439747783,3,8,6,0,0,0,0,14517,6.4,15493,169,46,-3525,-3278,16.9,1451.7,8,3,15,2,1,1,0,18042,7,18771,202,79,3525,3278,20.2,1804.2,red,1.12,7.67,25,13,red
4510536402,1,6,2,0,0,0,0,13653,6.6,16539,220,52,-3728,-3076,22,1365.3,6,1,4,0,0,0,0,17381,7.4,19615,220,64,3728,3076,22,1738.1,red,0.5,10,52,15,red
4522149954,8,8,13,0,0,0,0,17833,7,18351,191,61,1256,301,19.1,1783.3,8,8,7,0,0,0,0,16577,7,18050,193,43,-1256,-301,19.3,1657.7,red,2.62,1.88,19,16,blue
4496660905,9,4,14,1,1,0,0,17759,7,18824,228,48,3082,3200,22.8,1775.9,4,9,4,1,0,1,0,14677,6.2,15624,168,44,-3082,-3200,16.8,1467.7,blue,5.75,0.89,17,16,blue
4520942690,6,6,6,0,0,0,0,16158,7,17652,240,32,197,1241,24,1615.8,6,6,10,0,0,0,0,15961,6.6,16411,205,52,-197,-1241,20.5,1596.1,red,2,2.67,18,24,red
4523481420,4,5,3,1,0,1,0,16147,7,18863,222,55,482,914,22.2,1614.7,5,4,4,1,1,0,0,15665,7,17949,199,54,-482,-914,19.9,1566.5,red,1.4,2.25,43,21,red
4478267936,6,5,7,0,0,0,0,17065,7,18634,220,50,1019,327,22,1706.5,5,6,7,1,1,0,0,16046,7,18307,233,50,-1019,-327,23.3,1604.6,red,2.6,2,19,19,red
4523295777,8,7,6,2,1,1,0,17287,7,18953,215,62,817,266,21.5,1728.7,7,8,7,0,0,0,0,16470,7.2,18687,218,56,-817,-266,21.8,1647,blue,2,1.75,44,22,blue
4450437970,6,4,4,2,1,1,0,15997,7.2,19158,195,60,499,2441,19.5,1599.7,4,6,4,0,0,0,0,15498,6.6,16717,210,41,-499,-2441,21,1549.8,blue,2.5,1.33,35,22,blue
4523307860,3,3,4,0,0,0,0,15387,7,18342,215,64,-923,-1234,21.5,1538.7,3,3,5,1,1,0,0,16310,7.4,19576,232,72,923,1234,23.2,1631,blue,2.33,2.67,17,19,blue
4522150564,5,8,6,1,1,0,0,16313,7,17908,211,60,-531,241,21.1,1631.3,8,5,4,1,0,1,0,16844,6.8,17667,205,48,531,-241,20.5,1684.4,blue,1.38,2.4,20,17,red
4515910036,4,3,4,0,0,0,0,15987,7,18632,252,52,1033,372,25.2,1598.7,3,4,3,0,0,0,0,14954,7,18260,231,52,-1033,-372,23.1,1495.4,red,2.67,1.5,20,18,red
4504983497,7,8,9,0,0,0,0,16304,6.4,16307,169,44,-2336,-1468,16.9,1630.4,8,7,9,1,0,1,2,18640,7,17775,211,42,2336,1468,21.1,1864,blue,2,2.43,18,13,red
4459886824,10,12,11,1,0,1,0,18177,6.8,17640,203,40,-1253,-1627,20.3,1817.7,12,10,15,1,1,0,0,19430,7.2,19267,235,42,1253,1627,23.5,1943,blue,1.75,2.7,14,19,blue
4473361306,7,4,6,1,1,0,0,17493,7,18552,240,56,2851,1313,24,1749.3,4,7,4,0,0,0,0,14642,6.8,17239,198,54,-2851,-1313,19.8,1464.2,blue,3.25,1.14,20,13,red
4506292782,12,3,16,1,1,0,0,19443,7.2,19743,254,48,5349,4131,25.4,1944.3,3,12,3,0,0,0,0,14094,6.6,15612,190,48,-5349,-4131,19,1409.4,blue,9.33,0.5,13,19,blue
4515435281,4,5,5,0,0,0,0,14920,6.6,17571,186,45,-1670,-540,18.6,1492,5,4,1,2,1,1,0,16590,7,18111,233,56,1670,540,23.3,1659,red,1.8,1.5,13,14,red
4524281918,9,8,8,0,0,0,0,17511,6.8,17230,216,39,225,787,21.6,1751.1,8,9,14,0,0,0,0,17286,6.6,16443,206,49,-225,-787,20.6,1728.6,red,2.12,2.44,106,15,red
4518452503,9,5,10,1,1,0,0,16819,6.8,17163,197,40,459,-1147,19.7,1681.9,5,9,3,1,0,1,0,16360,6.8,18310,235,57,-459,1147,23.5,1636,blue,3.8,0.89,19,17,blue
4496336635,3,6,5,0,0,0,0,14703,6.8,16970,198,36,-2127,-1619,19.8,1470.3,6,3,10,1,1,0,0,16830,7,18589,233,55,2127,1619,23.3,1683,blue,1.33,5.33,37,20,blue
4523885762,7,5,5,0,0,0,0,16801,7.4,18747,203,64,575,706,20.3,1680.1,5,7,7,1,1,0,0,16226,7,18041,214,48,-575,-706,21.4,1622.6,blue,2.4,1.71,15,18,blue
4496613107,4,5,7,0,0,0,0,16254,7.2,18913,248,60,-329,-230,24.8,1625.4,5,4,5,0,0,0,0,16583,7.2,19143,272,47,329,230,27.2,1658.3,red,2.2,2.5,24,20,blue
4524349618,4,6,4,1,1,0,0,15478,6.8,18212,204,60,-2375,-293,20.4,1547.8,6,4,4,0,0,0,1,17853,7,18505,236,48,2375,293,23.6,1785.3,blue,1.33,2.5,78,17,red
4525122306,5,10,4,0,0,0,0,15363,6.4,16498,206,45,-2623,-2312,20.6,1536.3,10,5,16,1,0,1,0,17986,7,18810,226,33,2623,2312,22.6,1798.6,blue,0.9,5.2,22,18,red
4477398725,9,8,12,0,0,0,0,17121,6.6,16462,212,36,217,434,21.2,1712.1,8,9,9,1,0,1,0,16904,6.4,16028,173,35,-217,-434,17.3,1690.4,blue,2.62,1.89,19,17,blue
4510751913,5,13,5,0,0,0,0,15069,6.2,14655,172,36,-4160,-6073,17.2,1506.9,13,5,10,1,1,0,0,19229,7.4,20728,231,69,4160,6073,23.1,1922.9,red,0.77,4.6,19,52,red
4449452387,5,5,1,1,1,0,1,15891,6.4,15926,179,36,-498,-1785,17.9,1589.1,5,5,4,0,0,0,0,16389,6.8,17711,196,55,498,1785,19.6,1638.9,red,1.2,1.8,19,16,red
4477670126,1,9,1,0,0,0,0,13316,6.6,16245,188,49,-4500,-2980,18.8,1331.6,9,1,11,1,1,0,0,17816,7.2,19225,215,44,4500,2980,21.5,1781.6,red,0.22,20,18,15,red
4386551439,6,4,11,0,0,0,0,15956,6.8,17199,215,44,-43,-1154,21.5,1595.6,4,6,4,0,0,0,0,15999,7.2,18353,226,69,43,1154,22.6,1599.9,red,4.25,1.33,20,16,blue
4498209347,3,3,2,2,1,1,0,15661,7,18396,225,64,-643,-1199,22.5,1566.1,3,3,5,0,0,0,0,16304,7.2,19595,256,71,643,1199,25.6,1630.4,blue,1.67,2.67,31,18,blue
4520713335,6,5,5,0,0,0,0,16789,7,17947,198,57,1206,968,19.8,1678.9,5,6,5,0,0,0,0,15583,6.6,16979,192,36,-1206,-968,19.2,1558.3,blue,2.2,1.67,14,33,blue
4470773744,5,12,5,2,1,1,0,16347,6.6,17442,212,51,-3529,-1509,21.2,1634.7,12,5,15,0,0,0,1,19876,7.4,18951,214,52,3529,1509,21.4,1987.6,red,0.83,5.4,14,17,blue
4512800832,3,6,3,0,0,0,0,14901,6.8,16728,201,48,-1123,-976,20.1,1490.1,6,3,6,1,1,0,0,16024,6.8,17704,232,36,1123,976,23.2,1602.4,red,1,4,16,19,red
4520801311,8,7,12,1,1,0,0,17018,7,17105,190,56,1096,120,19,1701.8,7,8,4,0,0,0,0,15922,6.8,16985,196,47,-1096,-120,19.6,1592.2,red,2.86,1.38,26,43,blue
4525024400,8,13,12,0,0,0,0,16342,6.6,16909,165,42,-5219,-3480,16.5,1634.2,13,8,15,0,0,0,1,21561,7.4,20389,263,40,5219,3480,26.3,2156.1,red,1.54,3.5,38,43,red
4518554441,5,11,3,1,1,0,0,14801,6.2,16202,209,42,-3527,-1901,20.9,1480.1,11,5,12,0,0,0,0,18328,7,18103,230,43,3527,1901,23,1832.8,red,0.73,4.6,19,22,red
4502764370,9,6,17,0,0,0,0,17333,6.8,17113,209,43,1936,1447,20.9,1733.3,6,9,5,0,0,0,0,15397,6.4,15666,197,40,-1936,-1447,19.7,1539.7,red,4.33,1.22,15,19,blue
4515780099,4,7,6,0,0,0,0,15052,7,16945,194,50,-1729,-1258,19.4,1505.2,7,4,8,1,1,0,0,16781,7,18203,226,48,1729,1258,22.6,1678.1,red,1.43,3.75,20,23,red
4437310963,4,6,5,0,0,0,0,15585,6.8,17392,227,46,-797,-843,22.7,1558.5,6,4,7,0,0,0,0,16382,7,18235,241,40,797,843,24.1,1638.2,blue,1.5,3.25,19,18,blue
4484529733,3,5,4,0,0,0,0,15273,7,17980,214,58,-764,-1142,21.4,1527.3,5,3,1,1,1,0,0,16037,7,19122,248,56,764,1142,24.8,1603.7,red,1.4,2,49,23,red
4514844957,5,9,7,0,0,0,0,15666,6.6,15541,188,48,-2484,-3235,18.8,1566.6,9,5,5,1,1,0,0,18150,7.2,18776,235,56,2484,3235,23.5,1815,red,1.33,2.8,21,19,blue
4496994572,2,8,0,1,0,1,0,14591,6.8,17470,219,60,-2269,-1078,21.9,1459.1,8,2,7,1,1,0,0,16860,7.2,18548,223,42,2269,1078,22.3,1686,red,0.25,7.5,16,38,red
4522889281,3,7,5,0,0,0,0,14690,6.2,15769,191,44,-1753,-3324,19.1,1469,7,3,4,0,0,0,0,16443,7,19093,210,63,1753,3324,21,1644.3,red,1.14,3.67,14,28,red
4521575366,7,7,8,0,0,0,0,17151,6.8,17777,193,49,-1122,-926,19.3,1715.1,7,7,6,2,1,1,1,18273,7.2,18703,234,55,1122,926,23.4,1827.3,red,2.14,1.86,49,15,red
4462377853,6,6,6,0,0,0,0,16378,6.8,17819,211,43,428,-558,21.1,1637.8,6,6,6,2,1,1,0,15950,7,18377,216,49,-428,558,21.6,1595,red,2,2,125,58,blue
4523960363,5,7,7,0,0,0,0,15661,6.4,15375,208,39,-945,-2334,20.8,1566.1,7,5,5,0,0,0,0,16606,7,17709,234,36,945,2334,23.4,1660.6,red,1.71,2.4,21,17,red
4513242798,7,4,4,0,0,0,0,16589,7,18105,231,49,-17,-355,23.1,1658.9,4,7,4,1,1,0,0,16606,7.2,18460,220,66,17,355,22,1660.6,red,2.75,1.14,19,20,blue
4489563821,3,6,3,2,1,1,0,15900,6.8,17700,234,40,-1286,-995,23.4,1590,6,3,6,0,0,0,0,17186,7,18695,214,54,1286,995,21.4,1718.6,red,1,4,14,15,blue
4485610478,5,9,8,0,0,0,0,14927,6.6,15638,196,25,-2614,-1880,19.6,1492.7,9,5,16,1,1,0,0,17541,6.8,17518,214,47,2614,1880,21.4,1754.1,blue,1.44,5,19,20,blue
4472446718,2,3,0,1,0,1,1,16875,6.8,18159,247,56,2231,223,24.7,1687.5,3,2,3,1,1,0,0,14644,6.8,17936,190,76,-2231,-223,19,1464.4,blue,0.67,3,17,18,blue
4524894613,8,2,8,1,0,1,0,17847,7,18916,207,60,3060,1838,20.7,1784.7,2,8,3,0,0,0,0,14787,6.6,17078,221,60,-3060,-1838,22.1,1478.7,red,8,0.62,20,17,blue
4469128584,6,6,9,0,0,0,0,16369,7,18278,201,40,311,-50,20.1,1636.9,6,6,5,0,0,0,0,16058,7.2,18328,216,52,-311,50,21.6,1605.8,blue,2.5,1.83,89,16,blue
4452166670,4,1,7,2,1,1,0,17320,7.4,18965,264,75,2850,1646,26.4,1732,1,4,0,0,0,0,0,14470,6.8,17319,248,45,-2850,-1646,24.8,1447,blue,11,0.25,17,47,blue
4524202231,9,4,6,1,1,0,0,18532,7.4,20134,231,55,3195,1370,23.1,1853.2,4,9,1,0,0,0,0,15337,7.2,18764,223,64,-3195,-1370,22.3,1533.7,blue,3.75,0.56,16,126,blue
4450399741,8,6,10,0,0,0,0,17136,7,18233,202,54,1363,-147,20.2,1713.6,6,8,2,1,0,1,0,15773,7,18380,218,56,-1363,147,21.8,1577.3,red,3,1,26,23,blue
4524785066,8,6,7,0,0,0,0,17137,7.2,18448,192,44,1025,-199,19.2,1713.7,6,8,4,1,1,0,0,16112,6.8,18647,187,56,-1025,199,18.7,1611.2,red,2.5,1.25,21,17,red
4523130244,8,7,11,1,0,1,1,19114,7,18680,245,44,2544,-21,24.5,1911.4,7,8,10,1,1,0,0,16570,7,18701,209,60,-2544,21,20.9,1657,red,2.71,2.12,21,24,blue
4522178683,2,10,2,0,0,0,0,13555,6,13939,150,48,-6373,-5156,15,1355.5,10,2,9,2,1,1,1,19928,7.2,19095,242,56,6373,5156,24.2,1992.8,red,0.4,9.5,33,21,red
4469812384,4,5,5,0,0,0,0,14707,6.6,16234,213,36,-2268,-2502,21.3,1470.7,5,4,5,1,1,0,0,16975,7.2,18736,254,62,2268,2502,25.4,1697.5,blue,1.8,2.5,23,26,blue
4506010856,3,7,2,0,0,0,0,16025,7,17956,214,56,-44,-357,21.4,1602.5,7,3,5,1,1,0,0,16069,7,18313,220,44,44,357,22,1606.9,red,0.71,4,18,109,blue
4509803482,8,7,11,0,0,0,0,16776,6.4,15799,196,39,357,-26,19.6,1677.6,7,8,7,0,0,0,0,16419,6.2,15825,186,36,-357,26,18.6,1641.9,red,2.71,1.75,18,19,blue
4508899687,3,3,1,0,0,0,0,15379,7,17670,232,48,236,-37,23.2,1537.9,3,3,5,1,1,0,0,15143,6.8,17707,217,52,-236,37,21.7,1514.3,blue,1.33,2.67,19,22,red
4521616991,5,1,6,1,1,0,0,17196,7.2,19002,239,64,2973,1440,23.9,1719.6,1,5,2,0,0,0,0,14223,6.8,17562,239,48,-2973,-1440,23.9,1422.3,blue,11,0.6,26,24,blue
4509711649,7,1,4,1,1,0,0,17200,7.2,19346,234,60,2977,3051,23.4,1720,1,7,1,0,0,0,0,14223,6.6,16295,211,72,-2977,-3051,21.1,1422.3,blue,11,0.29,25,19,blue
4519025105,9,8,11,1,0,1,0,17472,7.2,17708,180,50,-423,-1210,18,1747.2,8,9,11,1,1,0,0,17895,7.2,18918,221,54,423,1210,22.1,1789.5,red,2.5,2.11,18,19,red
4473597829,4,5,5,0,0,0,0,15435,6.8,17093,231,38,-1077,-2560,23.1,1543.5,5,4,1,0,0,0,0,16512,7.4,19653,249,75,1077,2560,24.9,1651.2,red,1.8,1.5,23,21,blue
4478188896,6,4,5,1,1,0,0,16588,7.2,19189,229,62,1782,1959,22.9,1658.8,4,6,1,1,0,1,0,14806,6.8,17230,189,44,-1782,-1959,18.9,1480.6,blue,2.75,0.83,22,19,blue
4513831840,6,6,7,0,0,0,0,16784,7,17848,228,40,941,129,22.8,1678.4,6,6,4,0,0,0,0,15843,6.8,17719,176,55,-941,-129,17.6,1584.3,blue,2.17,1.67,17,17,blue
4462163208,9,8,11,1,1,0,0,16982,7,18420,191,44,-1346,-1607,19.1,1698.2,8,9,7,0,0,0,0,18328,7.4,20027,212,76,1346,1607,21.2,1832.8,blue,2.5,1.67,44,15,red
4514218237,9,13,11,0,0,0,0,17635,6.6,16554,175,42,-1430,-2349,17.5,1763.5,13,9,13,1,1,0,0,19065,7.2,18903,219,53,1430,2349,21.9,1906.5,blue,1.54,2.89,22,16,blue
4505075524,5,8,2,0,0,0,0,15913,6.8,18220,225,46,-1091,-892,22.5,1591.3,8,5,6,1,1,0,0,17004,7.2,19112,208,66,1091,892,20.8,1700.4,red,0.88,2.8,10,17,red
4470324396,4,7,6,1,1,0,0,14487,6.4,16054,170,52,-2088,-2747,17,1448.7,7,4,6,0,0,0,0,16575,7.4,18801,217,40,2088,2747,21.7,1657.5,red,1.43,3.25,19,15,red
4489428547,2,3,1,0,0,0,0,15643,6.8,18376,233,72,-1045,169,23.3,1564.3,3,2,3,0,0,0,1,16688,7.2,18207,229,52,1045,-169,22.9,1668.8,red,1,3,19,19,blue
4472696992,5,5,5,0,0,0,0,16853,7.2,18782,233,48,213,-583,23.3,1685.3,5,5,2,0,0,0,0,16640,7,19365,249,57,-213,583,24.9,1664,blue,2,1.4,21,35,red
4497596162,12,2,14,1,0,1,0,18242,7,17997,195,58,4484,2878,19.5,1824.2,2,12,1,0,0,0,0,13758,6.2,15119,199,32,-4484,-2878,19.9,1375.8,blue,13,0.25,16,21,blue
4486956653,7,7,8,0,0,0,0,16866,6.8,17575,194,54,-1543,-523,19.4,1686.6,7,7,7,1,0,1,1,18409,7,18098,207,48,1543,523,20.7,1840.9,blue,2.14,2,29,17,blue
4449670595,2,5,2,0,0,0,0,14673,7.2,18411,232,44,-2599,-818,23.2,1467.3,5,2,7,1,1,0,0,17272,7,19229,271,60,2599,818,27.1,1727.2,red,0.8,6,15,10,red
4472747889,4,5,4,0,0,0,0,15463,6.8,17936,215,45,-338,-9,21.5,1546.3,5,4,6,1,1,0,0,15801,7.2,17945,217,58,338,9,21.7,1580.1,blue,1.6,2.75,74,18,blue
4525215598,6,9,6,1,1,0,0,15824,6.6,16324,210,41,-2047,-2330,21,1582.4,9,6,8,1,0,1,0,17871,6.8,18654,205,64,2047,2330,20.5,1787.1,blue,1.33,2.83,60,22,red
4524641094,8,5,13,0,0,0,0,17129,6.8,17579,227,32,1192,449,22.7,1712.9,5,8,7,0,0,0,0,15937,6.8,17130,225,48,-1192,-449,22.5,1593.7,blue,4.2,1.5,40,18,red
4471001241,6,3,4,0,0,0,0,16335,6.8,17761,236,33,1167,489,23.6,1633.5,3,6,1,1,1,0,0,15168,6.8,17272,206,52,-1167,-489,20.6,1516.8,blue,3.33,0.67,24,89,red
4515369512,6,4,8,0,0,0,0,17099,7,18702,208,74,1579,1223,20.8,1709.9,4,6,3,1,1,0,0,15520,6.8,17479,228,43,-1579,-1223,22.8,1552,red,3.5,1.17,12,13,red
4476146291,10,2,6,1,1,0,0,19077,7.6,20483,234,52,5271,3997,23.4,1907.7,2,10,2,0,0,0,0,13806,6.6,16486,191,48,-5271,-3997,19.1,1380.6,blue,8,0.4,90,16,blue
4503152696,1,7,0,0,0,0,0,14983,6.8,17958,271,60,-1607,-1043,27.1,1498.3,7,1,10,1,1,0,0,16590,7,19001,212,54,1607,1043,21.2,1659,blue,0.14,17,12,13,red
4524326952,9,6,9,0,0,0,0,17368,6.8,18134,219,40,280,-1018,21.9,1736.8,6,9,8,0,0,0,0,17088,7.2,19152,227,59,-280,1018,22.7,1708.8,blue,3,1.56,19,18,red
4522317391,3,8,4,0,0,0,0,15286,6.8,17397,225,47,-2811,-2702,22.5,1528.6,8,3,11,2,1,1,0,18097,7.6,20099,247,68,2811,2702,24.7,1809.7,red,0.88,6.33,29,45,red
4495498094,5,8,5,0,0,0,0,16317,7,17669,209,56,-1025,-1767,20.9,1631.7,8,5,4,0,0,0,0,17342,7.2,19436,245,56,1025,1767,24.5,1734.2,red,1.25,2.4,14,16,red
4477368808,5,4,9,2,1,1,0,16364,7.4,19838,245,60,409,1681,24.5,1636.4,4,5,3,0,0,0,0,15955,6.8,18157,229,60,-409,-1681,22.9,1595.5,blue,3.5,1.4,17,17,red
4434549109,3,3,6,1,1,0,0,14623,6.6,15613,173,47,-417,-1234,17.3,1462.3,3,3,4,0,0,0,0,15040,6.8,16847,207,46,417,1234,20.7,1504,red,3,2.33,43,60,blue
4523746056,10,5,12,0,0,0,1,19938,7,18437,222,44,4534,1707,22.2,1993.8,5,10,4,1,1,0,0,15404,6.6,16730,214,52,-4534,-1707,21.4,1540.4,blue,4.4,0.9,87,15,blue
4493134944,5,8,5,0,0,0,0,16221,7,17699,216,64,-1437,-1656,21.6,1622.1,8,5,4,2,1,1,0,17658,7.2,19355,227,68,1437,1656,22.7,1765.8,red,1.25,2.4,17,41,red
4518121833,7,12,5,1,1,0,0,16544,6.8,17779,194,56,-3011,-1199,19.4,1654.4,12,7,20,0,0,0,0,19555,7,18978,222,36,3011,1199,22.2,1955.5,blue,1,4.57,15,16,blue
4515904262,8,7,7,0,0,0,0,17908,7.2,19202,229,54,653,430,22.9,1790.8,7,8,9,1,1,0,0,17255,7.2,18772,247,46,-653,-430,24.7,1725.5,blue,2.14,2,18,14,red
4506294418,2,2,1,0,0,0,0,15831,7.4,19463,271,64,1134,1160,27.1,1583.1,2,2,0,1,1,0,0,14697,7,18303,238,61,-1134,-1160,23.8,1469.7,red,1.5,1,18,15,red
4509108829,9,7,9,0,0,0,0,17668,7.2,18804,230,55,1024,750,23,1766.8,7,9,5,0,0,0,0,16644,7.2,18054,226,48,-1024,-750,22.6,1664.4,blue,2.57,1.33,18,15,blue
4518590112,5,7,6,0,0,0,0,15470,6.8,17038,217,40,-1708,-677,21.7,1547,7,5,12,0,0,0,0,17178,7.2,17715,207,44,1708,677,20.7,1717.8,red,1.57,3.8,18,53,red
4483110650,6,6,5,0,0,0,0,16448,6.8,17691,207,59,442,541,20.7,1644.8,6,6,3,0,0,0,0,16006,6.8,17150,221,52,-442,-541,22.1,1600.6,blue,1.83,1.5,18,19,red
4523035585,5,7,2,0,0,0,0,14877,7,17258,205,44,-1550,-1018,20.5,1487.7,7,5,8,0,0,0,0,16427,7,18276,211,55,1550,1018,21.1,1642.7,blue,1,3,28,15,red
4509064121,13,1,18,0,0,0,0,18917,7.6,19563,226,48,4611,3311,22.6,1891.7,1,13,1,0,0,0,0,14306,6.6,16252,213,48,-4611,-3311,21.3,1430.6,blue,31,0.15,45,84,blue
4523282532,6,9,8,0,0,0,0,16356,6.4,16343,202,47,-2865,-3840,20.2,1635.6,9,6,10,2,1,1,0,19221,7.4,20183,223,59,2865,3840,22.3,1922.1,red,1.56,3.17,16,21,blue
4518881307,3,7,5,0,0,0,0,14676,6.6,16668,170,59,-1563,-1232,17,1467.6,7,3,3,1,1,0,0,16239,6.8,17900,201,52,1563,1232,20.1,1623.9,red,1.14,3.33,19,19,red
4523038174,2,12,3,0,0,0,0,13126,6,14222,175,46,-4394,-3817,17.5,1312.6,12,2,11,1,1,0,0,17520,7,18039,195,44,4394,3817,19.5,1752,red,0.42,11.5,15,16,blue
4470312208,10,6,14,0,0,0,0,17769,7.2,18832,207,44,1417,1116,20.7,1776.9,6,10,3,1,1,0,0,16352,7,17716,215,58,-1417,-1116,21.5,1635.2,blue,4,0.9,20,18,red
4516146115,6,8,4,0,0,0,0,16051,6.8,17315,199,58,-485,-353,19.9,1605.1,8,6,8,1,1,0,0,16536,6.8,17668,199,44,485,353,19.9,1653.6,red,1.25,2.67,39,19,red
4522849346,6,3,6,1,0,1,0,17395,7.2,18998,252,56,2234,1606,25.2,1739.5,3,6,5,1,1,0,0,15161,7,17392,226,56,-2234,-1606,22.6,1516.1,red,4,1.33,89,24,blue
4477571512,8,4,12,1,1,0,0,16819,6.8,17190,199,58,1896,1069,19.9,1681.9,4,8,5,0,0,0,0,14923,6.6,16121,216,41,-1896,-1069,21.6,1492.3,blue,5,1.12,22,26,blue
4523940286,5,6,8,2,1,1,0,16315,6.8,17744,236,56,199,403,23.6,1631.5,6,5,9,0,0,0,0,16116,6.6,17341,227,34,-199,-403,22.7,1611.6,red,2.17,3,20,19,red
4513532582,7,6,8,1,1,0,0,16846,6.8,17698,246,39,-1705,-1679,24.6,1684.6,6,7,5,1,0,1,2,18551,7.2,19377,240,59,1705,1679,24,1855.1,blue,2.5,1.57,22,15,blue
4516772132,2,5,1,1,0,1,1,15951,7,18136,236,42,-675,-1212,23.6,1595.1,5,2,6,0,0,0,0,16626,7.2,19348,234,60,675,1212,23.4,1662.6,red,0.6,5.5,18,20,blue
4516594125,7,3,8,1,1,0,0,16858,7,18658,228,40,1160,1541,22.8,1685.8,3,7,6,0,0,0,0,15698,6.6,17117,244,58,-1160,-1541,24.4,1569.8,blue,5,1.29,17,26,red
4477392695,10,9,10,0,0,0,0,17335,6.6,16110,176,48,1287,-749,17.6,1733.5,9,10,11,1,1,0,0,16048,6.6,16859,198,40,-1287,749,19.8,1604.8,blue,2.22,2,23,19,blue
4500102951,7,7,7,0,0,0,0,16781,6.8,17415,194,52,-2063,-1448,19.4,1678.1,7,7,7,0,0,0,1,18844,7,18863,232,52,2063,1448,23.2,1884.4,red,2,2,18,28,blue
4447441297,8,4,11,0,0,0,0,17225,6.8,18183,222,57,2559,2593,22.2,1722.5,4,8,4,0,0,0,0,14666,6.2,15590,209,36,-2559,-2593,20.9,1466.6,blue,4.75,1,46,44,red
4523657411,6,4,4,0,0,0,0,16948,7,18271,252,60,2346,1424,25.2,1694.8,4,6,1,1,1,0,0,14602,6.4,16847,211,51,-2346,-1424,21.1,1460.2,blue,2.5,0.83,19,18,red
4487004786,7,7,7,1,1,0,0,16056,6.6,16268,188,40,-1151,-1924,18.8,1605.6,7,7,14,1,0,1,0,17207,7,18192,235,49,1151,1924,23.5,1720.7,red,2,3,23,16,red
4523591734,5,9,5,0,0,0,0,15440,6.4,15725,180,43,-1729,118,18,1544,9,5,8,0,0,0,0,17169,6.4,15607,185,44,1729,-118,18.5,1716.9,blue,1.11,3.4,40,19,red
4481802992,8,6,12,1,1,0,0,16058,6.4,15685,178,40,-1441,-2022,17.8,1605.8,6,8,10,0,0,0,0,17499,6.8,17707,240,60,1441,2022,24,1749.9,red,3.33,2,25,22,blue
4524924160,5,4,3,1,1,0,0,16315,7,18479,256,44,763,1243,25.6,1631.5,4,5,3,0,0,0,0,15552,6.8,17236,218,52,-763,-1243,21.8,1555.2,blue,2,1.4,19,17,blue
4448119077,9,4,16,1,1,0,0,17326,6.8,18168,188,58,1209,574,18.8,1732.6,4,9,5,0,0,0,0,16117,6.8,17594,231,33,-1209,-574,23.1,1611.7,blue,6.25,1,59,21,blue
4516417495,5,3,5,0,0,0,0,16851,7,18647,225,65,1706,1154,22.5,1685.1,3,5,5,1,1,0,0,15145,7,17493,219,54,-1706,-1154,21.9,1514.5,red,3.33,1.6,84,47,red
4514750583,6,2,4,0,0,0,0,16853,6.8,18346,234,44,2097,1569,23.4,1685.3,2,6,1,0,0,0,0,14756,6.6,16777,228,50,-2097,-1569,22.8,1475.6,blue,5,0.5,14,108,blue
4497828297,9,3,8,1,1,0,0,17556,7.4,19338,211,52,2201,1421,21.1,1755.6,3,9,3,0,0,0,0,15355,7,17917,227,49,-2201,-1421,22.7,1535.5,blue,5.67,0.67,17,35,blue
4518204390,11,12,9,0,0,0,0,17840,7,18114,175,51,-2425,-1827,17.5,1784,12,11,12,2,1,1,1,20265,7.4,19941,197,58,2425,1827,19.7,2026.5,red,1.67,2.18,17,30,blue
4462251940,10,6,9,0,0,0,0,18725,7.4,19513,243,59,2376,1325,24.3,1872.5,6,10,5,0,0,0,0,16349,7.2,18188,215,52,-2376,-1325,21.5,1634.9,red,3.17,1.1,22,19,blue
4457833778,5,6,5,0,0,0,0,16781,6.8,18303,222,48,679,1400,22.2,1678.1,6,5,6,1,1,0,0,16102,6.6,16903,192,57,-679,-1400,19.2,1610.2,blue,1.67,2.4,18,17,blue
4518920313,5,12,8,1,1,0,0,15376,6.6,16791,206,41,-4864,-3336,20.6,1537.6,12,5,11,0,0,0,0,20240,7.6,20127,247,48,4864,3336,24.7,2024,red,1.08,4.6,16,70,red
4439541078,2,6,1,0,0,0,0,14193,7,17801,218,43,-3116,-1349,21.8,1419.3,6,2,7,0,0,0,0,17309,7.4,19150,247,71,3116,1349,24.7,1730.9,red,0.5,6.5,21,18,red
4512918864,7,9,5,0,0,0,0,16862,6.8,18123,206,44,-542,-254,20.6,1686.2,9,7,8,2,1,1,0,17404,7.2,18377,222,41,542,254,22.2,1740.4,blue,1.33,2.43,17,18,red
4456463104,4,3,5,2,1,1,0,17003,6.8,18427,239,64,1634,546,23.9,1700.3,3,4,4,0,0,0,0,15369,7,17881,261,29,-1634,-546,26.1,1536.9,blue,3,1.75,27,29,blue
4459480413,4,6,5,0,0,0,0,15506,6.8,17710,231,50,-672,-1420,23.1,1550.6,6,4,4,1,1,0,0,16178,7.2,19130,214,49,672,1420,21.4,1617.8,red,1.5,2.5,16,13,red
4521091433,10,10,15,0,0,0,0,18724,6.8,18411,221,33,622,319,22.1,1872.4,10,10,16,2,1,1,0,18102,7,18092,220,47,-622,-319,22,1810.2,red,2.5,2.6,22,42,red
4477326347,4,3,3,1,0,1,0,16422,6.8,18048,242,54,1571,560,24.2,1642.2,3,4,3,1,1,0,0,14851,7,17488,211,56,-1571,-560,21.1,1485.1,blue,2.33,1.5,25,18,blue
4467752796,13,5,10,1,0,1,0,18337,7.2,18978,194,43,3211,3640,19.4,1833.7,5,13,6,0,0,0,0,15126,6.4,15338,182,32,-3211,-3640,18.2,1512.6,blue,4.6,0.85,18,16,blue
4524232031,6,10,6,1,1,0,0,15385,6.6,16039,210,48,-3134,-2772,21,1538.5,10,6,8,0,0,0,0,18519,7,18811,232,47,3134,2772,23.2,1851.9,blue,1.2,3,38,19,blue
4520510756,6,5,6,0,0,0,0,15566,6.8,17340,211,52,-1951,-872,21.1,1556.6,5,6,6,1,1,0,0,17517,7.2,18212,233,68,1951,872,23.3,1751.7,red,2.4,1.83,20,16,red
4463289443,8,4,10,0,0,0,0,18326,7.2,19015,239,51,3517,2356,23.9,1832.6,4,8,4,1,0,1,0,14809,6.6,16659,203,24,-3517,-2356,20.3,1480.9,blue,4.5,1,22,25,blue
4518300534,6,6,9,0,0,0,0,16299,6.8,17800,226,42,80,-599,22.6,1629.9,6,6,4,1,1,0,0,16219,7.2,18399,210,48,-80,599,21,1621.9,red,2.5,1.67,15,15,red
4525106403,1,3,1,0,0,0,0,13991,6.8,17215,221,59,-1380,-581,22.1,1399.1,3,1,2,1,1,0,0,15371,7,17796,224,52,1380,581,22.4,1537.1,red,0.67,5,14,13,red
4511755420,3,4,4,0,0,0,0,14205,6.6,16546,203,40,-1115,178,20.3,1420.5,4,3,4,1,1,0,0,15320,6.6,16368,192,52,1115,-178,19.2,1532,blue,1.75,2.67,17,20,red
4475203157,6,2,11,0,0,0,0,17955,7.2,18774,270,43,3187,880,27,1795.5,2,6,1,1,1,0,0,14768,6.8,17894,230,64,-3187,-880,23,1476.8,red,8.5,0.5,21,18,blue
4471503799,13,5,16,0,0,0,1,20862,7,18335,232,39,6423,3767,23.2,2086.2,5,13,8,0,0,0,0,14439,6.2,14568,148,45,-6423,-3767,14.8,1443.9,blue,5.8,1,54,16,blue
4512974012,0,6,0,0,0,0,0,14197,6.8,17915,255,54,-2313,-1210,25.5,1419.7,6,0,6,0,0,0,0,16510,7.2,19125,231,64,2313,1210,23.1,1651,red,0,12.65,17,63,red
4524697889,5,3,4,1,0,1,0,16788,7.2,19474,264,59,1346,919,26.4,1678.8,3,5,6,1,1,0,0,15442,7.2,18555,242,56,-1346,-919,24.2,1544.2,red,3,1.8,29,42,blue
4492336087,3,6,4,1,1,0,0,14798,6.8,16659,179,54,-2402,-1757,17.9,1479.8,6,3,7,0,0,0,0,17200,6.8,18416,227,52,2402,1757,22.7,1720,blue,1.17,4.33,35,14,red
4518449661,3,7,4,0,0,0,0,15598,6.8,17735,220,69,-1293,-260,22,1559.8,7,3,6,1,1,0,0,16891,7,17995,237,42,1293,260,23.7,1689.1,red,1,4.33,16,26,red
4524325797,5,2,2,0,0,0,0,16655,7.2,19541,238,59,2089,1675,23.8,1665.5,2,5,3,1,1,0,0,14566,6.8,17866,224,57,-2089,-1675,22.4,1456.6,blue,3.5,1,18,15,red
4466191823,8,4,9,1,1,0,0,16804,7.2,18899,206,60,2290,1865,20.6,1680.4,4,8,2,0,0,0,0,14514,6.6,17034,180,40,-2290,-1865,18,1451.4,red,4.25,0.75,21,12,red
4512225381,6,7,4,2,1,1,0,15977,6.8,17653,198,60,-1397,-1549,19.8,1597.7,7,6,6,0,0,0,0,17374,7.2,19202,230,62,1397,1549,23,1737.4,blue,1.43,2.17,18,23,blue
4518609876,4,3,2,1,1,0,0,15654,7.2,18324,233,46,-360,-61,23.3,1565.4,3,4,2,1,0,1,0,16014,7,18385,254,64,360,61,25.4,1601.4,red,2,1.25,18,11,red
4513906148,10,2,12,1,1,0,0,19035,7.4,19265,239,60,5465,3492,23.9,1903.5,2,10,2,0,0,0,0,13570,6.4,15773,190,32,-5465,-3492,19,1357,blue,11,0.4,23,34,blue
4450742884,4,2,5,1,0,1,0,16247,7.4,19687,226,72,1032,1098,22.6,1624.7,2,4,2,1,1,0,0,15215,7,18589,243,68,-1032,-1098,24.3,1521.5,red,4.5,1,17,16,red
4475833403,8,5,11,0,0,0,0,18074,7.4,19746,235,54,1887,1295,23.5,1807.4,5,8,4,0,0,0,0,16187,7,18451,220,64,-1887,-1295,22,1618.7,red,3.8,1.12,17,17,blue
4513432258,8,2,9,1,0,1,0,17274,7,18134,233,39,3640,2348,23.3,1727.4,2,8,0,0,0,0,0,13634,6.4,15786,202,44,-3640,-2348,20.2,1363.4,blue,8.5,0.25,16,17,blue
4505960953,10,7,12,0,0,0,0,17839,7,18614,201,48,1452,689,20.1,1783.9,7,10,5,1,1,0,0,16387,7.2,17925,198,56,-1452,-689,19.8,1638.7,blue,3.14,1.2,19,40,red
4512128800,6,6,11,0,0,0,0,16700,7,17393,218,40,1806,4,21.8,1670,6,6,3,1,1,0,0,14894,6.6,17389,203,39,-1806,-4,20.3,1489.4,blue,2.83,1.5,16,15,blue
4520602146,6,5,10,0,0,0,0,15852,6.8,17369,192,43,66,-57,19.2,1585.2,5,6,5,1,1,0,0,15786,6.8,17426,232,48,-66,57,23.2,1578.6,blue,3.2,1.67,17,22,red
4523446704,4,4,4,0,0,0,0,15296,6.6,17179,221,40,-112,-812,22.1,1529.6,4,4,4,1,1,0,0,15408,6.8,17991,222,50,112,812,22.2,1540.8,blue,2,2,19,17,blue
4517498934,1,1,2,1,1,0,0,14426,6.8,17085,219,52,-323,-615,21.9,1442.6,1,1,2,0,0,0,0,14749,6.6,17700,243,44,323,615,24.3,1474.9,blue,3,3,20,18,blue
4512991895,4,4,2,0,0,0,0,15856,7,19023,248,66,-82,745,24.8,1585.6,4,4,4,1,1,0,0,15938,7,18278,254,51,82,-745,25.4,1593.8,blue,1.5,2,22,21,blue
4511697354,11,6,17,0,0,0,0,17895,6.8,16640,191,38,2088,-118,19.1,1789.5,6,11,5,1,1,0,0,15807,6.6,16758,202,41,-2088,118,20.2,1580.7,blue,4.67,1,19,19,blue
4509390548,6,9,9,0,0,0,0,15728,6.6,17183,208,44,-2701,-2275,20.8,1572.8,9,6,8,0,0,0,0,18429,7.2,19458,208,56,2701,2275,20.8,1842.9,red,1.67,2.83,16,18,blue
4523847046,5,5,5,0,0,0,1,17333,6.8,16881,232,39,781,-1744,23.2,1733.3,5,5,4,1,0,1,0,16552,7.2,18625,234,52,-781,1744,23.4,1655.2,blue,2,1.8,21,19,blue
4521229573,8,7,9,0,0,0,0,16404,6.8,17425,197,54,283,608,19.7,1640.4,7,8,8,1,1,0,0,16121,6.6,16817,216,36,-283,-608,21.6,1612.1,red,2.43,1.88,38,108,blue
4523099371,6,6,6,1,1,0,0,15738,7,17430,206,52,-360,-708,20.6,1573.8,6,6,1,1,0,1,0,16098,7,18138,230,60,360,708,23,1609.8,blue,2,1.17,15,20,red
4454340438,0,4,0,0,0,0,0,13580,6.4,16571,207,48,-4279,-4529,20.7,1358,4,0,2,2,1,1,0,17859,7.6,21100,266,82,4279,4529,26.6,1785.9,red,0,12.65,16,39,red
4522233309,6,7,4,1,1,0,0,16773,6.8,17641,237,48,120,-1254,23.7,1677.3,7,6,5,0,0,0,0,16653,7.2,18895,224,48,-120,1254,22.4,1665.3,red,1.43,2,22,22,red
4522851544,4,8,5,0,0,0,0,14993,6.6,16251,215,33,-1845,-1879,21.5,1499.3,8,4,10,1,1,0,0,16838,7,18130,229,52,1845,1879,22.9,1683.8,red,1.12,4.5,17,20,red
4477952218,2,3,1,0,0,0,0,15219,6.8,17357,241,48,-563,-1422,24.1,1521.9,3,2,3,1,1,0,0,15782,7,18779,225,68,563,1422,22.5,1578.2,red,1,3,23,24,blue
4524900918,6,8,4,0,0,0,0,16046,6.6,16986,203,48,-1112,-942,20.3,1604.6,8,6,7,0,0,0,0,17158,7,17928,220,56,1112,942,22,1715.8,red,1.25,2.5,18,18,red
4491423800,6,8,5,1,1,0,0,15683,7,17335,186,54,-1906,-1476,18.6,1568.3,8,6,9,1,0,1,0,17589,7,18811,240,45,1906,1476,24,1758.9,red,1.38,2.83,16,15,red
4498664895,5,9,5,1,1,0,0,16408,6.8,17435,199,69,-2517,-1199,19.9,1640.8,9,5,12,0,0,0,0,18925,7.2,18634,248,44,2517,1199,24.8,1892.5,red,1.11,4.2,12,35,red
4465820697,3,7,2,1,0,1,0,15104,6.8,17634,228,38,-2831,-1651,22.8,1510.4,7,3,8,1,1,0,0,17935,7.4,19285,242,66,2831,1651,24.2,1793.5,red,0.71,5,19,17,red
4501779329,6,5,7,1,0,1,0,16113,6.8,16994,180,41,-1063,-632,18,1611.3,5,6,5,0,0,0,1,17176,6.8,17626,240,41,1063,632,24,1717.6,red,2.6,1.67,20,22,blue
4519218713,11,7,15,0,0,0,0,18894,6.8,17942,219,35,1573,-624,21.9,1889.4,7,11,7,2,1,1,0,17321,7,18566,220,76,-1573,624,22,1732.1,blue,3.71,1.27,17,15,red
4474045556,7,9,5,0,0,0,0,16652,6.8,18147,212,59,-427,-13,21.2,1665.2,9,7,9,0,0,0,0,17079,7,18160,226,32,427,13,22.6,1707.9,red,1.33,2.57,26,16,red
4524351356,4,10,4,0,0,0,0,15409,6.8,17089,218,40,-2161,-297,21.8,1540.9,10,4,18,0,0,0,0,17570,6.6,17386,187,48,2161,297,18.7,1757,red,0.8,7,21,15,red
4521873427,8,4,8,0,0,0,0,16733,7.4,19524,193,57,479,929,19.3,1673.3,4,8,3,1,1,0,0,16254,7,18595,233,67,-479,-929,23.3,1625.4,blue,4,0.88,17,21,red
4502515468,12,5,13,0,0,0,0,17307,6.4,16818,189,26,3237,2107,18.9,1730.7,5,12,4,0,0,0,0,14070,6.2,14711,158,33,-3237,-2107,15.8,1407,blue,5,0.75,25,14,blue
4522644977,5,4,8,1,1,0,0,15283,7,17676,223,48,230,-105,22.3,1528.3,4,5,5,0,0,0,0,15053,6.8,17781,212,52,-230,105,21.2,1505.3,blue,3.25,1.8,23,20,red
4499613300,3,7,1,0,0,0,0,14428,6.6,16819,215,52,-1217,-539,21.5,1442.8,7,3,11,1,1,0,0,15645,6.8,17358,216,32,1217,539,21.6,1564.5,red,0.57,6,14,65,red
4517778477,7,6,12,1,1,0,0,16679,7,17760,193,47,273,87,19.3,1667.9,6,7,9,0,0,0,0,16406,6.8,17673,215,48,-273,-87,21.5,1640.6,blue,3.17,2.14,15,15,blue
4450067073,4,10,3,0,0,0,0,15400,6.6,16607,188,45,-2552,-2052,18.8,1540,10,4,13,1,1,0,0,17952,6.8,18659,212,50,2552,2052,21.2,1795.2,red,0.7,5.75,47,53,red
4522151939,7,7,6,0,0,0,0,16230,6.8,17336,216,40,-4,-139,21.6,1623,7,7,5,0,0,0,0,16234,7,17475,177,63,4,139,17.7,1623.4,red,1.86,1.71,24,17,red
4498239413,4,7,3,1,1,0,0,16028,7.4,19000,249,56,-2863,-875,24.9,1602.8,7,4,6,0,0,0,0,18891,7.4,19875,242,52,2863,875,24.2,1889.1,red,1,3.25,17,16,red
4469941685,4,4,2,0,0,0,0,15731,7.2,18954,250,47,-85,-632,25,1573.1,4,4,3,0,0,0,0,15816,7.2,19586,229,75,85,632,22.9,1581.6,blue,1.5,1.75,19,43,blue
4484202806,4,10,1,0,0,0,0,14816,6.6,16519,218,46,-4490,-3582,21.8,1481.6,10,4,6,2,1,1,1,19306,7.4,20101,247,56,4490,3582,24.7,1930.6,red,0.5,4,15,15,red
4521383938,4,6,2,1,0,1,0,15862,7.2,19244,229,60,-988,470,22.9,1586.2,6,4,6,1,1,0,0,16850,7,18774,232,56,988,-470,23.2,1685,blue,1,3,39,19,red
4488307772,1,4,1,2,1,1,0,14140,6.6,17249,241,48,-1481,-1506,24.1,1414,4,1,5,0,0,0,0,15621,7,18755,228,52,1481,1506,22.8,1562.1,blue,0.5,9,16,58,red
4486155288,6,4,7,2,1,1,0,16699,7,18503,242,55,1109,718,24.2,1669.9,4,6,6,0,0,0,0,15590,6.8,17785,237,41,-1109,-718,23.7,1559,blue,3.25,1.67,89,24,red
4518987840,2,9,1,0,0,0,0,13405,6.4,15189,182,43,-5392,-2904,18.2,1340.5,9,2,19,1,1,0,0,18797,6.8,18093,231,54,5392,2904,23.1,1879.7,red,0.33,14,17,21,red
4455452551,8,10,5,0,0,0,0,17538,7,18073,224,41,238,840,22.4,1753.8,10,8,10,1,1,0,0,17300,6.8,17233,191,46,-238,-840,19.1,1730,blue,1.3,2.5,29,20,red
4448427323,15,3,5,0,0,0,0,19038,7.2,19801,261,32,4941,4702,26.1,1903.8,3,15,5,0,0,0,0,14097,6.2,15099,190,48,-4941,-4702,19,1409.7,red,6.67,0.53,15,19,blue
4491653265,9,12,10,0,0,0,0,18082,7.2,18637,209,54,24,235,20.9,1808.2,12,9,11,2,1,1,0,18058,7,18402,200,44,-24,-235,20,1805.8,red,1.58,2.56,36,56,red
4509495092,1,5,0,1,1,0,0,14004,6.4,16302,217,39,-1113,-1381,21.7,1400.4,5,1,5,0,0,0,0,15117,7,17683,212,32,1113,1381,21.2,1511.7,red,0.2,10,18,12,red
4477722271,4,4,5,0,0,0,0,16349,7.2,18699,253,62,754,13,25.3,1634.9,4,4,3,1,1,0,0,15595,7.2,18686,243,55,-754,-13,24.3,1559.5,blue,2.25,1.75,36,16,red
4479540109,2,7,1,0,0,0,0,15373,7.2,18734,252,68,-1942,140,25.2,1537.3,7,2,10,2,1,1,0,17315,7.2,18594,226,52,1942,-140,22.6,1731.5,red,0.43,8.5,17,82,red
4463166329,7,7,7,2,1,1,0,16559,7.2,18848,235,43,-167,39,23.5,1655.9,7,7,5,0,0,0,0,16726,7,18809,237,48,167,-39,23.7,1672.6,blue,2,1.71,18,16,blue
4487524071,5,2,6,1,1,0,0,16513,6.8,18070,203,48,3537,2976,20.3,1651.3,2,5,2,0,0,0,0,12976,6.4,15094,186,36,-3537,-2976,18.6,1297.6,blue,5.5,0.8,18,19,blue
4511068350,10,3,10,1,0,1,0,19886,7.4,20060,240,67,5349,3639,24,1988.6,3,10,5,0,0,0,0,14537,6.6,16421,189,44,-5349,-3639,18.9,1453.7,blue,6.67,0.8,37,16,blue
4524387920,6,2,4,2,1,1,0,17167,7,19248,247,67,2793,2280,24.7,1716.7,2,6,0,0,0,0,0,14374,6.6,16968,225,52,-2793,-2280,22.5,1437.4,blue,5,0.33,18,22,blue
4452219290,5,1,9,1,1,0,0,16809,7.2,18916,241,55,2192,464,24.1,1680.9,1,5,1,0,0,0,0,14617,6.8,18452,246,59,-2192,-464,24.6,1461.7,blue,14,0.4,58,20,blue
4524524540,10,13,12,0,0,0,0,18178,6.8,17540,200,35,-286,-494,20,1817.8,13,10,12,1,1,0,0,18464,6.8,18034,171,40,286,494,17.1,1846.4,red,1.69,2.5,18,21,red
4524619949,3,10,4,0,0,0,0,14742,6.6,15941,215,52,-3540,-3279,21.5,1474.2,10,3,13,1,1,0,0,18282,7.2,19220,227,44,3540,3279,22.7,1828.2,red,0.7,7.67,17,21,red
4519347430,4,5,4,0,0,0,0,15126,6.8,17342,207,38,-568,-345,20.7,1512.6,5,4,2,0,0,0,0,15694,6.8,17687,231,53,568,345,23.1,1569.4,blue,1.6,1.75,16,15,red
4514643182,5,9,7,0,0,0,0,15449,6.6,16663,195,56,-2975,-2542,19.5,1544.9,9,5,15,1,1,0,0,18424,7.2,19205,258,48,2975,2542,25.8,1842.4,red,1.33,4.8,14,20,red
4518236753,4,12,7,0,0,0,0,15233,6.6,16168,208,39,-3184,-2345,20.8,1523.3,12,4,14,0,0,0,0,18417,7,18513,218,44,3184,2345,21.8,1841.7,red,0.92,6.5,19,16,blue
4485967051,2,6,3,0,0,0,0,14602,6.8,17042,208,54,-2185,-2480,20.8,1460.2,6,2,4,1,1,0,0,16787,7.2,19522,232,76,2185,2480,23.2,1678.7,red,0.83,5,18,15,red
4520613300,3,4,5,0,0,0,0,15390,7,18666,245,51,-387,879,24.5,1539,4,3,8,0,0,0,0,15777,7,17787,239,55,387,-879,23.9,1577.7,blue,2,4,29,22,red
4458509653,5,5,9,0,0,0,0,16766,7,18538,231,47,1543,828,23.1,1676.6,5,5,2,1,1,0,0,15223,6.8,17710,208,52,-1543,-828,20.8,1522.3,blue,2.8,1.4,25,24,blue
4522886351,6,10,6,0,0,0,0,16093,6.4,16579,181,34,-1908,-1654,18.1,1609.3,10,6,9,1,0,1,0,18001,7,18233,220,60,1908,1654,22,1800.1,blue,1.2,3.17,21,15,red
4502492792,3,4,3,1,1,0,0,15575,6.6,16473,220,48,737,-691,22,1557.5,4,3,4,0,0,0,0,14838,6.6,17164,201,43,-737,691,20.1,1483.8,blue,1.5,2.67,21,22,blue
4423262467,7,5,12,0,0,0,0,16953,6.8,17147,199,65,1073,-541,19.9,1695.3,5,7,7,1,1,0,0,15880,7,17688,210,64,-1073,541,21,1588,blue,3.8,1.71,17,17,blue
4474674368,6,5,7,1,1,0,0,15529,7,17721,204,39,-413,-1004,20.4,1552.9,5,6,2,1,0,1,0,15942,7,18725,237,48,413,1004,23.7,1594.2,red,2.6,1.17,21,16,red
4462298411,6,2,7,1,0,1,0,16836,7.2,19773,242,60,2569,2378,24.2,1683.6,2,6,1,1,1,0,0,14267,6.8,17395,228,45,-2569,-2378,22.8,1426.7,blue,6.5,0.5,27,45,blue
4513293772,3,9,2,0,0,0,0,13820,5.8,13497,158,45,-3996,-2986,15.8,1382,9,3,14,1,1,0,0,17816,6.6,16483,190,48,3996,2986,19,1781.6,red,0.56,7.67,17,91,blue
4520671984,12,6,25,1,1,0,0,19321,7,18437,226,42,2574,359,22.6,1932.1,6,12,9,0,0,0,0,16747,7,18078,228,56,-2574,-359,22.8,1674.7,blue,6.17,1.25,22,17,blue
4492730038,3,5,6,0,0,0,0,15834,6.8,18088,228,56,-191,-182,22.8,1583.4,5,3,6,1,1,0,0,16025,7.2,18270,208,52,191,182,20.8,1602.5,red,1.8,3.67,23,150,blue
4524773384,7,7,10,1,1,0,0,16585,6.8,16982,191,42,-536,-864,19.1,1658.5,7,7,9,0,0,0,0,17121,6.8,17846,234,52,536,864,23.4,1712.1,blue,2.43,2.29,18,18,red
4515341076,5,8,6,1,1,0,0,15483,6.8,16690,174,54,-1429,-683,17.4,1548.3,8,5,10,0,0,0,0,16912,6.8,17373,225,40,1429,683,22.5,1691.2,red,1.38,3.6,20,28,red
4521293545,6,2,5,1,0,1,0,17834,7.2,19145,276,44,3797,2242,27.6,1783.4,2,6,3,1,1,0,0,14037,6.8,16903,202,48,-3797,-2242,20.2,1403.7,blue,5.5,0.83,18,11,blue
4459704027,5,2,7,1,1,0,0,16858,7.2,18543,251,39,2407,939,25.1,1685.8,2,5,3,0,0,0,0,14451,6.6,17604,221,44,-2407,-939,22.1,1445.1,blue,6,1,37,44,blue
4521182941,17,9,19,0,0,0,0,20619,7.4,18696,205,43,2828,1962,20.5,2061.9,9,17,7,1,1,0,0,17791,6.8,16734,198,38,-2828,-1962,19.8,1779.1,blue,4,0.94,19,19,red
4454235667,9,5,9,1,1,0,0,18449,7.2,19139,257,45,2334,1246,25.7,1844.9,5,9,6,0,0,0,0,16115,6.8,17893,231,48,-2334,-1246,23.1,1611.5,blue,3.6,1.22,22,65,red
4459609583,7,3,9,0,0,0,0,17354,7.4,20449,224,63,2301,3412,22.4,1735.4,3,7,4,0,0,0,0,15053,6.6,17037,240,44,-2301,-3412,24,1505.3,blue,5.33,1,22,12,red
4516238123,7,6,8,0,0,0,0,16097,6.6,16760,214,42,853,363,21.4,1609.7,6,7,4,1,1,0,0,15244,6.4,16397,182,46,-853,-363,18.2,1524.4,red,2.5,1.43,16,17,blue
4520047610,6,6,7,0,0,0,0,16138,6.8,17204,211,31,-243,418,21.1,1613.8,6,6,13,1,0,1,0,16381,6.6,16786,188,52,243,-418,18.8,1638.1,blue,2.17,3.17,18,14,red
4520390476,8,2,11,1,1,0,0,17794,7,17983,220,56,4793,3669,22,1779.4,2,8,2,0,0,0,0,13001,5.8,14314,217,12,-4793,-3669,21.7,1300.1,blue,9.5,0.5,14,12,blue
4487249336,11,6,15,1,1,0,0,19218,7,19389,197,56,3248,2147,19.7,1921.8,6,11,4,0,0,0,0,15970,6.8,17242,205,48,-3248,-2147,20.5,1597,blue,4.33,0.91,38,18,blue
4482519172,10,4,15,1,1,0,0,18501,7.6,19714,230,64,2907,2700,23,1850.1,4,10,6,0,0,0,0,15594,7,17014,215,55,-2907,-2700,21.5,1559.4,blue,6.25,1,56,12,red
4498278588,4,6,0,0,0,0,0,15922,7.2,19022,248,64,-1454,-616,24.8,1592.2,6,4,8,0,0,0,0,17376,7.2,19638,207,68,1454,616,20.7,1737.6,red,0.67,3.5,13,39,red
4518118181,6,7,7,0,0,0,0,16119,6.6,16372,203,51,292,-206,20.3,1611.9,7,6,6,1,1,0,0,15827,6.6,16578,206,36,-292,206,20.6,1582.7,blue,1.86,2.17,14,26,blue
4497870757,3,11,4,1,1,0,0,14625,6.6,16487,200,48,-2978,-2960,20,1462.5,11,3,12,0,0,0,0,17603,7.4,19447,190,44,2978,2960,19,1760.3,red,0.64,7.67,19,22,blue
4449694269,7,8,6,1,1,0,0,16685,6.8,17591,193,40,-335,-681,19.3,1668.5,8,7,7,1,0,1,0,17020,6.8,18272,228,47,335,681,22.8,1702,red,1.62,2.14,27,33,red
4500726742,2,8,1,1,0,1,0,13895,6.6,16914,210,44,-2894,-1742,21,1389.5,8,2,9,1,1,0,0,16789,7,18656,208,55,2894,1742,20.8,1678.9,red,0.38,8.5,20,19,red
4505754774,14,6,22,0,0,0,0,19890,6.8,17275,174,46,4401,2185,17.4,1989,6,14,6,1,1,0,0,15489,6.2,15090,204,36,-4401,-2185,20.4,1548.9,blue,6,0.86,34,18,red
4490249135,6,10,5,0,0,0,0,15164,6.4,16581,190,41,-4055,-2248,19,1516.4,10,6,10,1,0,1,0,19219,7.2,18829,236,58,4055,2248,23.6,1921.9,red,1.1,3.33,18,33,blue
4449918896,10,4,7,0,0,0,0,17498,7.4,19402,224,45,2084,2869,22.4,1749.8,4,10,4,0,0,0,0,15414,6.4,16533,228,36,-2084,-2869,22.8,1541.4,red,4.25,0.8,15,12,blue
4521299727,13,5,16,0,0,0,0,19452,7.6,20776,212,59,2593,3690,21.2,1945.2,5,13,7,2,1,1,0,16859,6.8,17086,213,64,-2593,-3690,21.3,1685.9,blue,5.8,0.92,38,17,blue
4513005798,9,5,7,1,1,0,0,17322,7,18525,255,44,1372,2320,25.5,1732.2,5,9,6,0,0,0,0,15950,6.6,16205,213,52,-1372,-2320,21.3,1595,red,3.2,1.22,13,14,red
4518366913,8,3,6,1,1,0,0,17243,6.8,18171,231,52,2803,1638,23.1,1724.3,3,8,5,0,0,0,0,14440,6.6,16533,186,57,-2803,-1638,18.6,1444,blue,4.67,1,20,21,blue
4491183408,8,10,8,1,0,1,0,18020,7.2,19285,214,63,-533,944,21.4,1802,10,8,14,0,0,0,0,18553,7,18341,198,52,533,-944,19.8,1855.3,red,1.6,3,17,87,red
4522622334,6,7,8,2,1,1,0,16289,6.8,17723,208,56,-963,-64,20.8,1628.9,7,6,11,0,0,0,0,17252,7,17787,230,56,963,64,23,1725.2,red,2,3,57,20,red
4469829210,9,4,10,2,1,1,0,18303,7.2,19140,263,58,2642,366,26.3,1830.3,4,9,2,0,0,0,0,15661,7,18774,231,49,-2642,-366,23.1,1566.1,blue,4.75,0.67,35,16,blue
4515668714,4,10,6,0,0,0,0,15728,6.8,16927,212,56,-1615,-1585,21.2,1572.8,10,4,12,0,0,0,0,17343,7,18512,205,44,1615,1585,20.5,1734.3,red,1,5.5,18,37,blue
4521129958,6,3,5,0,0,0,0,16097,7,18426,226,51,1212,1738,22.6,1609.7,3,6,1,2,1,1,0,14885,6.6,16688,216,50,-1212,-1738,21.6,1488.5,blue,3.67,0.67,16,16,blue
4515298489,2,5,4,2,1,1,0,14414,6.4,16249,215,64,-2363,-2144,21.5,1441.4,5,2,10,0,0,0,0,16777,7.2,18393,233,64,2363,2144,23.3,1677.7,red,1.2,7.5,19,15,red
4517512393,9,8,5,1,1,0,0,15852,6.8,17330,194,35,-1918,-1739,19.4,1585.2,8,9,10,1,0,1,0,17770,7.2,19069,213,66,1918,1739,21.3,1777,blue,1.75,2,18,19,blue
4522390017,4,3,4,0,0,0,0,15202,6.8,17438,215,53,145,-729,21.5,1520.2,3,4,2,1,0,1,0,15057,6.8,18167,247,60,-145,729,24.7,1505.7,blue,2.67,1.25,21,51,blue
4513729345,2,3,1,0,0,0,0,15572,7.2,19166,242,83,902,860,24.2,1557.2,3,2,4,1,1,0,0,14670,6.8,18306,231,47,-902,-860,23.1,1467,blue,1,3.5,20,17,blue
4520954808,8,8,6,0,0,0,0,16488,7,17386,208,41,-870,-1120,20.8,1648.8,8,8,7,1,1,0,0,17358,7.2,18506,241,48,870,1120,24.1,1735.8,red,1.75,1.88,14,15,blue
4464340157,5,12,11,1,1,0,0,14353,6.2,15067,168,48,-4550,-3483,16.8,1435.3,12,5,19,0,0,0,0,18903,7.2,18550,216,39,4550,3483,21.6,1890.3,red,1.33,6.2,13,12,red
4514527472,13,3,11,1,0,1,0,19133,7.4,20110,223,40,4238,3475,22.3,1913.3,3,13,2,1,1,0,0,14895,6.6,16635,168,80,-4238,-3475,16.8,1489.5,blue,8,0.38,18,14,red
4520734931,3,5,4,0,0,0,0,15314,7,18205,233,52,-1659,-1566,23.3,1531.4,5,3,5,0,0,0,0,16973,7.4,19771,253,60,1659,1566,25.3,1697.3,red,1.4,3.33,46,23,red
4447699269,10,6,18,0,0,0,0,17690,7.2,18278,192,45,1377,2429,19.2,1769,6,10,5,0,0,0,0,16313,6.6,15849,194,42,-1377,-2429,19.4,1631.3,red,4.67,1.1,42,17,red
4520645604,10,6,15,2,1,1,1,20183,7.6,20663,216,73,3663,2748,21.6,2018.3,6,10,6,0,0,0,0,16520,6.8,17915,192,47,-3663,-2748,19.2,1652,blue,4.17,1.2,156,15,blue
4511159553,9,5,9,1,0,1,0,18408,7.2,19614,225,56,2969,2575,22.5,1840.8,5,9,3,0,0,0,0,15439,6.6,17039,210,60,-2969,-2575,21,1543.9,blue,3.6,0.89,20,18,blue
4468173353,6,12,6,0,0,0,0,15595,6.4,15756,159,48,-3682,-4566,15.9,1559.5,12,6,13,0,0,0,0,19277,7.6,20322,240,54,3682,4566,24,1927.7,red,1,4.17,14,18,red
4489481429,8,9,9,0,0,0,0,17119,7,18174,209,36,-1362,-863,20.9,1711.9,9,8,9,0,0,0,0,18481,7.4,19037,235,55,1362,863,23.5,1848.1,blue,1.89,2.25,16,16,blue
4464085930,9,9,9,0,0,0,0,17658,7,17546,214,47,108,-88,21.4,1765.8,9,9,8,1,0,1,0,17550,7,17634,235,36,-108,88,23.5,1755,red,2,1.89,30,18,blue
4503626292,14,4,14,0,0,0,0,19600,7.4,20132,218,56,5344,3506,21.8,1960,4,14,1,0,0,0,0,14256,6.8,16626,194,47,-5344,-3506,19.4,1425.6,blue,7,0.36,16,13,blue
4450431370,7,14,8,0,0,0,0,16336,6.8,16919,190,40,-3908,-2704,19,1633.6,14,7,17,1,1,0,0,20244,7.2,19623,208,66,3908,2704,20.8,2024.4,red,1.07,4.43,15,19,red
4525060117,7,2,5,1,1,0,0,16860,6.8,18168,226,49,2984,1565,22.6,1686,2,7,1,0,0,0,0,13876,6.6,16603,216,40,-2984,-1565,21.6,1387.6,blue,6,0.43,21,25,blue
4524609422,3,4,2,2,1,1,0,14501,6.6,16819,201,46,-250,489,20.1,1450.1,4,3,6,0,0,0,0,14751,6.4,16330,212,39,250,-489,21.2,1475.1,blue,1.25,3.33,19,19,blue
4468568554,7,7,8,0,0,0,0,17148,7,17427,226,52,1084,658,22.6,1714.8,7,7,8,2,1,1,0,16064,6.4,16769,207,40,-1084,-658,20.7,1606.4,red,2.14,2.14,15,18,red
4520833786,10,6,10,0,0,0,0,18559,7,18239,223,61,2606,964,22.3,1855.9,6,10,6,1,1,0,0,15953,6.8,17275,203,60,-2606,-964,20.3,1595.3,blue,3.33,1.2,18,16,blue
4523634047,3,5,4,1,0,1,1,16250,6.6,16288,215,48,154,-979,21.5,1625,5,3,11,1,1,0,0,16096,6.8,17267,230,51,-154,979,23,1609.6,red,1.4,5.33,14,14,red
4523122447,4,3,3,1,1,0,0,15791,7,17326,224,56,960,-812,22.4,1579.1,3,4,5,0,0,0,0,14831,7,18138,223,49,-960,812,22.3,1483.1,blue,2.33,2,20,20,blue
4483634862,5,12,5,0,0,0,0,15634,6.6,16435,222,40,-3194,-2675,22.2,1563.4,12,5,13,1,0,1,0,18828,7.2,19110,205,52,3194,2675,20.5,1882.8,red,0.83,5,15,52,red
4517860054,3,2,3,0,0,0,0,15148,6.6,16687,215,48,-44,-1601,21.5,1514.8,2,3,1,0,0,0,0,15192,7,18288,246,51,44,1601,24.6,1519.2,blue,3,1,18,24,blue
4464319633,10,8,14,2,1,1,0,17893,7,17157,206,56,1181,-934,20.6,1789.3,8,10,6,0,0,0,0,16712,7,18091,182,47,-1181,934,18.2,1671.2,blue,3,1.4,15,15,blue
4505648249,7,8,12,1,1,0,0,16200,6.6,17810,202,42,-927,-736,20.2,1620,8,7,11,1,0,1,0,17127,7.2,18546,207,57,927,736,20.7,1712.7,blue,2.38,2.71,14,16,blue
4522858842,2,7,0,0,0,0,0,13371,6.4,15621,224,0,-3170,-2591,22.4,1337.1,7,2,6,1,1,0,0,16541,6.8,18212,226,40,3170,2591,22.6,1654.1,red,0.29,6.5,11,13,red
4502931082,6,7,5,0,0,0,0,15903,7,18823,205,53,-623,1024,20.5,1590.3,7,6,5,1,1,0,0,16526,7,17799,205,48,623,-1024,20.5,1652.6,red,1.57,2,14,15,red
4510837678,5,6,6,0,0,0,0,15719,6.8,17801,202,39,-1121,4,20.2,1571.9,6,5,5,0,0,0,0,16840,7,17797,236,48,1121,-4,23.6,1684,blue,1.83,2.2,82,20,red
4495147066,2,9,2,0,0,0,0,13267,6.2,14831,185,40,-5292,-4922,18.5,1326.7,9,2,12,1,1,0,0,18559,7.2,19753,237,64,5292,4922,23.7,1855.9,red,0.44,10.5,14,17,red
4524109040,4,1,4,2,1,1,0,16305,7.2,19758,253,64,1793,929,25.3,1630.5,1,4,1,0,0,0,0,14512,7.2,18829,204,76,-1793,-929,20.4,1451.2,blue,8,0.5,17,17,blue
4482075284,8,2,8,0,0,0,0,18269,7.6,20290,258,49,3389,3465,25.8,1826.9,2,8,1,0,0,0,0,14880,6.4,16825,239,50,-3389,-3465,23.9,1488,blue,8,0.38,15,18,blue
4524584974,4,11,3,0,0,0,0,14956,6.4,16656,216,49,-3532,-2062,21.6,1495.6,11,4,11,0,0,0,0,18488,7.2,18718,217,56,3532,2062,21.7,1848.8,red,0.64,5.5,17,19,red
4525152197,3,7,3,1,0,1,1,16180,6.8,17570,229,45,-981,264,22.9,1618,7,3,11,1,1,0,0,17161,6.8,17306,230,48,981,-264,23,1716.1,blue,0.86,6,16,13,red
4524926639,8,6,12,0,0,0,0,16808,6.8,16741,200,44,616,-87,20,1680.8,6,8,8,0,0,0,0,16192,6.6,16828,198,48,-616,87,19.8,1619.2,red,3.33,1.75,19,20,blue
4522027915,10,5,7,1,0,1,0,17971,7.2,19214,231,44,3146,1518,23.1,1797.1,5,10,2,1,1,0,0,14825,7,17696,181,47,-3146,-1518,18.1,1482.5,red,3.4,0.7,21,15,blue
4524157575,6,2,6,2,1,1,0,16998,7.2,18708,236,56,2619,1209,23.6,1699.8,2,6,2,0,0,0,0,14379,7,17499,217,52,-2619,-1209,21.7,1437.9,blue,6,0.67,16,14,blue
4517748095,5,14,6,2,1,1,0,15015,6.6,16032,167,54,-5065,-3552,16.7,1501.5,14,5,9,0,0,0,0,20080,7.4,19584,224,52,5065,3552,22.4,2008,red,0.79,4.6,15,17,red
4521386660,4,4,1,0,0,0,0,14881,7,18074,209,45,-856,-563,20.9,1488.1,4,4,1,0,0,0,0,15737,7,18637,236,55,856,563,23.6,1573.7,blue,1.25,1.25,16,167,blue
4462148925,4,3,10,1,1,0,0,15730,7,18484,241,52,739,-270,24.1,1573,3,4,5,0,0,0,0,14991,7,18754,239,59,-739,270,23.9,1499.1,blue,4.67,2,19,18,blue
4497724425,16,5,14,1,1,0,0,19098,7,18636,203,37,2447,247,20.3,1909.8,5,16,3,0,0,0,0,16651,7,18389,207,63,-2447,-247,20.7,1665.1,blue,6,0.5,16,11,blue
4523546666,5,3,6,0,0,0,0,16169,7.2,18880,235,60,561,740,23.5,1616.9,3,5,3,0,0,0,0,15608,7,18140,235,59,-561,-740,23.5,1560.8,blue,3.67,1.2,17,14,red
4495258112,9,10,6,1,1,0,0,16954,6.8,16923,197,49,-1073,210,19.7,1695.4,10,9,16,0,0,0,0,18027,6.6,16713,176,51,1073,-210,17.6,1802.7,red,1.5,2.89,19,22,red
4520518919,5,4,5,0,0,0,0,15984,7.2,17527,203,54,193,89,20.3,1598.4,4,5,4,0,0,0,0,15791,6.8,17438,222,50,-193,-89,22.2,1579.1,red,2.5,1.6,19,18,red
4503545828,8,7,8,0,0,0,0,18078,7,18614,261,48,1204,306,26.1,1807.8,7,8,7,1,1,0,0,16874,6.8,18308,204,52,-1204,-306,20.4,1687.4,blue,2.29,1.75,55,39,blue
4523347600,9,5,9,1,1,0,0,16329,6.4,16575,206,36,948,16,20.6,1632.9,5,9,4,0,0,0,0,15381,6.8,16559,173,52,-948,-16,17.3,1538.1,blue,3.6,1,15,18,blue
4496613517,9,10,5,0,0,0,0,17193,7,18326,224,40,-1027,-1434,22.4,1719.3,10,9,6,0,0,0,0,18220,7.6,19760,236,56,1027,1434,23.6,1822,red,1.4,1.78,21,18,blue
4513948107,11,6,13,1,1,0,0,18401,7,18465,201,51,1843,1402,20.1,1840.1,6,11,8,0,0,0,0,16558,6.8,17063,212,36,-1843,-1402,21.2,1655.8,blue,4,1.27,23,19,blue
4467944823,2,10,0,0,0,0,0,14704,7,17930,227,60,-3517,-1818,22.7,1470.4,10,2,7,1,1,0,0,18221,7.6,19748,235,56,3517,1818,23.5,1822.1,red,0.2,8.5,20,12,blue
4497717401,5,8,3,0,0,0,0,16367,7.2,18191,254,48,-1204,-717,25.4,1636.7,8,5,8,1,1,0,0,17571,7,18908,218,56,1204,717,21.8,1757.1,red,1,3.2,15,45,red
4509036476,0,5,0,0,0,0,0,12905,6.2,15457,195,44,-3927,-3257,19.5,1290.5,5,0,5,0,0,0,0,16832,7,18714,211,78,3927,3257,21.1,1683.2,red,0,12.65,13,20,red
4524695455,3,7,0,0,0,0,0,13967,7,16908,197,48,-2681,-834,19.7,1396.7,7,3,6,1,1,0,0,16648,6.6,17742,193,61,2681,834,19.3,1664.8,red,0.43,4.33,40,17,red
4514151915,8,6,9,1,1,0,0,16511,7,18106,199,48,300,1722,19.9,1651.1,6,8,7,0,0,0,0,16211,6.6,16384,225,44,-300,-1722,22.5,1621.1,red,2.83,1.62,18,17,red
4516562361,8,7,8,0,0,0,0,17496,7.4,19884,232,35,4,1213,23.2,1749.6,7,8,8,0,0,0,0,17492,7.2,18671,259,56,-4,-1213,25.9,1749.2,red,2.29,1.88,18,17,red
4468712896,7,6,6,1,1,0,0,17743,7.4,19173,255,52,1572,829,25.5,1774.3,6,7,4,0,0,0,0,16171,7,18344,218,47,-1572,-829,21.8,1617.1,blue,2.17,1.43,28,19,blue
4523887906,8,6,8,1,1,0,0,16888,7,18788,202,56,856,1638,20.2,1688.8,6,8,5,1,0,1,0,16032,6.6,17150,198,52,-856,-1638,19.8,1603.2,blue,2.67,1.38,15,45,red
4522419408,2,2,0,1,0,1,0,13742,6.8,17269,208,52,-2296,-1213,20.8,1374.2,2,2,1,1,1,0,0,16038,6.8,18482,250,52,2296,1213,25,1603.8,red,1,1.5,20,17,red
4488609653,9,15,10,0,0,0,0,17793,7,18271,187,58,-1961,-392,18.7,1779.3,15,9,19,1,1,0,0,19754,7,18663,173,36,1961,392,17.3,1975.4,red,1.27,3.78,21,22,red
4523824469,5,8,6,0,0,0,0,16178,6.8,17363,221,48,-1320,-687,22.1,1617.8,8,5,10,1,0,1,0,17498,7.2,18050,185,52,1320,687,18.5,1749.8,red,1.38,3.6,47,56,blue
4458383359,8,8,8,1,1,0,0,17706,6.8,18217,217,60,-492,-173,21.7,1770.6,8,8,11,0,0,0,0,18198,7.2,18390,230,52,492,173,23,1819.8,blue,2,2.38,18,16,red
4515399183,6,9,5,2,1,1,0,16149,6.8,16641,199,52,34,-957,19.9,1614.9,9,6,9,0,0,0,0,16115,6.8,17598,184,28,-34,957,18.4,1611.5,blue,1.22,3,17,37,blue
4494820088,3,8,2,0,0,0,0,14760,6.4,16005,183,53,-1964,-3710,18.3,1476,8,3,6,1,1,0,0,16724,7.4,19715,200,74,1964,3710,20,1672.4,red,0.62,4.67,13,21,blue
4419100258,3,5,3,0,0,0,0,15820,6.8,17793,220,55,-306,-282,22,1582,5,3,8,2,1,1,0,16126,7,18075,222,52,306,282,22.2,1612.6,red,1.2,4.33,16,21,red
4519853578,5,9,3,1,0,1,0,15173,7,17165,183,59,-2354,-1337,18.3,1517.3,9,5,7,1,1,0,0,17527,7,18502,210,46,2354,1337,21,1752.7,red,0.89,3.2,14,19,red
4492130975,4,3,5,0,0,0,0,14769,6.8,17725,215,36,-1071,-843,21.5,1476.9,3,4,2,0,0,0,0,15840,7,18568,242,51,1071,843,24.2,1584,red,3,1.25,18,12,red
4509170584,4,3,6,0,0,0,0,14353,6.8,17197,178,48,-1009,-280,17.8,1435.3,3,4,1,1,1,0,0,15362,6.8,17477,222,62,1009,280,22.2,1536.2,red,3.33,1,21,21,red
4487686105,8,4,11,0,0,0,0,16763,7,17757,216,34,147,-712,21.6,1676.3,4,8,8,0,0,0,0,16616,7,18469,240,64,-147,712,24,1661.6,blue,4.75,1.5,16,16,blue
4433310925,5,2,5,0,0,0,0,16747,7.2,19858,250,64,2126,1070,25,1674.7,2,5,1,0,0,0,0,14621,7,18788,227,60,-2126,-1070,22.7,1462.1,blue,5,0.6,17,12,blue
4521010137,8,5,7,0,0,0,0,17044,6.8,17686,217,46,845,-234,21.7,1704.4,5,8,5,1,1,0,0,16199,6.8,17920,207,60,-845,234,20.7,1619.9,red,3,1.25,20,15,blue
4525088163,6,7,8,0,0,0,0,15532,6.8,17908,190,48,-1779,-354,19,1553.2,7,6,4,0,0,0,0,17311,7,18262,242,48,1779,354,24.2,1731.1,red,2,1.83,16,17,red
4511374041,7,12,6,2,1,1,0,17347,6.6,18118,222,63,-1305,-1101,22.2,1734.7,12,7,15,0,0,0,0,18652,7.4,19219,218,44,1305,1101,21.8,1865.2,red,1.08,3.86,18,20,red
4481135148,9,6,8,1,0,1,1,18758,7.2,18617,228,44,2137,490,22.8,1875.8,6,9,6,0,0,0,0,16621,6.8,18127,234,52,-2137,-490,23.4,1662.1,blue,2.83,1.33,20,18,blue
4473770063,13,8,13,1,0,1,0,20711,7.6,20463,220,68,3673,1956,22,2071.1,8,13,4,1,1,0,0,17038,7,18507,209,44,-3673,-1956,20.9,1703.8,blue,3.25,0.92,18,17,red
4516824896,8,4,9,0,0,0,0,16539,7,17585,205,46,1947,1396,20.5,1653.9,4,8,3,0,0,0,0,14592,6.6,16189,196,43,-1947,-1396,19.6,1459.2,blue,4.25,0.88,24,40,red
4524811313,11,9,13,1,0,1,0,19096,7.2,19250,206,55,895,910,20.6,1909.6,9,11,9,0,0,0,0,18201,7,18340,235,49,-895,-910,23.5,1820.1,blue,2.67,1.64,22,20,blue
4524847047,11,4,14,2,1,1,0,17938,6.6,16164,199,48,3413,396,19.9,1793.8,4,11,3,0,0,0,0,14525,6.6,15768,195,34,-3413,-396,19.5,1452.5,blue,6.25,0.64,25,13,blue
4513553506,8,11,8,0,0,0,0,17072,6.8,17724,180,63,-2298,-730,18,1707.2,11,8,5,2,1,1,1,19370,7,18454,242,48,2298,730,24.2,1937,blue,1.45,2,40,15,blue
4516387872,12,4,18,1,1,0,0,19640,7,18636,216,52,5151,3496,21.6,1964,4,12,5,0,0,0,0,14489,6,15140,175,36,-5151,-3496,17.5,1448.9,blue,7.5,0.75,21,11,blue
4522005554,7,5,6,1,1,0,0,16891,7,18224,214,65,-51,373,21.4,1689.1,5,7,8,1,0,1,0,16942,6.8,17851,218,48,51,-373,21.8,1694.2,blue,2.6,1.86,16,40,blue
4503361762,9,3,6,1,1,0,0,17485,7,18330,234,58,3075,1798,23.4,1748.5,3,9,2,0,0,0,0,14410,6.6,16532,214,27,-3075,-1798,21.4,1441,blue,5,0.56,19,19,blue
4522608036,7,2,5,0,0,0,0,16696,7.2,18900,225,68,1945,2614,22.5,1669.6,2,7,3,0,0,0,0,14751,6.4,16286,196,52,-1945,-2614,19.6,1475.1,red,6,0.71,26,21,red
4513537755,8,3,4,1,1,0,0,17499,7.2,19191,231,44,2644,2337,23.1,1749.9,3,8,2,0,0,0,0,14855,6.6,16854,208,39,-2644,-2337,20.8,1485.5,blue,4,0.62,14,20,blue
4504128321,10,6,9,0,0,0,0,18288,7.2,19569,245,41,2569,1891,24.5,1828.8,6,10,4,1,0,1,0,15719,6.8,17678,220,41,-2569,-1891,22,1571.9,blue,3.17,1,18,131,blue
4489090931,5,6,7,0,0,0,0,15684,6.8,17384,170,56,-1434,-1409,17,1568.4,6,5,3,1,0,1,0,17118,7.2,18793,223,52,1434,1409,22.3,1711.8,red,2,1.8,18,21,blue
4523720139,1,1,0,1,0,1,0,14737,7,18532,229,59,92,728,22.9,1473.7,1,1,0,0,0,0,0,14645,6.8,17804,199,59,-92,-728,19.9,1464.5,red,1,1,15,13,blue
4450091892,11,9,13,1,1,0,0,18715,7,18626,223,52,1326,351,22.3,1871.5,9,11,9,0,0,0,0,17389,7.2,18275,208,50,-1326,-351,20.8,1738.9,red,2.67,1.64,21,16,blue
4524739692,7,6,9,1,1,0,1,18551,7.2,18363,225,61,1850,834,22.5,1855.1,6,7,7,0,0,0,0,16701,7,17529,210,57,-1850,-834,21,1670.1,blue,2.67,1.86,18,19,red
4480057032,12,4,16,1,1,0,0,19351,7.4,20590,220,40,3969,3522,22,1935.1,4,12,4,0,0,0,0,15382,6.6,17068,221,48,-3969,-3522,22.1,1538.2,blue,7,0.67,21,16,blue
4509298842,8,8,12,0,0,0,0,17318,6.6,16336,175,56,-266,-1524,17.5,1731.8,8,8,9,1,1,0,0,17584,6.8,17860,217,51,266,1524,21.7,1758.4,red,2.5,2.12,20,47,red
4452485048,10,4,11,1,1,0,0,18969,7.6,20353,205,63,4139,3424,20.5,1896.9,4,10,2,0,0,0,0,14830,6.8,16929,172,61,-4139,-3424,17.2,1483,blue,5.25,0.6,16,18,blue
4461048637,8,1,14,1,1,0,0,17113,7,18837,203,52,3278,2617,20.3,1711.3,1,8,0,0,0,0,0,13835,6.6,16220,194,56,-3278,-2617,19.4,1383.5,blue,22,0.12,15,15,blue
4523306081,8,12,11,0,0,0,0,17201,7.2,18755,207,30,-1817,-354,20.7,1720.1,12,8,13,1,1,0,0,19018,7.4,19109,201,46,1817,354,20.1,1901.8,red,1.58,3.12,18,58,red
4521897188,8,5,4,0,0,0,0,16749,6.8,17788,217,43,1152,400,21.7,1674.9,5,8,7,1,1,0,0,15597,6.6,17388,185,68,-1152,-400,18.5,1559.7,blue,2.4,1.5,19,16,blue
4519816980,4,2,4,0,0,0,0,16523,7.2,18881,222,60,2592,1348,22.2,1652.3,2,4,2,1,1,0,0,13931,6.6,17533,202,52,-2592,-1348,20.2,1393.1,blue,4,1,24,21,red
4487913203,11,2,9,0,0,0,0,18285,7.2,19465,221,37,4581,3919,22.1,1828.5,2,11,1,0,0,0,0,13704,6.6,15546,175,50,-4581,-3919,17.5,1370.4,red,10,0.27,19,23,blue
4500094420,10,9,7,1,0,1,0,17346,7,18518,214,51,149,1781,21.4,1734.6,9,10,10,0,0,0,0,17197,6.8,16737,205,44,-149,-1781,20.5,1719.7,blue,1.89,1.9,22,47,red
4518483468,7,3,11,0,0,0,0,17443,7.4,19184,238,45,2786,881,23.8,1744.3,3,7,2,0,0,0,0,14657,6.8,18303,212,57,-2786,-881,21.2,1465.7,red,6,0.71,20,19,blue
4518291052,7,4,12,0,0,0,0,16526,6.6,17213,211,54,562,249,21.1,1652.6,4,7,9,1,1,0,0,15964,6.8,16964,233,48,-562,-249,23.3,1596.4,blue,4.75,1.86,16,24,red
4457019061,7,8,8,0,0,0,0,17363,6.8,17169,188,44,903,1019,18.8,1736.3,8,7,7,1,0,1,0,16460,6.4,16150,205,35,-903,-1019,20.5,1646,blue,1.88,2.14,22,28,blue
4521675950,10,4,9,1,1,0,0,18779,7.2,19556,252,47,3679,2110,25.2,1877.9,4,10,3,0,0,0,0,15100,6.6,17446,203,56,-3679,-2110,20.3,1510,blue,4.75,0.7,16,60,red
4522025457,13,6,14,0,0,0,1,20317,7,18795,199,42,3899,2300,19.9,2031.7,6,13,9,1,1,0,0,16418,6.4,16495,197,56,-3899,-2300,19.7,1641.8,red,4.5,1.15,13,16,blue
4524407688,2,1,2,1,1,0,0,15649,7,18530,269,56,1281,1111,26.9,1564.9,1,2,0,0,0,0,0,14368,7,17419,225,62,-1281,-1111,22.5,1436.8,blue,4,0.5,19,15,blue
4465268169,5,5,6,0,0,0,0,16256,7.2,17524,217,51,329,-994,21.7,1625.6,5,5,5,0,0,0,0,15927,7.2,18518,224,53,-329,994,22.4,1592.7,red,2.2,2,33,20,blue
4515997665,5,6,7,0,0,0,0,16688,7,18697,247,49,1008,-248,24.7,1668.8,6,5,5,1,1,0,0,15680,7.4,18945,199,51,-1008,248,19.9,1568,blue,2,2.2,17,47,blue
4421824314,10,4,8,1,0,1,0,17724,7.4,19917,210,43,3192,3351,21,1772.4,4,10,2,0,0,0,0,14532,6.6,16566,205,39,-3192,-3351,20.5,1453.2,red,4.5,0.6,44,19,red
4519746020,3,15,2,1,0,1,0,15320,6.8,16625,176,56,-4348,-4019,17.6,1532,15,3,15,1,1,0,0,19668,7.6,20644,208,48,4348,4019,20.8,1966.8,red,0.33,10,19,38,red
4496874191,6,7,8,1,1,0,0,15900,6.8,17169,203,52,-689,-1431,20.3,1590,7,6,8,0,0,0,0,16589,7.2,18600,218,56,689,1431,21.8,1658.9,blue,2,2.5,15,20,red
4510298547,12,4,19,1,1,0,0,18377,6.8,17762,193,50,2963,141,19.3,1837.7,4,12,1,0,0,0,0,15414,7,17621,221,47,-2963,-141,22.1,1541.4,blue,7.75,0.42,18,17,blue
4477353070,4,6,5,1,1,0,0,15785,6.8,17629,210,51,-522,-1014,21,1578.5,6,4,4,0,0,0,0,16307,7,18643,221,52,522,1014,22.1,1630.7,red,1.5,2.5,20,19,red
4426206807,10,7,13,0,0,0,0,17625,7.4,19146,205,39,514,2073,20.5,1762.5,7,10,10,0,0,0,0,17111,6.6,17073,223,36,-514,-2073,22.3,1711.1,red,3.29,1.7,17,19,red
4508717967,15,6,15,0,0,0,0,19931,7,18115,213,40,4375,3249,21.3,1993.1,6,15,6,0,0,0,0,15556,6.2,14866,169,40,-4375,-3249,16.9,1555.6,red,5,0.8,20,18,red
4450360531,14,4,15,1,1,0,0,19331,7,19211,213,46,4289,3990,21.3,1933.1,4,14,7,0,0,0,0,15042,6.4,15221,171,36,-4289,-3990,17.1,1504.2,red,7.25,0.79,17,15,blue
4496714478,6,9,4,1,1,0,0,17048,7.2,18842,201,64,-32,848,20.1,1704.8,9,6,9,0,0,0,0,17080,7,17994,197,48,32,-848,19.7,1708,blue,1.11,3,21,16,red
4522281462,9,10,10,0,0,0,0,17910,6.8,16867,207,45,88,-589,20.7,1791,10,9,11,1,0,1,0,17822,6.8,17456,197,44,-88,589,19.7,1782.2,red,1.9,2.33,32,46,red
4518592520,7,1,4,1,1,0,0,16614,7,18570,221,50,3295,3468,22.1,1661.4,1,7,0,0,0,0,0,13319,6.4,15102,205,50,-3295,-3468,20.5,1331.9,blue,11,0.14,16,16,blue
4492030196,5,5,6,0,0,0,0,15943,6.6,17366,229,47,-467,-1361,22.9,1594.3,5,5,5,0,0,0,0,16410,7,18727,235,56,467,1361,23.5,1641,red,2.2,2,25,17,red
4509979337,4,7,1,0,0,0,0,14924,6.8,17139,207,56,-2611,-1375,20.7,1492.4,7,4,5,1,1,0,1,17535,7,18514,218,65,2611,1375,21.8,1753.5,blue,0.71,3,14,54,red
4450271730,5,8,3,1,1,0,0,15069,6.6,16824,198,46,-1974,-589,19.8,1506.9,8,5,12,0,0,0,0,17043,6.8,17413,216,40,1974,589,21.6,1704.3,blue,1,4,16,26,red
4496792553,8,7,13,0,0,0,0,16366,6.8,17010,196,34,-963,-457,19.6,1636.6,7,8,8,0,0,0,0,17329,7,17467,220,52,963,457,22,1732.9,blue,3,1.88,19,18,red
4523725496,2,12,2,0,0,0,0,14158,6.6,16377,194,41,-5740,-3709,19.4,1415.8,12,2,8,2,1,1,0,19898,7.4,20086,240,57,5740,3709,24,1989.8,red,0.33,10,17,20,red
4440187029,2,4,1,0,0,0,0,14291,7,18239,207,65,-2609,-1786,20.7,1429.1,4,2,3,1,1,0,0,16900,7.6,20025,259,76,2609,1786,25.9,1690,red,0.75,3.5,88,19,red
4518069601,5,6,7,0,0,0,0,15078,6.6,16578,202,28,-1018,-828,20.2,1507.8,6,5,6,1,1,0,0,16096,6.8,17406,222,38,1018,828,22.2,1609.6,red,2,2.4,16,15,red
4476840336,9,4,13,0,0,0,0,17234,6.6,17496,195,44,2477,1105,19.5,1723.4,4,9,3,0,0,0,0,14757,6.6,16391,194,39,-2477,-1105,19.4,1475.7,blue,5.5,0.78,20,16,blue
4462139682,9,5,8,1,1,0,0,17826,7.2,18216,220,54,3074,1273,22,1782.6,5,9,2,0,0,0,0,14752,6.4,16943,205,37,-3074,-1273,20.5,1475.2,blue,3.4,0.78,33,17,blue
4494166965,10,11,9,1,1,0,0,18445,7,18076,199,50,552,-193,19.9,1844.5,11,10,10,0,0,0,0,17893,7,18269,207,36,-552,193,20.7,1789.3,red,1.73,2.1,20,16,red
4518235291,6,6,7,1,1,0,0,15814,6.8,17161,205,49,-1530,-922,20.5,1581.4,6,6,6,1,0,1,0,17344,7,18083,252,48,1530,922,25.2,1734.4,red,2.17,2,17,22,red
4475880508,8,13,4,0,0,0,0,16735,7,17923,202,28,-2187,-2383,20.2,1673.5,13,8,15,1,1,0,0,18922,7.2,20306,208,46,2187,2383,20.8,1892.2,red,0.92,3.5,22,54,red
4518819945,8,13,8,0,0,0,0,15818,6.4,16673,172,28,-4100,-3722,17.2,1581.8,13,8,11,0,0,0,0,19918,7.4,20395,220,59,4100,3722,22,1991.8,red,1.23,3,12,22,red
4523974037,6,5,6,0,0,0,0,16999,7.2,18578,232,59,389,-279,23.2,1699.9,5,6,6,2,1,1,0,16610,7.2,18857,216,64,-389,279,21.6,1661,red,2.4,1.83,34,49,red
4448510561,5,10,5,0,0,0,0,15867,6.8,17737,227,47,-1806,-1253,22.7,1586.7,10,5,9,0,0,0,0,17673,7.2,18990,200,44,1806,1253,20,1767.3,red,1,3.8,19,20,red
4465932394,11,10,11,0,0,0,0,18042,6.6,17600,221,46,704,-422,22.1,1804.2,10,11,10,0,0,0,0,17338,7,18022,198,42,-704,422,19.8,1733.8,blue,2.2,1.82,17,22,blue
4474160523,8,4,9,2,1,1,0,18293,7.4,19340,228,76,2406,2284,22.8,1829.3,4,8,7,0,0,0,0,15887,6.8,17056,224,52,-2406,-2284,22.4,1588.7,blue,4.25,1.38,18,17,blue
4436517463,5,4,6,0,0,0,0,15895,7,18344,239,38,42,367,23.9,1589.5,4,5,7,1,1,0,0,15853,6.8,17977,258,48,-42,-367,25.8,1585.3,blue,2.75,2.2,13,23,blue
4523100302,1,4,1,0,0,0,0,14305,6.8,17810,251,44,-2889,-2106,25.1,1430.5,4,1,5,1,1,0,0,17194,7.2,19916,282,56,2889,2106,28.2,1719.4,red,0.5,9,21,25,red
4523793959,8,2,16,1,1,0,0,18186,7.4,19555,232,67,3131,2377,23.2,1818.6,2,8,5,0,0,0,0,15055,6.6,17178,231,50,-3131,-2377,23.1,1505.5,blue,12,0.88,21,16,blue
4520794525,6,8,7,0,0,0,0,16295,6.8,17588,222,47,-1271,-364,22.2,1629.5,8,6,10,1,1,0,0,17566,6.8,17952,219,47,1271,364,21.9,1756.6,red,1.62,3,48,15,red
4506509560,17,1,23,1,1,0,0,20151,7.4,19504,226,38,6783,4718,22.6,2015.1,1,17,2,0,0,0,0,13368,6.2,14786,177,53,-6783,-4718,17.7,1336.8,blue,40,0.18,25,24,blue
4496084500,3,9,5,0,0,0,0,14735,6.4,16488,219,38,-2932,-2063,21.9,1473.5,9,3,5,0,0,0,0,17667,7.2,18551,223,44,2932,2063,22.3,1766.7,red,0.89,4.67,39,15,red
4431984647,1,16,1,1,1,0,0,12798,5.8,13908,179,36,-7868,-5339,17.9,1279.8,16,1,16,0,0,0,1,20666,7.2,19247,223,44,7868,5339,22.3,2066.6,red,0.12,32,16,15,red
4522422661,4,6,6,1,1,0,0,16452,7,18564,234,54,271,22,23.4,1645.2,6,4,1,1,0,1,0,16181,7,18542,224,64,-271,-22,22.4,1618.1,blue,1.67,1.75,19,15,blue
4523404068,6,7,6,0,0,0,0,16120,7,18149,215,51,-732,750,21.5,1612,7,6,7,1,1,0,0,16852,7,17399,205,56,732,-750,20.5,1685.2,red,1.71,2.33,13,17,red
4494238237,9,6,9,0,0,0,0,18287,7.4,19617,226,44,1863,2270,22.6,1828.7,6,9,6,0,0,0,0,16424,6.8,17347,232,49,-1863,-2270,23.2,1642.4,blue,3,1.33,18,19,blue
4443526032,4,7,6,0,0,0,0,15902,6.8,17995,241,48,-1190,-66,24.1,1590.2,7,4,14,1,1,0,0,17092,6.8,18061,241,57,1190,66,24.1,1709.2,red,1.43,5.25,39,33,red
4522459289,8,5,8,0,0,0,0,16982,7.2,19524,218,41,-212,1212,21.8,1698.2,5,8,10,2,1,1,0,17194,7.2,18312,242,59,212,-1212,24.2,1719.4,blue,3.2,1.88,13,14,red
4519045200,7,7,6,0,0,0,0,17064,7,18061,236,48,134,-396,23.6,1706.4,7,7,8,1,1,0,0,16930,7,18457,210,59,-134,396,21,1693,red,1.86,2.14,15,17,red
4491049455,5,11,6,0,0,0,0,15424,6.6,16080,208,45,-3692,-3112,20.8,1542.4,11,5,16,2,1,1,0,19116,7.2,19192,195,55,3692,3112,19.5,1911.6,red,1,5.4,20,18,red
4471439169,9,4,13,0,0,0,0,18369,7.2,19417,210,56,3269,2404,21,1836.9,4,9,1,1,1,0,0,15100,6.8,17013,213,52,-3269,-2404,21.3,1510,blue,5.5,0.56,21,19,blue
4525020504,7,6,7,0,0,0,0,17568,6.8,18166,236,64,1308,544,23.6,1756.8,6,7,6,0,0,0,0,16260,7,17622,207,40,-1308,-544,20.7,1626,blue,2.33,1.71,19,28,blue
4524033878,9,10,7,0,0,0,0,18090,6.8,17730,229,36,1106,470,22.9,1809,10,9,12,1,0,1,0,16984,7,17260,204,38,-1106,-470,20.4,1698.4,blue,1.6,2.44,26,20,red
4517857557,4,5,7,1,1,0,0,15786,6.8,17823,207,54,-92,-1170,20.7,1578.6,5,4,3,0,0,0,0,15878,7.4,18993,215,50,92,1170,21.5,1587.8,red,2.2,2,16,17,red
4452273327,4,3,6,0,0,0,0,16596,7,18596,252,64,539,818,25.2,1659.6,3,4,2,1,1,0,0,16057,6.6,17778,236,51,-539,-818,23.6,1605.7,red,3.33,1.25,53,27,blue
4516355012,8,12,5,1,0,1,0,16093,7,16927,154,53,-3195,-953,15.4,1609.3,12,8,13,0,0,0,0,19288,6.8,17880,213,46,3195,953,21.3,1928.8,red,1.08,3.12,15,14,blue
4523634644,7,4,8,2,1,1,1,18858,7.2,19023,237,66,4338,4607,23.7,1885.8,4,7,11,0,0,0,0,14520,6.2,14416,166,42,-4338,-4607,16.6,1452,blue,3.75,2.14,19,20,blue
4509524180,5,7,9,1,1,0,0,15288,6.6,16534,206,57,-861,131,20.6,1528.8,7,5,13,0,0,0,0,16149,6.6,16403,200,34,861,-131,20,1614.9,red,2,4,20,28,blue
4462515361,7,5,7,1,1,0,0,16346,6.8,17401,227,52,-90,102,22.7,1634.6,5,7,5,0,0,0,0,16436,7,17299,234,40,90,-102,23.4,1643.6,blue,2.8,1.43,17,16,red
4448123749,1,11,0,0,0,0,0,13447,6.4,16199,201,51,-5698,-3675,20.1,1344.7,11,1,12,2,1,1,0,19145,7.2,19874,240,44,5698,3675,24,1914.5,red,0.09,23,15,21,red
4516721414,8,8,8,1,1,0,0,16453,6.8,17231,206,40,-569,-213,20.6,1645.3,8,8,10,1,0,1,0,17022,7,17444,199,43,569,213,19.9,1702.2,red,2,2.25,22,23,blue
4458124147,12,6,16,0,0,0,0,18669,7.2,19226,213,39,1788,761,21.3,1866.9,6,12,7,1,1,0,0,16881,7,18465,208,55,-1788,-761,20.8,1688.1,blue,4.67,1.08,15,43,red
4467276496,5,5,8,0,0,0,0,16192,6.8,18197,209,60,1056,-182,20.9,1619.2,5,5,4,1,1,0,0,15136,7,18379,185,46,-1056,182,18.5,1513.6,blue,2.6,1.8,37,12,blue
4503391789,2,7,1,1,1,0,0,13701,6.6,15431,183,59,-4095,-3017,18.3,1370.1,7,2,6,0,0,0,0,17796,7.2,18448,255,36,4095,3017,25.5,1779.6,red,0.43,6.5,17,23,red
4437730015,6,5,7,0,0,0,0,16762,7,18180,242,44,482,166,24.2,1676.2,5,6,8,0,0,0,0,16280,6.8,18014,231,48,-482,-166,23.1,1628,red,2.6,2.17,20,20,blue
4490472819,8,8,5,0,0,0,0,16795,6.8,18159,235,48,-507,-790,23.5,1679.5,8,8,9,1,0,1,0,17302,7.2,18949,203,56,507,790,20.3,1730.2,red,1.62,2.12,17,19,blue
4524386145,4,12,1,0,0,0,0,14464,6.2,15227,164,58,-4820,-2651,16.4,1446.4,12,4,9,0,0,0,1,19284,7,17878,206,44,4820,2651,20.6,1928.4,red,0.42,5.25,13,15,red
4520879335,5,10,5,0,0,0,0,16925,6.6,18087,233,64,-962,107,23.3,1692.5,10,5,16,1,1,0,0,17887,7,17980,213,44,962,-107,21.3,1788.7,red,1,5.2,17,20,red
4518934441,3,9,1,0,0,0,0,14302,6.6,15878,211,51,-3025,-2906,21.1,1430.2,9,3,9,2,1,1,0,17327,7.2,18784,212,64,3025,2906,21.2,1732.7,red,0.44,6,21,37,blue
4453066386,2,8,2,1,0,1,0,14786,6.6,16676,233,50,-1340,-529,23.3,1478.6,8,2,6,1,1,0,0,16126,6.8,17205,205,37,1340,529,20.5,1612.6,red,0.5,7,18,20,red
4500486602,3,3,2,0,0,0,0,15134,7,18028,214,54,-168,267,21.4,1513.4,3,3,4,1,1,0,0,15302,7,17761,214,61,168,-267,21.4,1530.2,red,1.67,2.33,30,19,red
4524898473,8,13,8,1,0,1,1,18954,6.8,17795,228,46,-664,-549,22.8,1895.4,13,8,13,1,1,0,1,19618,7,18344,182,57,664,549,18.2,1961.8,blue,1.23,3.25,16,17,red
4450459916,6,12,7,1,1,0,0,16043,7,17409,220,51,-3089,-2946,22,1604.3,12,6,12,0,0,0,0,19132,7.6,20355,235,50,3089,2946,23.5,1913.2,red,1.08,4,17,24,blue
4514841518,5,6,4,0,0,0,0,15195,7.2,17896,196,43,-1573,-1171,19.6,1519.5,6,5,7,1,1,0,0,16768,7,19067,202,71,1573,1171,20.2,1676.8,blue,1.5,2.6,15,13,red
4473962566,9,7,10,1,1,0,0,17205,7,18124,218,40,721,2077,21.8,1720.5,7,9,11,0,0,0,0,16484,6.4,16047,212,39,-721,-2077,21.2,1648.4,blue,2.71,2,19,17,red
4522845066,5,4,5,0,0,0,0,16022,7,17853,219,60,511,-678,21.9,1602.2,4,5,9,1,0,1,0,15511,7,18531,242,42,-511,678,24.2,1551.1,red,2.5,2.6,26,79,blue
4517859003,6,7,6,0,0,0,0,15615,7,17928,201,49,-1193,-819,20.1,1561.5,7,6,10,0,0,0,0,16808,7,18747,229,36,1193,819,22.9,1680.8,blue,1.71,2.83,19,20,red
4484417350,2,8,3,0,0,0,0,14433,6.6,16813,202,64,-3215,-1656,20.2,1443.3,8,2,7,1,0,1,0,17648,7.2,18469,243,43,3215,1656,24.3,1764.8,red,0.62,7.5,16,24,red
4523090796,13,3,13,2,1,1,1,19807,6.8,17943,220,36,5227,2051,22,1980.7,3,13,1,0,0,0,0,14580,6.6,15892,210,47,-5227,-2051,21,1458,blue,8.67,0.31,21,54,blue
4512968570,4,2,5,1,1,0,0,15704,6.8,18292,236,58,1012,519,23.6,1570.4,2,4,0,0,0,0,0,14692,7,17773,234,63,-1012,-519,23.4,1469.2,blue,4.5,0.5,23,24,blue
4517995978,4,4,5,1,0,1,1,17073,6.8,17021,221,50,2002,388,22.1,1707.3,4,4,7,0,0,0,0,15071,6.4,16633,203,51,-2002,-388,20.3,1507.1,blue,2.25,2.75,18,18,blue
4458685012,9,3,11,0,0,0,0,18584,7,18383,203,70,3093,1285,20.3,1858.4,3,9,5,0,0,0,0,15491,6.8,17098,212,41,-3093,-1285,21.2,1549.1,blue,6.67,0.89,18,19,blue
4439348607,7,11,11,1,1,0,0,16187,6.4,16701,216,30,-2377,-2355,21.6,1618.7,11,7,14,0,0,0,0,18564,7,19056,206,67,2377,2355,20.6,1856.4,red,1.64,3.57,24,20,red
4513003533,9,10,14,1,1,0,0,16749,6.4,16227,166,48,-2419,-3313,16.6,1674.9,10,9,13,0,0,0,0,19168,7.4,19540,240,39,2419,3313,24,1916.8,red,2.3,2.56,25,20,red
4524532805,6,6,5,1,1,0,0,16490,7,19578,214,68,-392,462,21.4,1649,6,6,8,0,0,0,0,16882,7.2,19116,232,56,392,-462,23.2,1688.2,red,1.83,2.33,11,17,red
4447096755,6,4,5,2,1,1,0,16697,7.2,19170,236,59,852,1553,23.6,1669.7,4,6,7,0,0,0,0,15845,7,17617,214,51,-852,-1553,21.4,1584.5,blue,2.75,1.83,26,20,blue
4470320666,10,4,10,2,1,1,0,17973,7.2,20040,196,64,2507,3196,19.6,1797.3,4,10,5,0,0,0,0,15466,6.6,16844,209,48,-2507,-3196,20.9,1546.6,blue,5,0.9,48,18,red
4499907399,5,2,6,0,0,0,0,16029,6.8,17493,234,47,1756,1920,23.4,1602.9,2,5,3,0,0,0,0,14273,6.2,15573,199,49,-1756,-1920,19.9,1427.3,blue,5.5,1,25,18,red
4523305960,4,2,4,2,1,1,0,15752,7.2,19171,231,64,1064,2471,23.1,1575.2,2,4,4,0,0,0,0,14688,6.6,16700,235,44,-1064,-2471,23.5,1468.8,blue,4,1.5,17,56,red
4501476679,5,3,3,1,1,0,0,15930,7.2,18669,234,44,1713,2145,23.4,1593,3,5,3,0,0,0,0,14217,6.4,16524,188,44,-1713,-2145,18.8,1421.7,blue,2.67,1.2,16,18,blue
4499810008,6,6,10,0,0,0,0,15241,6.6,16491,190,36,-1137,-1402,19,1524.1,6,6,6,2,1,1,0,16378,6.8,17893,224,45,1137,1402,22.4,1637.8,red,2.67,2,16,18,red
4451011365,8,4,7,1,1,0,0,17127,6.8,18148,201,48,2294,1383,20.1,1712.7,4,8,2,0,0,0,0,14833,6.4,16765,183,67,-2294,-1383,18.3,1483.3,blue,3.75,0.75,18,17,red
4524361228,1,7,2,0,0,0,0,13519,6.4,15833,188,53,-4115,-2985,18.8,1351.9,7,1,9,1,1,0,0,17634,7,18818,251,47,4115,2985,25.1,1763.4,red,0.43,16,18,20,red
4513611157,11,6,13,0,0,0,0,18748,7,19116,243,40,2520,2092,24.3,1874.8,6,11,5,0,0,0,0,16228,6.8,17024,224,40,-2520,-2092,22.4,1622.8,blue,4,1,22,57,red
4520841378,4,7,3,1,1,0,0,16055,6.8,17933,227,55,93,1195,22.7,1605.5,7,4,9,0,0,0,0,15962,6.8,16738,214,36,-93,-1195,21.4,1596.2,blue,1,4,16,16,red
4524882878,7,5,5,1,1,0,0,16496,7,18201,202,55,1744,1187,20.2,1649.6,5,7,5,0,0,0,0,14752,6.6,17014,209,36,-1744,-1187,20.9,1475.2,blue,2.4,1.43,20,20,blue
4517917805,6,9,10,1,1,0,0,17217,7,18979,222,60,-315,-7,22.2,1721.7,9,6,11,0,0,0,0,17532,7,18986,218,52,315,7,21.8,1753.2,blue,1.78,3.33,18,24,red
4524026578,4,5,4,0,0,0,0,15482,7.2,18715,237,47,-1335,-172,23.7,1548.2,5,4,5,2,1,1,0,16817,7.2,18887,228,55,1335,172,22.8,1681.7,red,1.6,2.5,15,41,red
4447452177,3,3,1,0,0,0,0,14486,7,18218,200,63,-648,728,20,1448.6,3,3,3,1,1,0,0,15134,7,17490,208,56,648,-728,20.8,1513.4,red,1.33,2,18,22,blue
4407738489,6,12,4,0,0,0,0,15809,6.8,17592,198,30,-3854,-1813,19.8,1580.9,12,6,15,0,0,0,0,19663,7.2,19405,238,39,3854,1813,23.8,1966.3,red,0.83,4.5,51,15,blue
4522541186,11,8,8,1,1,0,1,19556,7,18352,229,41,2585,1759,22.9,1955.6,8,11,9,0,0,0,0,16971,6.6,16593,169,63,-2585,-1759,16.9,1697.1,blue,2.38,1.55,168,15,blue
4452390949,9,4,11,1,1,0,0,17003,6.8,17799,188,58,2247,1668,18.8,1700.3,4,9,3,0,0,0,0,14756,6.4,16131,189,48,-2247,-1668,18.9,1475.6,blue,5,0.78,14,14,blue
4458640668,5,10,2,0,0,0,0,16451,7,18416,220,59,-977,143,22,1645.1,10,5,8,0,0,0,0,17428,6.8,18273,189,53,977,-143,18.9,1742.8,red,0.7,3.6,19,16,red
4465074882,6,3,5,0,0,0,0,17837,7.2,19440,238,76,2970,2037,23.8,1783.7,3,6,4,0,0,0,0,14867,7,17403,217,52,-2970,-2037,21.7,1486.7,blue,3.67,1.17,21,54,blue
4506217760,11,6,14,1,1,0,0,18056,6.8,17829,195,54,250,287,19.5,1805.6,6,11,7,1,0,1,1,17806,7,17542,210,59,-250,-287,21,1780.6,blue,4.17,1.18,17,270,blue
4443008526,8,8,2,0,0,0,0,16249,6.8,17245,189,41,-1276,-648,18.9,1624.9,8,8,11,0,0,0,0,17525,7,17893,193,42,1276,648,19.3,1752.5,red,1.25,2.38,23,16,blue
4524611648,7,7,9,0,0,0,0,16946,6.8,18077,212,45,1482,1055,21.2,1694.6,7,7,7,1,1,0,0,15464,7,17022,161,48,-1482,-1055,16.1,1546.4,blue,2.29,2,18,20,blue
4506376932,4,2,5,0,0,0,0,15707,6.8,17968,243,55,428,687,24.3,1570.7,2,4,4,1,1,0,0,15279,6.8,17281,247,42,-428,-687,24.7,1527.9,red,4.5,1.5,26,22,red
4515697055,7,6,7,0,0,0,0,16443,7,18461,193,52,-1706,-1027,19.3,1644.3,6,7,6,0,0,0,0,18149,7.2,19488,247,68,1706,1027,24.7,1814.9,red,2.33,1.71,20,17,blue
4483760431,8,5,10,2,1,1,0,17823,7.4,19752,215,64,1014,950,21.5,1782.3,5,8,5,0,0,0,0,16809,7,18802,219,75,-1014,-950,21.9,1680.9,blue,3.6,1.25,12,10,red
4485980330,2,6,2,0,0,0,0,16241,7.2,18365,236,57,250,942,23.6,1624.1,6,2,8,1,1,0,0,15991,6.8,17423,196,56,-250,-942,19.6,1599.1,blue,0.67,7,21,38,red
4511502291,7,8,6,1,0,1,0,16464,6.6,17075,209,52,166,395,20.9,1646.4,8,7,12,1,1,0,0,16298,6.6,16680,167,40,-166,-395,16.7,1629.8,blue,1.62,2.86,17,17,red
4495005465,6,8,7,0,0,0,0,16924,6.8,17938,233,47,-465,-436,23.3,1692.4,8,6,10,0,0,0,0,17389,7.2,18374,214,42,465,436,21.4,1738.9,red,1.62,3,13,82,red
4456960285,10,8,10,1,1,0,0,17251,6.8,17415,217,46,-733,-541,21.7,1725.1,8,10,13,0,0,0,0,17984,6.8,17956,234,39,733,541,23.4,1798.4,blue,2.5,2.1,24,20,red
4518159499,6,8,8,0,0,0,0,16917,7.2,18964,212,62,-1013,-36,21.2,1691.7,8,6,6,1,1,0,0,17930,7,19000,260,56,1013,36,26,1793,red,1.75,2.33,40,13,red
4468797183,7,7,6,2,1,1,2,19453,7,18832,239,64,3773,1957,23.9,1945.3,7,7,6,0,0,0,0,15680,6.6,16875,170,52,-3773,-1957,17,1568,blue,1.86,1.86,12,13,red
4523041612,5,4,4,0,0,0,0,16891,7.4,19197,207,79,1060,1554,20.7,1689.1,4,5,4,1,1,0,0,15831,6.8,17643,211,60,-1060,-1554,21.1,1583.1,red,2.25,1.6,19,72,red
4512312350,7,4,4,1,1,0,0,17107,7.2,19237,218,68,2169,2453,21.8,1710.7,4,7,4,0,0,0,0,14938,6.6,16784,212,40,-2169,-2453,21.2,1493.8,blue,2.75,1.14,18,31,blue
4514358264,4,2,3,1,1,0,0,15444,7,17833,236,53,1019,708,23.6,1544.4,2,4,0,0,0,0,0,14425,6.6,17125,229,44,-1019,-708,22.9,1442.5,blue,3.5,0.5,22,18,red
4520529176,9,5,10,2,1,1,0,18283,7.2,18731,226,59,2684,1191,22.6,1828.3,5,9,4,0,0,0,0,15599,7,17540,211,37,-2684,-1191,21.1,1559.9,blue,3.8,1,20,44,blue
4477445574,4,2,3,0,0,0,0,16267,6.8,18319,246,52,1362,699,24.6,1626.7,2,4,4,2,1,1,0,14905,7,17620,228,64,-1362,-699,22.8,1490.5,blue,3.5,1.5,21,17,blue
4477502000,6,7,7,1,0,1,0,17247,7,18845,233,65,915,1710,23.3,1724.7,7,6,9,0,0,0,0,16332,7,17135,214,36,-915,-1710,21.4,1633.2,blue,1.86,2.67,64,19,blue
4520688318,11,6,22,1,0,1,0,18640,7,18015,226,48,1931,1200,22.6,1864,6,11,10,1,1,0,0,16709,6.6,16815,232,62,-1931,-1200,23.2,1670.9,red,5.5,1.45,58,15,red
4478461160,9,0,8,0,0,0,0,17086,7.2,19170,221,49,3655,2743,22.1,1708.6,0,9,0,1,1,0,0,13431,6.4,16427,198,60,-3655,-2743,19.8,1343.1,blue,12.03,0,16,39,blue
4519427485,6,4,8,0,0,0,0,16505,6.8,17567,205,52,805,149,20.5,1650.5,4,6,4,1,1,0,0,15700,7,17418,256,44,-805,-149,25.6,1570,red,3.5,1.33,28,21,blue
4524478226,12,10,20,0,0,0,0,17961,6.8,17984,172,32,478,-124,17.2,1796.1,10,12,17,1,1,0,0,17483,6.8,18108,159,75,-478,124,15.9,1748.3,blue,3.2,2.25,17,62,red
4501131347,14,12,14,1,1,0,0,19418,6.8,18520,204,49,1698,2237,20.4,1941.8,12,14,11,1,0,1,0,17720,6.6,16283,167,51,-1698,-2237,16.7,1772,blue,2.33,1.64,49,26,blue
4500439445,4,5,3,0,0,0,0,15846,7,18388,214,58,-330,-466,21.4,1584.6,5,4,5,1,1,0,0,16176,7.2,18854,236,52,330,466,23.6,1617.6,blue,1.4,2.5,20,18,blue
4521846073,6,5,7,1,0,1,0,16937,7,18194,221,43,592,242,22.1,1693.7,5,6,4,1,1,0,0,16345,7.2,17952,215,67,-592,-242,21.5,1634.5,blue,2.6,1.5,24,17,blue
4524317634,1,4,1,0,0,0,0,14064,6.6,16539,220,37,-1765,-2344,22,1406.4,4,1,2,1,1,0,0,15829,6.8,18883,244,62,1765,2344,24.4,1582.9,red,0.5,6,20,21,blue
4508697399,1,2,1,0,0,0,0,15094,6.8,18255,246,51,-92,-244,24.6,1509.4,2,1,3,1,1,0,0,15186,6.8,18499,226,64,92,244,22.6,1518.6,red,1,5,14,12,blue
4494950726,5,11,5,1,1,0,0,15633,6.8,17179,193,54,-2947,-2189,19.3,1563.3,11,5,13,0,0,0,0,18580,7.2,19368,224,43,2947,2189,22.4,1858,red,0.91,4.8,71,18,blue
4524780505,6,2,6,1,1,0,0,16868,6.8,18060,245,52,1982,990,24.5,1686.8,2,6,6,0,0,0,0,14886,6.8,17070,227,60,-1982,-990,22.7,1488.6,blue,6,1.33,21,18,blue
4480448606,10,7,8,1,0,1,0,19289,7.6,19633,240,63,2330,2319,24,1928.9,7,10,9,0,0,0,0,16959,7,17314,200,39,-2330,-2319,20,1695.9,blue,2.57,1.6,18,54,red
4521063765,3,3,4,1,1,0,0,15138,7,18807,194,66,-105,1086,19.4,1513.8,3,3,3,0,0,0,0,15243,7,17721,235,55,105,-1086,23.5,1524.3,blue,2.33,2,18,18,red
4446243794,1,5,1,2,1,1,0,14942,7,17727,210,83,-1215,-756,21,1494.2,5,1,7,0,0,0,0,16157,7,18483,233,52,1215,756,23.3,1615.7,blue,0.4,12,20,24,red
4509810925,6,6,7,1,1,0,0,15703,6.8,16893,191,40,-951,-1116,19.1,1570.3,6,6,8,0,0,0,0,16654,7.2,18009,221,51,951,1116,22.1,1665.4,red,2.17,2.33,17,15,red
4473257949,5,3,7,2,1,1,0,15427,6.8,17667,217,47,134,-144,21.7,1542.7,3,5,2,0,0,0,0,15293,7,17811,235,51,-134,144,23.5,1529.3,blue,4,1,20,23,blue
4523527699,6,5,8,0,0,0,0,16620,7,17711,238,37,361,-672,23.8,1662,5,6,5,0,0,0,0,16259,7,18383,223,54,-361,672,22.3,1625.9,blue,2.8,1.67,113,17,blue
4522356055,6,5,5,1,1,0,0,15926,6.8,17186,209,44,905,1369,20.9,1592.6,5,6,10,0,0,0,0,15021,6.4,15817,180,40,-905,-1369,18,1502.1,blue,2.2,2.5,21,17,red
4454501300,9,6,5,0,0,0,0,16852,6.6,17417,210,38,348,-1004,21,1685.2,6,9,6,1,1,0,0,16504,7,18421,216,60,-348,1004,21.6,1650.4,red,2.33,1.33,16,20,blue
4516589560,6,8,6,0,0,0,0,16936,7.2,18023,219,64,-424,-630,21.9,1693.6,8,6,10,2,1,1,0,17360,7,18653,230,48,424,630,23,1736,red,1.5,3,15,16,blue
4505605320,10,4,13,1,1,0,0,17917,7.2,18904,212,37,3058,1325,21.2,1791.7,4,10,2,1,0,1,0,14859,6.8,17579,222,52,-3058,-1325,22.2,1485.9,blue,5.75,0.6,19,38,blue
4470336918,7,8,11,1,1,0,0,17558,6.8,17445,241,48,-105,-1401,24.1,1755.8,8,7,9,1,0,1,0,17663,6.8,18846,232,50,105,1401,23.2,1766.3,red,2.25,2.43,17,22,blue
4522654087,3,8,3,0,0,0,0,15149,6.8,17143,205,51,-1876,-2659,20.5,1514.9,8,3,4,1,1,0,0,17025,7.4,19802,211,76,1876,2659,21.1,1702.5,red,0.75,4,12,15,red
4523758251,5,7,8,1,1,0,0,16112,6.4,16747,215,52,-1031,-760,21.5,1611.2,7,5,10,0,0,0,0,17143,6.8,17507,211,56,1031,760,21.1,1714.3,red,1.86,3.4,16,18,red
4522558200,7,4,6,0,0,0,0,15885,7.2,19056,207,52,125,2058,20.7,1588.5,4,7,4,0,0,0,0,15760,6.8,16998,224,47,-125,-2058,22.4,1576,red,3.25,1.14,40,27,blue
4524960407,4,7,4,1,0,1,1,17104,6.6,17075,224,61,-669,-502,22.4,1710.4,7,4,8,1,1,0,0,17773,6.8,17577,209,46,669,502,20.9,1777.3,blue,1.14,3.75,22,21,blue
4492820318,10,5,16,1,1,0,1,17535,6.4,15420,173,40,1436,-1544,17.3,1753.5,5,10,4,0,0,0,0,16099,6.8,16964,207,66,-1436,1544,20.7,1609.9,blue,5.2,0.9,54,16,red
4482355547,8,10,8,1,1,0,0,17321,7,18683,205,59,-78,-155,20.5,1732.1,10,8,7,1,0,1,0,17399,7.4,18838,207,40,78,155,20.7,1739.9,red,1.6,2.12,24,15,blue
4519483383,6,7,6,1,0,1,0,16317,7,18679,204,71,-713,103,20.4,1631.7,7,6,5,1,1,0,0,17030,6.8,18576,212,52,713,-103,21.2,1703,blue,1.71,2,12,88,blue
4523957266,4,7,2,0,0,0,0,15649,7.2,18614,234,66,-1975,-1115,23.4,1564.9,7,4,7,1,1,0,0,17624,7.2,19729,243,55,1975,1115,24.3,1762.4,red,0.86,3.5,21,28,red
4520868488,9,3,11,0,0,0,0,17592,7,18664,220,41,1411,766,22,1759.2,3,9,4,1,1,0,0,16181,7,17898,215,62,-1411,-766,21.5,1618.1,blue,6.67,0.78,18,12,blue
4457621044,2,1,3,1,1,0,0,15420,7,18204,230,65,661,139,23,1542,1,2,2,0,0,0,0,14759,6.6,18065,245,56,-661,-139,24.5,1475.9,blue,5,1.5,50,16,blue
4494262239,3,4,6,0,0,0,0,15929,6.8,17529,226,40,-394,-1635,22.6,1592.9,4,3,4,1,0,1,0,16323,7,19164,237,64,394,1635,23.7,1632.3,red,2.25,2.67,14,15,red
4524530241,4,4,4,0,0,0,0,15046,6.6,16504,178,48,-557,-832,17.8,1504.6,4,4,6,0,0,0,0,15603,6.6,17336,217,52,557,832,21.7,1560.3,red,2,2.5,49,18,blue
4500738372,6,3,5,0,0,0,0,16737,7.4,19857,243,64,1204,2004,24.3,1673.7,3,6,2,1,1,0,0,15533,6.8,17853,250,48,-1204,-2004,25,1553.3,blue,3.67,0.83,23,20,red
4520610441,6,7,8,0,0,0,0,15756,6.6,16210,204,49,-1966,-3189,20.4,1575.6,7,6,6,0,0,0,0,17722,7.4,19399,242,60,1966,3189,24.2,1772.2,red,2,2.17,43,22,blue
4487705166,3,6,6,1,1,0,0,15442,6.8,17518,238,51,-1090,-1499,23.8,1544.2,6,3,6,0,0,0,0,16532,6.8,19017,233,56,1090,1499,23.3,1653.2,blue,1.5,4,61,28,red
4524841427,9,8,12,1,0,1,0,16649,6.2,15616,166,36,-1152,-2193,16.6,1664.9,8,9,8,1,1,0,0,17801,6.8,17809,208,48,1152,2193,20.8,1780.1,red,2.62,1.78,18,21,blue
4501013460,6,10,4,1,0,1,0,16171,7,17902,202,54,-1682,-71,20.2,1617.1,10,6,8,1,1,0,0,17853,7,17973,226,52,1682,71,22.6,1785.3,red,1,3,27,16,red
4522459951,9,4,12,1,1,0,0,17190,6.6,17783,210,41,1847,1084,21,1719,4,9,5,1,0,1,0,15343,6.8,16699,200,40,-1847,-1084,20,1534.3,blue,5.25,1,20,16,blue
4524235691,7,6,12,0,0,0,0,17222,7,18157,227,48,808,-236,22.7,1722.2,6,7,3,1,1,0,0,16414,7,18393,250,53,-808,236,25,1641.4,red,3.17,1.29,95,16,blue
4524900733,6,9,3,1,1,0,0,15704,6.6,17114,199,52,-1332,-2004,19.9,1570.4,9,6,10,0,0,0,0,17036,7.2,19118,217,40,1332,2004,21.7,1703.6,blue,1,3.17,17,20,red
4521830295,9,18,9,0,0,0,0,16331,6.4,14886,162,31,-3966,-2999,16.2,1633.1,18,9,16,1,0,1,0,20297,6.8,17885,169,38,3966,2999,16.9,2029.7,red,1,3.78,18,20,red
4460355612,10,7,11,1,0,1,1,19186,7.2,18375,183,51,1377,795,18.3,1918.6,7,10,8,1,1,0,0,17809,7,17580,201,52,-1377,-795,20.1,1780.9,red,3,1.5,34,16,red
4500291945,7,3,10,1,1,0,0,17546,6.8,17209,228,47,1493,1167,22.8,1754.6,3,7,4,1,0,1,1,16053,6.4,16042,193,51,-1493,-1167,19.3,1605.3,blue,5.67,1,16,12,blue
4512192023,4,7,5,0,0,0,0,15198,6.8,17177,219,38,-2876,-2715,21.9,1519.8,7,4,9,1,0,1,0,18074,7.2,19892,222,92,2876,2715,22.2,1807.4,red,1.29,4,22,14,red
4489456327,8,7,13,1,1,0,0,17909,6.4,16512,165,39,1340,-207,16.5,1790.9,7,8,10,0,0,0,0,16569,6.6,16719,201,32,-1340,207,20.1,1656.9,red,3,2.12,45,23,red
4522648784,4,7,2,0,0,0,0,15046,6.6,17140,208,48,-1208,-614,20.8,1504.6,7,4,5,1,1,0,0,16254,7,17754,227,44,1208,614,22.7,1625.4,red,0.86,3,21,41,red
4481739224,6,6,9,0,0,0,0,16740,7,19237,238,54,218,1085,23.8,1674,6,6,8,1,1,0,0,16522,7,18152,229,54,-218,-1085,22.9,1652.2,blue,2.5,2.33,24,22,red
4525228858,13,1,10,1,1,0,1,20295,7.2,19531,258,56,6907,4512,25.8,2029.5,1,13,1,0,0,0,0,13388,6.2,15019,178,54,-6907,-4512,17.8,1338.8,blue,23,0.15,17,17,blue
4522283833,4,5,7,0,0,0,0,15921,7,18190,217,48,-594,-353,21.7,1592.1,5,4,7,2,1,1,0,16515,7.2,18543,235,48,594,353,23.5,1651.5,blue,2.2,3,14,15,red
4473660797,10,9,13,2,1,1,0,17145,7,17904,192,45,-1464,-454,19.2,1714.5,9,10,5,0,0,0,0,18609,7.2,18358,226,46,1464,454,22.6,1860.9,red,2.56,1.4,15,18,red
4516698364,5,4,7,0,0,0,0,15936,7,18030,205,43,554,-702,20.5,1593.6,4,5,4,0,0,0,0,15382,7,18732,179,68,-554,702,17.9,1538.2,blue,3,1.6,17,28,red
4507824198,7,2,5,1,0,1,0,16649,7.4,19322,226,47,1256,-295,22.6,1664.9,2,7,1,1,1,0,0,15393,7.4,19617,268,63,-1256,295,26.8,1539.3,blue,6,0.43,18,22,blue
4508436860,10,2,14,1,1,0,0,17618,7,18556,203,36,4373,4286,20.3,1761.8,2,10,3,0,0,0,0,13245,6,14270,184,24,-4373,-4286,18.4,1324.5,blue,12,0.5,42,17,blue
4451008750,6,5,6,0,0,0,0,15871,6.6,17106,195,45,-245,-278,19.5,1587.1,5,6,6,1,1,0,0,16116,7,17384,221,45,245,278,22.1,1611.6,blue,2.4,1.83,26,16,blue
4456309511,8,8,7,1,0,1,1,17676,7,18151,206,32,393,-215,20.6,1767.6,8,8,9,1,1,0,0,17283,7,18366,223,46,-393,215,22.3,1728.3,red,1.88,2.12,16,17,blue
4517825338,7,2,6,0,0,0,0,17423,7.4,19973,248,55,2822,2207,24.8,1742.3,2,7,2,1,1,0,0,14601,7,17766,219,64,-2822,-2207,21.9,1460.1,blue,6.5,0.57,20,27,blue
4522021441,1,10,0,0,0,0,0,13410,6.4,16059,210,52,-5025,-2610,21,1341,10,1,16,1,1,0,0,18435,7.2,18669,228,58,5025,2610,22.8,1843.5,red,0.1,26,14,23,red
4516557839,7,8,8,0,0,0,0,16992,7,18385,219,44,-371,-172,21.9,1699.2,8,7,7,1,1,0,0,17363,7.2,18557,225,65,371,172,22.5,1736.3,blue,1.88,2.14,21,33,red
4519886299,8,4,10,2,1,1,1,18678,7,18538,231,56,3999,2223,23.1,1867.8,4,8,5,0,0,0,0,14679,6.6,16315,193,42,-3999,-2223,19.3,1467.9,blue,4.5,1.12,20,14,blue
4470465305,5,12,12,0,0,0,0,16220,7,17906,222,66,-4157,-1724,22.2,1622,12,5,24,1,1,0,0,20377,7.4,19630,257,52,4157,1724,25.7,2037.7,red,1.42,7.2,23,16,red
4523482714,5,12,2,0,0,0,0,14930,6,15593,169,56,-5298,-4670,16.9,1493,12,5,14,1,1,0,0,20228,7.4,20263,242,52,5298,4670,24.2,2022.8,red,0.58,5.2,31,12,red
4520785581,7,8,7,0,0,0,0,16304,6.8,17825,201,51,-28,-63,20.1,1630.4,8,7,4,0,0,0,0,16332,6.8,17888,209,41,28,63,20.9,1633.2,red,1.75,1.71,14,15,red
4491168583,7,5,14,1,1,0,0,17075,7,18159,230,52,462,579,23,1707.5,5,7,6,0,0,0,0,16613,6.6,17580,224,51,-462,-579,22.4,1661.3,blue,4.2,1.57,55,21,red
4501782812,5,3,5,0,0,0,0,15499,7,17516,225,47,-81,-1,22.5,1549.9,3,5,3,1,1,0,0,15580,6.8,17517,214,60,81,1,21.4,1558,red,3.33,1.2,20,20,red
4521124599,6,4,9,2,1,1,0,16972,7.4,19577,218,55,752,344,21.8,1697.2,4,6,3,0,0,0,0,16220,7.2,19233,247,68,-752,-344,24.7,1622,blue,3.75,1.17,17,16,blue
4501847669,6,10,5,0,0,0,0,15256,6.6,16464,189,28,-1555,-357,18.9,1525.6,10,6,12,1,1,0,0,16811,6.8,16821,182,45,1555,357,18.2,1681.1,red,1.1,3.67,16,19,red
4469793505,6,3,9,0,0,0,0,16568,7.2,18645,197,52,1188,2039,19.7,1656.8,3,6,4,2,1,1,0,15380,6.8,16606,207,52,-1188,-2039,20.7,1538,blue,5,1.17,17,22,red
4524882681,7,3,10,1,0,1,0,17326,7.2,18459,224,56,1639,-213,22.4,1732.6,3,7,3,1,1,0,0,15687,7,18672,248,68,-1639,213,24.8,1568.7,blue,5.67,0.86,15,19,blue
4520333259,6,4,7,0,0,0,0,16619,7.2,18958,226,51,1552,1488,22.6,1661.9,4,6,5,0,0,0,0,15067,6.8,17470,213,52,-1552,-1488,21.3,1506.7,blue,3.25,1.5,21,35,red
4511049704,4,5,4,0,0,0,0,16295,7.2,18278,261,36,41,-936,26.1,1629.5,5,4,5,1,1,0,0,16254,7.2,19214,234,64,-41,936,23.4,1625.4,red,1.6,2.5,18,58,red
4488805966,7,4,7,1,1,0,0,15680,6.6,17099,186,52,-259,-1115,18.6,1568,4,7,4,0,0,0,0,15939,7,18214,227,51,259,1115,22.7,1593.9,blue,3.5,1.14,14,38,blue
4452201690,7,7,8,0,0,0,0,16432,6.8,16967,191,36,367,-1025,19.1,1643.2,7,7,7,1,1,0,0,16065,7,17992,212,47,-367,1025,21.2,1606.5,red,2.14,2,16,34,blue
4523749055,10,6,9,2,1,1,2,19197,7.2,18449,219,53,2941,1850,21.9,1919.7,6,10,6,0,0,0,0,16256,6.6,16599,192,52,-2941,-1850,19.2,1625.6,blue,3.17,1.2,18,21,red
4520672989,10,7,8,1,1,0,0,18468,7.2,18822,221,51,1142,283,22.1,1846.8,7,10,6,0,0,0,0,17326,7.2,18539,252,40,-1142,-283,25.2,1732.6,blue,2.57,1.3,17,21,blue
4447744489,9,5,10,0,0,0,0,18280,7,18115,229,35,4051,1394,22.9,1828,5,9,3,1,1,0,0,14229,6.6,16721,211,36,-4051,-1394,21.1,1422.9,blue,3.8,0.89,22,24,blue
4495628923,5,9,7,0,0,0,0,16103,6.6,17019,193,48,-2419,-1437,19.3,1610.3,9,5,14,1,0,1,0,18522,7,18456,246,40,2419,1437,24.6,1852.2,blue,1.33,4.6,22,55,red
4423079773,6,4,8,2,1,1,0,16832,7.2,18675,221,65,1624,1008,22.1,1683.2,4,6,5,0,0,0,0,15208,7,17667,238,33,-1624,-1008,23.8,1520.8,blue,3.5,1.5,20,18,blue
4525132026,3,8,5,1,1,0,0,15028,6.8,17228,232,40,-2254,-379,23.2,1502.8,8,3,8,0,0,0,0,17282,7,17607,232,48,2254,379,23.2,1728.2,red,1,5.33,37,21,red
4496068567,9,5,6,1,0,1,0,17076,7.2,18945,194,54,834,1853,19.4,1707.6,5,9,2,0,0,0,0,16242,6.6,17092,238,36,-834,-1853,23.8,1624.2,blue,3,0.78,15,16,blue
4503581851,7,4,6,0,0,0,0,16745,6.8,17283,210,35,2150,1104,21,1674.5,4,7,3,0,0,0,0,14595,6.6,16179,187,50,-2150,-1104,18.7,1459.5,blue,3.25,1,22,18,blue
4487682437,4,8,4,1,0,1,0,15658,6.6,17351,222,42,-1624,-2019,22.2,1565.8,8,4,8,1,1,0,0,17282,7.4,19370,207,61,1624,2019,20.7,1728.2,blue,1,4,17,17,red
4522601475,6,5,6,1,0,1,0,15760,7.2,18719,167,72,-2072,412,16.7,1576,5,6,2,1,1,0,1,17832,7,18307,268,51,2072,-412,26.8,1783.2,blue,2.4,1.17,8,18,blue
4496837103,2,7,3,1,0,1,0,14624,6.8,16881,210,57,-2089,537,21,1462.4,7,2,10,0,0,0,0,16713,6.6,16344,215,38,2089,-537,21.5,1671.3,red,0.71,8.5,15,44,red
4497765026,2,3,1,0,0,0,0,15568,7,18302,245,48,542,1212,24.5,1556.8,3,2,4,1,1,0,0,15026,6.6,17090,209,62,-542,-1212,20.9,1502.6,blue,1,3.5,14,17,red
4438388290,6,7,4,1,0,1,0,16331,7.2,17920,231,49,-226,-221,23.1,1633.1,7,6,7,0,0,0,0,16557,7,18141,226,54,226,221,22.6,1655.7,red,1.43,2.33,19,40,red
4524881998,7,5,7,2,1,1,0,17204,7.4,18986,240,60,316,10,24,1720.4,5,7,4,0,0,0,0,16888,7,18976,236,48,-316,-10,23.6,1688.8,blue,2.8,1.29,34,37,blue
4495074549,3,6,3,0,0,0,0,14910,6.6,15466,195,36,-821,-2540,19.5,1491,6,3,4,1,1,0,0,15731,6.8,18006,206,67,821,2540,20.6,1573.1,red,1,3.33,20,47,blue
4518759823,12,5,15,1,1,0,0,19141,7.6,20647,192,60,4294,4438,19.2,1914.1,5,12,3,0,0,0,0,14847,6.4,16209,210,36,-4294,-4438,21,1484.7,blue,5.4,0.67,40,17,blue
4481631636,2,8,1,0,0,0,0,14208,7,17036,194,64,-4891,-2335,19.4,1420.8,8,2,8,1,0,1,1,19099,7.2,19371,266,40,4891,2335,26.6,1909.9,red,0.38,8,23,21,red
4490315006,9,4,7,1,1,0,0,17951,6.8,18031,234,44,3432,2317,23.4,1795.1,4,9,9,0,0,0,0,14519,6.4,15714,183,45,-3432,-2317,18.3,1451.9,blue,4,1.44,24,17,red
4521403114,7,8,8,1,1,0,0,16142,6.8,17610,197,62,-563,-812,19.7,1614.2,8,7,12,0,0,0,0,16705,7,18422,207,48,563,812,20.7,1670.5,blue,1.88,2.86,17,28,blue
4521688394,4,4,5,0,0,0,0,16333,7.2,19527,237,65,60,-341,23.7,1633.3,4,4,3,1,1,0,0,16273,7.6,19868,252,80,-60,341,25.2,1627.3,blue,2.25,1.75,19,28,red
4501386832,8,2,11,0,0,0,0,17526,6.8,17824,222,63,2761,680,22.2,1752.6,2,8,2,1,1,0,0,14765,6.8,17144,216,64,-2761,-680,21.6,1476.5,red,9.5,0.5,20,16,blue
4515233268,7,7,7,2,1,1,0,17381,7.2,20017,221,76,1542,2179,22.1,1738.1,7,7,4,0,0,0,0,15839,7,17838,204,48,-1542,-2179,20.4,1583.9,blue,2,1.57,18,19,blue
4522201208,5,3,5,1,0,1,1,17854,7.4,20383,230,56,2323,2120,23,1785.4,3,5,2,0,0,0,0,15531,7,18263,219,52,-2323,-2120,21.9,1553.1,red,3.33,1,36,14,red
4515342785,6,5,4,1,1,0,0,15698,7,17468,206,59,-1143,-859,20.6,1569.8,5,6,3,1,0,1,0,16841,7,18327,259,50,1143,859,25.9,1684.1,red,2,1.33,17,16,blue
4483621634,6,7,4,0,0,0,0,16039,7,17942,195,49,-665,-571,19.5,1603.9,7,6,5,1,1,0,0,16704,7,18513,231,52,665,571,23.1,1670.4,blue,1.43,2,22,19,red
4519595865,3,8,4,1,0,1,0,14506,6.8,16989,206,52,-2520,-1932,20.6,1450.6,8,3,7,1,1,0,0,17026,7.2,18921,221,56,2520,1932,22.1,1702.6,red,0.88,5,21,17,red
4497520104,6,6,6,0,0,0,0,16830,7,18944,226,51,708,1208,22.6,1683,6,6,4,2,1,1,0,16122,6.8,17736,204,54,-708,-1208,20.4,1612.2,blue,2,1.67,143,20,red
4483310485,2,1,3,1,1,0,0,14909,7,18031,245,52,410,720,24.5,1490.9,1,2,1,0,0,0,0,14499,6.8,17311,237,52,-410,-720,23.7,1449.9,blue,5,1,21,17,red
4514522984,0,5,0,0,0,0,0,12939,6.4,15958,201,32,-4578,-3673,20.1,1293.9,5,0,5,1,1,0,0,17517,7.4,19631,259,79,4578,3673,25.9,1751.7,blue,0,12.65,17,21,red
4495304851,8,6,3,0,0,0,0,16678,7,18875,216,64,1079,1586,21.6,1667.8,6,8,3,1,1,0,0,15599,6.8,17289,220,32,-1079,-1586,22,1559.9,red,1.83,1.12,16,20,red
4504908173,5,14,3,0,0,0,0,15322,6.4,15807,210,56,-4024,-2373,21,1532.2,14,5,17,1,1,0,0,19346,6.8,18180,203,47,4024,2373,20.3,1934.6,red,0.57,6.2,12,20,red
4520894516,5,7,4,0,0,0,0,16562,7.2,18781,210,64,44,170,21,1656.2,7,5,8,1,1,0,0,16518,7,18611,245,36,-44,-170,24.5,1651.8,red,1.29,3,42,22,blue
4520635728,6,8,5,1,0,1,0,16353,7,18367,214,56,-560,-46,21.4,1635.3,8,6,10,1,1,0,0,16913,7.4,18413,221,44,560,46,22.1,1691.3,blue,1.38,3,17,18,blue
4506495968,7,11,6,1,0,1,0,16998,6.6,17282,207,55,-1343,-591,20.7,1699.8,11,7,15,1,1,0,0,18341,6.8,17873,191,40,1343,591,19.1,1834.1,red,1.18,3.71,10,21,red
4464777980,5,5,7,1,1,0,0,15051,6.6,16743,188,35,60,323,18.8,1505.1,5,5,4,0,0,0,0,14991,6.8,16420,206,44,-60,-323,20.6,1499.1,red,2.4,1.8,21,13,red
4523251665,3,6,6,0,0,0,0,14986,6.8,17222,208,46,-1501,-1478,20.8,1498.6,6,3,4,0,0,0,0,16487,7.2,18700,220,49,1501,1478,22,1648.7,red,1.5,3.33,51,21,red
4513442931,7,5,9,0,0,0,0,17003,6.6,18007,214,40,1331,1287,21.4,1700.3,5,7,8,0,0,0,0,15672,6.8,16720,190,52,-1331,-1287,19,1567.2,red,3.2,1.86,44,17,blue
4463059486,4,12,5,1,1,0,0,15380,6.6,15984,226,43,-4864,-2818,22.6,1538,12,4,17,1,0,1,2,20244,7.2,18802,231,36,4864,2818,23.1,2024.4,red,0.75,7.25,19,19,red
4511735384,9,3,8,2,1,1,0,18599,7.2,20735,216,76,3821,4288,21.6,1859.9,3,9,5,0,0,0,0,14778,6.8,16447,187,56,-3821,-4288,18.7,1477.8,blue,5.67,0.89,17,35,blue
4524160140,6,7,6,0,0,0,0,15936,6.8,17755,192,46,-1477,-1018,19.2,1593.6,7,6,10,1,1,0,0,17413,7,18773,245,53,1477,1018,24.5,1741.3,blue,1.71,2.83,15,18,red
4452237596,3,2,2,0,0,0,0,15265,6.8,17859,224,52,446,263,22.4,1526.5,2,3,1,0,0,0,0,14819,6.6,17596,237,45,-446,-263,23.7,1481.9,blue,2.5,1,17,15,blue
4506113510,10,3,12,1,1,0,0,18177,7,18965,219,50,3504,995,21.9,1817.7,3,10,4,0,0,0,0,14673,6.8,17970,214,46,-3504,-995,21.4,1467.3,blue,7.33,0.7,17,19,blue
4520650445,7,5,12,1,0,1,0,16605,6.6,16894,220,39,2046,584,22,1660.5,5,7,9,1,1,0,0,14559,6.6,16310,175,44,-2046,-584,17.5,1455.9,red,3.8,2,21,25,red
4420437374,4,3,3,0,0,0,0,14742,6.8,17515,203,40,-541,-1094,20.3,1474.2,3,4,5,2,1,1,0,15283,7.2,18609,230,60,541,1094,23,1528.3,red,2.33,2,19,20,blue
4465091109,3,8,1,0,0,0,0,14440,7,17275,194,60,-3132,-1630,19.4,1444,8,3,6,1,1,0,0,17572,7,18905,220,50,3132,1630,22,1757.2,red,0.5,4.67,13,19,red
4452001720,2,13,3,0,0,0,0,12798,5.4,12111,187,4,-8472,-8242,18.7,1279.8,13,2,16,1,1,0,1,21270,7.6,20353,224,64,8472,8242,22.4,2127,red,0.38,14.5,17,17,red
4517686299,5,6,6,0,0,0,0,15698,6.6,17663,201,63,-687,-372,20.1,1569.8,6,5,8,1,1,0,0,16385,7,18035,230,43,687,372,23,1638.5,red,1.83,2.8,18,26,red
4524698589,7,2,7,1,1,0,0,17324,7.2,19349,216,48,3129,2922,21.6,1732.4,2,7,3,0,0,0,0,14195,6.8,16427,208,47,-3129,-2922,20.8,1419.5,blue,7,0.71,83,18,blue
4478918776,2,4,5,1,0,1,0,14613,6.8,17026,233,47,-2539,-943,23.3,1461.3,4,2,7,1,1,0,0,17152,7,17969,234,47,2539,943,23.4,1715.2,red,1.75,5.5,13,18,red
4518368417,4,5,4,0,0,0,0,14705,6.6,16663,196,44,-2167,-2507,19.6,1470.5,5,4,6,1,1,0,0,16872,7.2,19170,240,65,2167,2507,24,1687.2,red,1.6,2.75,15,18,blue
4487456685,8,5,10,0,0,0,0,17536,7.2,19665,247,47,910,1269,24.7,1753.6,5,8,6,1,1,0,0,16626,7,18396,226,68,-910,-1269,22.6,1662.6,blue,3.6,1.38,19,21,red
4508403926,5,5,3,1,0,1,0,15226,6.6,17298,213,55,-521,-1275,21.3,1522.6,5,5,3,1,1,0,0,15747,7.2,18573,236,48,521,1275,23.6,1574.7,red,1.6,1.6,16,13,red
4502937096,6,5,5,0,0,0,0,16051,7,17771,197,41,523,-1060,19.7,1605.1,5,6,4,1,1,0,0,15528,7.2,18831,226,54,-523,1060,22.6,1552.8,red,2.2,1.5,15,20,blue
4521579265,3,4,4,0,0,0,0,15158,6.8,17197,236,47,-341,-1982,23.6,1515.8,4,3,5,2,1,1,0,15499,7,19179,219,56,341,1982,21.9,1549.9,blue,1.75,3,18,21,red
4518125145,8,8,13,0,0,0,0,16934,6.4,16045,193,44,247,-775,19.3,1693.4,8,8,6,1,1,0,0,16687,6.6,16820,191,56,-247,775,19.1,1668.7,red,2.62,1.75,19,16,blue
4454573791,4,8,7,1,0,1,0,15228,6.8,16963,198,52,-2236,-2070,19.8,1522.8,8,4,8,1,1,0,0,17464,7.2,19033,227,48,2236,2070,22.7,1746.4,red,1.38,4,27,25,blue
4521700370,10,4,7,0,0,0,0,17710,7,18758,205,56,3297,2983,20.5,1771,4,10,3,1,1,0,0,14413,6.4,15775,183,44,-3297,-2983,18.3,1441.3,blue,4.25,0.7,18,17,blue
4510866403,2,3,2,0,0,0,0,14971,7,18121,228,49,-682,-89,22.8,1497.1,3,2,5,1,1,0,0,15653,7.2,18210,252,49,682,89,25.2,1565.3,red,1.33,4,18,22,red
4522684962,10,5,10,1,0,1,0,17835,7.2,18036,205,50,1923,437,20.5,1783.5,5,10,5,0,0,0,0,15912,6.8,17599,216,43,-1923,-437,21.6,1591.2,red,4,1,24,20,red
4463456988,7,3,4,2,1,1,0,17071,7.2,19347,234,64,1738,2447,23.4,1707.1,3,7,2,0,0,0,0,15333,6.8,16900,226,57,-1738,-2447,22.6,1533.3,blue,3.67,0.71,18,19,red
4518358306,6,11,10,1,1,0,0,16245,7,18044,208,50,-3451,-2220,20.8,1624.5,11,6,10,1,0,1,0,19696,7.6,20264,235,59,3451,2220,23.5,1969.6,red,1.45,3.5,46,31,red
4513008281,6,2,6,0,0,0,0,16835,7,17368,235,42,2251,-284,23.5,1683.5,2,6,2,2,1,1,0,14584,7,17652,248,49,-2251,284,24.8,1458.4,red,6,0.67,20,91,blue
4432115286,6,9,8,0,0,0,0,17088,7.2,18768,226,67,-884,963,22.6,1708.8,9,6,15,2,1,1,0,17972,6.8,17805,218,48,884,-963,21.8,1797.2,red,1.56,4,20,21,blue
4502817224,5,4,7,1,1,0,0,16383,7.2,19209,223,56,864,898,22.3,1638.3,4,5,2,0,0,0,0,15519,7,18311,246,45,-864,-898,24.6,1551.9,red,3,1.2,14,17,red
4479373618,4,2,2,1,1,0,1,16577,6.8,17637,220,58,1830,-1232,22,1657.7,2,4,1,1,0,1,0,14747,7,18869,219,66,-1830,1232,21.9,1474.7,blue,3,0.75,22,21,blue
4501993937,12,5,19,1,1,0,0,19607,7.6,19804,221,44,3913,2948,22.1,1960.7,5,12,7,0,0,0,0,15694,6.6,16856,220,52,-3913,-2948,22,1569.4,blue,6.2,1,62,19,blue
4519007166,8,9,7,2,1,1,0,15775,6.6,17200,149,47,-2675,-1325,14.9,1577.5,9,8,11,0,0,0,0,18450,7,18525,231,42,2675,1325,23.1,1845,blue,1.67,2.5,21,23,blue
4521254867,4,8,4,2,1,1,0,14998,6.6,16127,185,45,-1430,147,18.5,1499.8,8,4,7,0,0,0,0,16428,6.6,15980,196,48,1430,-147,19.6,1642.8,red,1,3.75,14,15,blue
4472127504,8,8,10,2,1,1,0,16906,6.8,17910,207,48,226,221,20.7,1690.6,8,8,4,0,0,0,0,16680,6.8,17689,176,54,-226,-221,17.6,1668,red,2.25,1.5,21,18,blue
4479722727,9,3,8,2,1,1,1,18743,7,18381,209,49,4324,1705,20.9,1874.3,3,9,1,0,0,0,0,14419,6.6,16676,191,56,-4324,-1705,19.1,1441.9,blue,5.67,0.44,19,19,blue
4447477693,8,8,11,0,0,0,0,16634,7,17892,198,40,-355,279,19.8,1663.4,8,8,7,0,0,0,0,16989,6.8,17613,195,44,355,-279,19.5,1698.9,red,2.38,1.88,20,41,red
4472428830,3,8,4,0,0,0,0,13636,6.2,14432,177,35,-4529,-4665,17.7,1363.6,8,3,7,2,1,1,0,18165,7.4,19097,249,60,4529,4665,24.9,1816.5,red,0.88,5,71,39,red
4524480433,3,10,1,1,1,0,0,13744,6.4,15449,167,50,-4663,-3624,16.7,1374.4,10,3,11,0,0,0,0,18407,7.2,19073,219,44,4663,3624,21.9,1840.7,red,0.4,7,14,17,blue
4522555214,4,4,9,1,1,0,0,15823,6.8,17501,230,46,-211,-1817,23,1582.3,4,4,4,0,0,0,0,16034,7.2,19318,233,64,211,1817,23.3,1603.4,red,3.25,2,17,40,blue
4449686178,7,6,6,1,1,0,0,16356,7.2,19371,219,47,38,1241,21.9,1635.6,6,7,5,1,0,1,0,16318,7,18130,226,40,-38,-1241,22.6,1631.8,blue,2.17,1.57,39,13,blue
4465356930,11,9,14,1,0,1,1,19801,6.6,17196,195,55,3315,904,19.5,1980.1,9,11,12,1,1,0,0,16486,6.4,16292,147,45,-3315,-904,14.7,1648.6,red,2.78,1.91,21,18,red
4506680103,11,9,12,0,0,0,0,18200,7,17815,202,39,1211,-757,20.2,1820,9,11,10,1,1,0,0,16989,7.2,18572,211,60,-1211,757,21.1,1698.9,red,2.56,1.73,20,21,blue
4456179027,4,3,2,0,0,0,0,15335,6.8,18648,230,40,-188,270,23,1533.5,3,4,2,1,1,0,0,15523,7,18378,248,60,188,-270,24.8,1552.3,red,2,1.25,55,14,red
4487676643,6,4,4,0,0,0,0,16792,7.2,18901,238,52,1852,2113,23.8,1679.2,4,6,5,0,0,0,0,14940,6.6,16788,218,40,-1852,-2113,21.8,1494,blue,2.5,1.5,17,21,blue
4473506921,12,8,13,1,1,0,1,20086,7,18345,232,44,3059,1408,23.2,2008.6,8,12,8,1,0,1,0,17027,6.4,16937,207,56,-3059,-1408,20.7,1702.7,red,3.12,1.33,17,21,blue
4521783603,1,4,1,0,0,0,0,13858,6.4,16054,232,45,-2552,-2268,23.2,1385.8,4,1,6,2,1,1,0,16410,7,18322,239,63,2552,2268,23.9,1641,red,0.5,10,20,15,red
4519169222,5,7,9,0,0,0,0,16190,7,17505,222,53,-1566,-1852,22.2,1619,7,5,6,1,1,0,0,17756,7.2,19357,258,62,1566,1852,25.8,1775.6,red,2,2.6,55,20,blue
4493402938,7,10,5,0,0,0,0,16112,7,18155,202,42,-2967,-758,20.2,1611.2,10,7,10,0,0,0,0,19079,7.2,18913,238,45,2967,758,23.8,1907.9,red,1.2,2.86,15,16,blue
4523323599,9,11,10,1,0,1,0,17298,6.8,17146,198,40,-98,-169,19.8,1729.8,11,9,13,1,1,0,0,17396,7,17315,182,36,98,169,18.2,1739.6,blue,1.73,2.67,30,52,red
4512807335,2,4,3,0,0,0,0,14593,6.6,17874,240,38,-1972,-1177,24,1459.3,4,2,5,0,0,0,0,16565,7.2,19051,253,64,1972,1177,25.3,1656.5,red,1.25,4.5,14,14,red
4510691546,10,8,17,1,1,0,0,17723,6.8,17913,201,54,557,-1383,20.1,1772.3,8,10,9,0,0,0,0,17166,7.4,19296,204,68,-557,1383,20.4,1716.6,blue,3.38,1.7,16,15,blue
4450170058,8,3,11,1,0,1,0,16565,6.8,17417,204,45,1217,309,20.4,1656.5,3,8,2,0,0,0,0,15348,6.6,17108,214,45,-1217,-309,21.4,1534.8,red,6.33,0.62,23,78,blue
4497712191,4,5,7,0,0,0,0,16301,7.2,19215,254,62,-27,394,25.4,1630.1,5,4,6,1,1,0,0,16328,7.2,18821,234,46,27,-394,23.4,1632.8,blue,2.2,2.75,17,20,red
4524932561,6,5,5,1,0,1,0,16698,7.2,19972,238,59,865,2685,23.8,1669.8,5,6,8,1,1,0,0,15833,6.8,17287,213,48,-865,-2685,21.3,1583.3,blue,2.2,2.17,19,26,blue
4520745739,1,4,1,0,0,0,0,14878,7,18414,235,60,-1653,-1289,23.5,1487.8,4,1,4,1,1,0,0,16531,7.2,19703,258,64,1653,1289,25.8,1653.1,red,0.5,8,13,14,red
4490937979,5,3,3,1,1,0,0,16494,7,19149,255,66,1932,2097,25.5,1649.4,3,5,3,0,0,0,0,14562,6.6,17052,182,52,-1932,-2097,18.2,1456.2,red,2.67,1.2,20,17,red
4524927159,5,9,4,0,0,0,0,15463,7,17005,206,60,-3386,-2729,20.6,1546.3,9,5,13,0,0,0,0,18849,7,19734,234,51,3386,2729,23.4,1884.9,red,1,4.4,15,19,blue
4495222052,6,15,9,0,0,0,0,15435,6.6,15816,161,40,-5097,-3482,16.1,1543.5,15,6,16,1,1,0,0,20532,7.4,19298,226,44,5097,3482,22.6,2053.2,red,1,5.17,17,20,red
4502309990,5,1,8,2,1,1,0,16165,6.8,18233,215,67,1321,1735,21.5,1616.5,1,5,2,0,0,0,0,14844,6.6,16498,245,56,-1321,-1735,24.5,1484.4,red,13,0.6,55,16,blue
4524336258,6,6,9,1,1,0,0,16640,7.2,17949,233,50,-276,-1424,23.3,1664,6,6,8,0,0,0,0,16916,7.4,19373,220,59,276,1424,22,1691.6,red,2.5,2.33,15,24,blue
4483668263,6,4,6,1,0,1,0,16422,7,17507,212,53,-19,-1122,21.2,1642.2,4,6,2,0,0,0,0,16441,7,18629,256,68,19,1122,25.6,1644.1,red,3,1,13,12,blue
4446171042,8,4,7,0,0,0,0,17863,7.2,19086,256,33,2590,1850,25.6,1786.3,4,8,4,0,0,0,0,15273,7,17236,218,48,-2590,-1850,21.8,1527.3,blue,3.75,1,20,18,blue
4503175131,8,6,8,0,0,0,0,16970,6.8,17201,226,45,510,-601,22.6,1697,6,8,10,1,1,0,0,16460,6.8,17802,230,48,-510,601,23,1646,red,2.67,2,22,30,blue
4508573055,4,2,7,0,0,0,0,14866,6.8,17470,191,51,103,412,19.1,1486.6,2,4,3,1,0,1,0,14763,6.8,17058,239,41,-103,-412,23.9,1476.3,red,5.5,1.25,27,27,red
4479801050,9,10,10,0,0,0,0,17761,7,18196,229,48,-237,-500,22.9,1776.1,10,9,13,1,1,0,0,17998,7.2,18696,200,60,237,500,20,1799.8,blue,1.9,2.56,14,21,blue
4519375393,7,4,5,0,0,0,0,16650,7,18854,233,48,-612,549,23.3,1665,4,7,5,2,1,1,1,17262,7,18305,232,59,612,-549,23.2,1726.2,blue,3,1.29,16,20,red
4512258772,8,1,6,1,0,1,0,18607,7.4,20228,264,53,4488,3191,26.4,1860.7,1,8,1,1,1,0,0,14119,6.6,17037,210,60,-4488,-3191,21,1411.9,red,14,0.25,22,16,blue
4494864543,8,5,6,0,0,0,0,16237,6.8,17830,209,48,335,675,20.9,1623.7,5,8,5,1,1,0,0,15902,6.8,17155,192,64,-335,-675,19.2,1590.2,red,2.8,1.25,20,17,red
4505104958,2,3,2,1,1,0,0,14273,6.8,17164,220,40,-814,-418,22,1427.3,3,2,2,1,0,1,0,15087,6.6,17582,224,44,814,418,22.4,1508.7,red,1.33,2.5,20,13,red
4514431388,6,5,7,1,1,0,0,15906,7,17700,232,39,-39,464,23.2,1590.6,5,6,9,0,0,0,0,15945,6.6,17236,197,45,39,-464,19.7,1594.5,blue,2.6,2.33,19,18,blue
4513352439,4,5,3,0,0,0,0,16083,6.8,18268,264,53,80,-609,26.4,1608.3,5,4,8,1,1,0,0,16003,7.2,18877,225,53,-80,609,22.5,1600.3,blue,1.4,3.25,25,69,blue
4515442346,2,8,2,2,1,1,0,15034,7,17176,204,77,-1975,-888,20.4,1503.4,8,2,11,0,0,0,0,17009,7,18064,201,44,1975,888,20.1,1700.9,red,0.5,9.5,18,19,red
4524409899,5,3,7,0,0,0,0,16660,7.2,18967,257,52,1723,970,25.7,1666,3,5,5,2,1,1,0,14937,7,17997,227,52,-1723,-970,22.7,1493.7,red,4,1.6,17,39,blue
4444371751,5,9,2,1,1,0,0,13945,5.8,14302,155,56,-5763,-4731,15.5,1394.5,9,5,11,1,0,1,2,19708,7.4,19033,203,60,5763,4731,20.3,1970.8,red,0.78,4,18,16,blue
4513965875,3,13,6,0,0,0,0,14991,6.6,17279,207,53,-6050,-4081,20.7,1499.1,13,3,16,0,0,0,0,21041,7.6,21360,273,60,6050,4081,27.3,2104.1,red,0.69,9.67,27,38,red
4520923371,3,3,6,1,1,0,0,16653,7,18507,261,60,1152,-29,26.1,1665.3,3,3,6,0,0,0,0,15501,7.2,18536,228,60,-1152,29,22.8,1550.1,red,3,3,41,17,blue
4523763219,7,2,9,1,0,1,0,17557,7,18193,209,64,3822,2980,20.9,1755.7,2,7,1,0,0,0,0,13735,6,15213,224,24,-3822,-2980,22.4,1373.5,blue,8,0.43,20,20,blue
4521104135,4,8,4,1,1,0,0,14439,6.6,16198,196,41,-2975,-2024,19.6,1443.9,8,4,10,0,0,0,0,17414,7,18222,235,40,2975,2024,23.5,1741.4,red,1,4.5,16,40,red
4510666820,12,5,18,1,1,0,0,18567,7,18176,227,40,1526,472,22.7,1856.7,5,12,7,0,0,0,0,17041,6.8,17704,203,56,-1526,-472,20.3,1704.1,blue,6,1,42,18,blue
4524932837,9,1,9,1,1,0,0,17079,7,17962,229,44,3916,2599,22.9,1707.9,1,9,0,0,0,0,0,13163,6.6,15363,191,44,-3916,-2599,19.1,1316.3,blue,18,0.11,20,16,blue
4469723831,6,1,2,2,1,1,3,21051,7.4,20745,276,70,8776,8348,27.6,2105.1,1,6,1,0,0,0,0,12275,5.4,12397,176,20,-8776,-8348,17.6,1227.5,blue,8,0.33,14,15,blue
4499740164,8,10,4,0,0,0,0,15229,6.4,16071,213,4,-4493,-3830,21.3,1522.9,10,8,10,2,1,1,1,19722,7.4,19901,218,68,4493,3830,21.8,1972.2,red,1.2,2.5,16,15,red
4500544230,5,4,3,1,1,0,0,16490,7,18411,214,55,1018,-1023,21.4,1649,4,5,2,1,0,1,0,15472,7.2,19434,204,64,-1018,1023,20.4,1547.2,blue,2,1.2,17,13,blue
4525140164,8,9,7,0,0,0,0,17047,7,17601,200,47,-97,165,20,1704.7,9,8,6,1,1,0,0,17144,6.8,17436,198,48,97,-165,19.8,1714.4,blue,1.67,1.88,16,19,blue
4487935586,4,6,4,0,0,0,0,14844,7,17089,187,51,-933,-636,18.7,1484.4,6,4,6,1,0,1,0,15777,7,17725,217,31,933,636,21.7,1577.7,red,1.33,3,43,20,red
4523954840,8,10,10,0,0,0,0,16382,7.2,18090,206,37,-4322,-1588,20.6,1638.2,10,8,8,1,0,1,1,20704,7.2,19678,244,60,4322,1588,24.4,2070.4,red,1.8,2.25,19,17,red
4485823957,7,4,11,0,0,0,0,18113,7.2,19187,231,49,1350,524,23.1,1811.3,4,7,6,0,0,0,0,16763,7,18663,262,65,-1350,-524,26.2,1676.3,blue,4.5,1.43,26,21,red
4525145899,1,9,0,0,0,0,0,13933,6.6,16583,194,51,-5490,-2476,19.4,1393.3,9,1,8,1,1,0,1,19423,7.2,19059,225,52,5490,2476,22.5,1942.3,red,0.11,17,34,20,red
4459553176,8,8,9,1,1,0,0,16352,6.8,17749,214,36,-730,58,21.4,1635.2,8,8,10,0,0,0,0,17082,7,17691,191,50,730,-58,19.1,1708.2,red,2.12,2.25,21,17,red
4462400484,2,2,0,0,0,0,0,15098,7,19226,239,64,-631,337,23.9,1509.8,2,2,2,1,1,0,0,15729,7.2,18889,258,76,631,-337,25.8,1572.9,blue,1,2,14,25,blue
4522561203,5,4,4,1,0,1,0,16384,7.4,18938,244,50,-183,254,24.4,1638.4,4,5,3,1,1,0,0,16567,7,18684,243,60,183,-254,24.3,1656.7,red,2.25,1.4,38,21,blue
4512990467,7,11,9,1,0,1,0,17132,6.6,16777,198,56,-2250,-1591,19.8,1713.2,11,7,17,1,1,0,0,19382,7,18368,196,52,2250,1591,19.6,1938.2,red,1.45,4,21,22,blue
4453522690,5,3,6,1,1,0,0,16116,6.8,18086,249,60,493,-699,24.9,1611.6,3,5,3,0,0,0,0,15623,7.2,18785,250,48,-493,699,25,1562.3,red,3.67,1.2,26,48,blue
4525240848,7,7,11,0,0,0,0,17201,7,18871,230,49,-211,-626,23,1720.1,7,7,10,1,1,0,0,17412,7.2,19497,222,68,211,626,22.2,1741.2,red,2.57,2.43,23,18,blue
4518457045,3,6,4,0,0,0,0,15224,7,18728,228,49,-1611,97,22.8,1522.4,6,3,11,0,0,0,0,16835,7.2,18631,247,44,1611,-97,24.7,1683.5,blue,1.17,5.67,18,45,red
4494818793,6,8,3,0,0,0,0,15334,6.4,16172,203,44,-1343,-768,20.3,1533.4,8,6,5,1,1,0,0,16677,6.6,16940,204,36,1343,768,20.4,1667.7,red,1.12,2.17,18,24,red
4436503508,12,3,17,2,1,1,1,21016,7.4,20144,272,59,5512,3244,27.2,2101.6,3,12,6,0,0,0,0,15504,6.6,16900,212,56,-5512,-3244,21.2,1550.4,blue,9.67,0.75,21,51,blue
4520304212,7,13,9,0,0,0,0,15812,6.8,17646,186,47,-3590,-1683,18.6,1581.2,13,7,10,1,1,0,0,19402,7.2,19329,216,52,3590,1683,21.6,1940.2,red,1.23,3.29,19,18,red
4478553958,5,5,10,1,0,1,0,15447,6.2,15691,194,44,-406,-1748,19.4,1544.7,5,5,6,0,0,0,0,15853,7,17439,219,50,406,1748,21.9,1585.3,blue,3,2.2,22,17,blue
4524476983,5,11,6,0,0,0,0,15812,6.6,16319,209,56,-2150,-1215,20.9,1581.2,11,5,18,1,1,0,0,17962,6.8,17534,175,66,2150,1215,17.5,1796.2,red,1,5.8,15,16,blue
4522530131,1,5,1,1,1,0,0,14301,6.8,17056,214,45,-679,-1331,21.4,1430.1,5,1,2,0,0,0,0,14980,7,18387,216,43,679,1331,21.6,1498,red,0.4,7,18,17,red
4506094664,2,10,1,1,0,1,0,14749,6.6,16489,204,51,-3114,-2569,20.4,1474.9,10,2,5,0,0,0,0,17863,7.2,19058,224,47,3114,2569,22.4,1786.3,blue,0.3,7.5,13,19,red
4515527726,7,6,6,0,0,0,0,17605,7.4,19964,254,64,1564,668,25.4,1760.5,6,7,3,1,1,0,0,16041,7.2,19296,214,44,-1564,-668,21.4,1604.1,blue,2.17,1.29,40,19,red
4495054674,5,9,5,1,1,0,0,15535,6.8,17403,207,53,-4205,-1540,20.7,1553.5,9,5,10,0,0,0,1,19740,7.4,18943,251,44,4205,1540,25.1,1974,red,1.11,3.8,58,24,red
4520676421,11,1,13,0,0,0,0,18761,7.2,19378,230,62,4172,1918,23,1876.1,1,11,1,0,0,0,0,14589,6.8,17460,259,47,-4172,-1918,25.9,1458.9,blue,24,0.18,49,16,blue
4523507584,8,12,5,1,1,0,0,16855,6.4,16841,216,44,-2672,-2811,21.6,1685.5,12,8,19,0,0,0,0,19527,7.4,19652,204,65,2672,2811,20.4,1952.7,blue,1.08,3.88,15,16,blue
4520799474,18,10,15,1,1,0,0,21352,7.6,20771,224,59,4287,3938,22.4,2135.2,10,18,11,0,0,0,0,17065,6.8,16833,135,35,-4287,-3938,13.5,1706.5,blue,3.3,1.17,12,13,blue
4519839148,5,1,7,1,1,0,0,15990,7.2,18712,221,54,811,881,22.1,1599,1,5,1,0,0,0,0,15179,7,17831,235,65,-811,-881,23.5,1517.9,red,12,0.4,18,18,blue
4523054451,5,4,3,1,1,0,0,15015,6.4,16819,184,47,-585,-809,18.4,1501.5,4,5,2,1,0,1,0,15600,6.8,17628,248,52,585,809,24.8,1560,blue,2,1.2,13,19,blue
4495272249,5,6,3,1,0,1,0,15432,6.6,16542,223,24,-1042,-2030,22.3,1543.2,6,5,8,1,1,0,0,16474,7,18572,221,64,1042,2030,22.1,1647.4,red,1.33,2.8,16,21,red
4514795179,4,3,4,0,0,0,0,15404,7,18235,236,51,163,1490,23.6,1540.4,3,4,3,1,1,0,0,15241,6.8,16745,238,43,-163,-1490,23.8,1524.1,red,2.67,1.5,20,21,red
4515979529,5,1,5,1,1,0,0,16224,7.2,18401,233,52,1697,1110,23.3,1622.4,1,5,1,0,0,0,0,14527,6.6,17291,238,60,-1697,-1110,23.8,1452.7,red,10,0.4,44,18,blue
4524895008,10,7,15,1,1,0,0,17437,7,17146,177,57,1059,180,17.7,1743.7,7,10,5,1,0,1,0,16378,6.8,16966,186,55,-1059,-180,18.6,1637.8,red,3.57,1.2,14,122,blue
4453712057,6,6,5,1,0,1,0,17783,7.6,19374,236,72,1498,149,23.6,1778.3,6,6,7,1,1,0,0,16285,7.4,19225,213,61,-1498,-149,21.3,1628.5,red,1.83,2.17,20,16,blue
4522776236,8,8,5,0,0,0,0,17618,7.2,19023,227,41,457,692,22.7,1761.8,8,8,5,1,1,0,0,17161,7,18331,225,49,-457,-692,22.5,1716.1,blue,1.62,1.62,17,18,red
4522859365,9,2,16,1,1,0,0,18984,7.4,20083,254,54,4620,2871,25.4,1898.4,2,9,3,0,0,0,0,14364,6.6,17212,171,59,-4620,-2871,17.1,1436.4,blue,12.5,0.56,21,18,red
4524945992,11,10,8,1,1,0,0,18104,6.8,17404,205,40,1117,-637,20.5,1810.4,10,11,6,0,0,0,0,16987,6.8,18041,168,41,-1117,637,16.8,1698.7,blue,1.9,1.45,13,17,blue
4513730011,5,6,2,0,0,0,0,17250,7,19462,251,68,929,1352,25.1,1725,6,5,9,1,1,0,0,16321,7.2,18110,211,44,-929,-1352,21.1,1632.1,blue,1.17,3,21,16,blue
4510706024,5,4,7,2,1,1,0,16222,7,18814,243,56,459,1309,24.3,1622.2,4,5,1,0,0,0,0,15763,7,17505,234,51,-459,-1309,23.4,1576.3,red,3,1,26,43,red
4467448834,3,8,2,0,0,0,0,15179,7,17994,238,47,-2537,-1603,23.8,1517.9,8,3,6,1,1,0,0,17716,7.2,19597,216,64,2537,1603,21.6,1771.6,red,0.62,4.67,31,19,red
4494522299,3,13,2,0,0,0,0,13896,5.6,13354,197,20,-4882,-4505,19.7,1389.6,13,3,18,1,1,0,0,18778,6.8,17859,204,57,4882,4505,20.4,1877.8,red,0.38,10.33,15,53,blue
4477077306,8,8,11,0,0,0,0,17911,6.8,17981,218,40,1014,688,21.8,1791.1,8,8,12,1,0,1,0,16897,6.6,17293,191,47,-1014,-688,19.1,1689.7,red,2.38,2.5,19,18,red
4488501189,11,5,10,0,0,0,0,18582,7,18818,217,39,3039,2255,21.7,1858.2,5,11,8,0,0,0,0,15543,6.6,16563,203,28,-3039,-2255,20.3,1554.3,blue,4.2,1.18,17,18,red
4518951602,13,10,18,2,1,1,0,19099,6.8,17642,207,30,650,511,20.7,1909.9,10,13,8,0,0,0,0,18449,6.6,17131,204,52,-650,-511,20.4,1844.9,blue,3.1,1.38,115,32,blue
4507086578,6,9,8,1,0,1,0,15879,6.8,17163,187,48,-905,-709,18.7,1587.9,9,6,10,1,1,0,0,16784,7,17872,183,53,905,709,18.3,1678.4,blue,1.56,3.17,42,35,blue
4523312152,9,7,4,0,0,0,0,17354,6.8,18013,239,32,966,969,23.9,1735.4,7,9,4,1,1,0,0,16388,6.8,17044,208,39,-966,-969,20.8,1638.8,blue,1.86,1.22,17,20,red
4514078470,6,8,9,1,0,1,1,16760,6.6,16615,186,40,-429,-1821,18.6,1676,8,6,10,0,0,0,0,17189,7.2,18436,242,43,429,1821,24.2,1718.9,red,1.88,3,26,16,blue
4522338058,7,5,8,2,1,1,0,16839,6.6,17206,209,53,1211,355,20.9,1683.9,5,7,9,0,0,0,0,15628,6.8,16851,191,51,-1211,-355,19.1,1562.8,blue,3,2,39,26,blue
4505315494,6,5,6,1,1,0,0,16186,7,18472,225,43,53,-114,22.5,1618.6,5,6,5,0,0,0,0,16133,6.8,18586,205,56,-53,114,20.5,1613.3,red,2.4,1.67,13,12,blue
4514158215,9,5,10,1,1,0,0,16915,7,17888,198,55,649,-103,19.8,1691.5,5,9,5,0,0,0,0,16266,6.8,17991,197,60,-649,103,19.7,1626.6,red,3.8,1.11,35,14,blue
4517541768,9,11,7,0,0,0,1,17951,6.2,16342,207,30,-135,-1288,20.7,1795.1,11,9,11,1,1,0,0,18086,6.6,17630,190,45,135,1288,19,1808.6,red,1.45,2.44,21,20,red
4459895934,8,7,7,1,1,0,0,17722,7.2,18555,224,43,1137,-609,22.4,1772.2,7,8,6,1,0,1,0,16585,7.2,19164,225,47,-1137,609,22.5,1658.5,blue,2.14,1.62,36,57,blue
4488652229,9,1,9,1,1,0,0,18381,7,19201,249,56,3951,2490,24.9,1838.1,1,9,0,0,0,0,0,14430,6.6,16711,214,60,-3951,-2490,21.4,1443,blue,18,0.11,21,21,blue
4462059327,5,6,5,0,0,0,0,16084,6.8,17317,219,46,-859,-2114,21.9,1608.4,6,5,5,1,1,0,0,16943,7.4,19431,244,60,859,2114,24.4,1694.3,red,1.67,2.2,15,18,red
4524178462,2,6,0,0,0,0,0,15054,7.2,18364,239,60,-962,612,23.9,1505.4,6,2,6,1,1,0,0,16016,6.8,17752,233,44,962,-612,23.3,1601.6,red,0.33,6,24,25,red
4501385353,12,5,17,0,0,0,0,17838,6.8,17217,194,42,2554,1453,19.4,1783.8,5,12,5,0,0,0,0,15284,6.4,15764,215,41,-2554,-1453,21.5,1528.4,blue,5.8,0.83,56,21,blue
4473787682,8,7,8,0,0,0,0,17415,6.8,18304,239,48,1158,-618,23.9,1741.5,7,8,4,1,1,0,0,16257,7.2,18922,184,84,-1158,618,18.4,1625.7,red,2.29,1.38,20,20,blue
4499266500,3,6,3,1,1,0,0,15025,6.6,17533,234,44,-2963,-1630,23.4,1502.5,6,3,6,1,0,1,0,17988,7.2,19163,252,56,2963,1630,25.2,1798.8,red,1,4,25,62,red
4524765955,4,7,4,0,0,0,0,15362,6.2,15828,206,48,-1894,-2184,20.6,1536.2,7,4,4,1,0,1,1,17256,7,18012,196,52,1894,2184,19.6,1725.6,red,1.14,2.75,18,15,red
4520757711,4,7,1,0,0,0,0,15038,6.8,17152,230,52,-1535,-716,23,1503.8,7,4,8,1,1,0,0,16573,6.8,17868,215,60,1535,716,21.5,1657.3,red,0.71,3.75,13,17,red
4519298162,8,4,11,0,0,0,0,17726,7.2,18294,218,50,1654,1097,21.8,1772.6,4,8,5,0,0,0,0,16072,6.8,17197,219,48,-1654,-1097,21.9,1607.2,blue,4.75,1.12,16,14,red
4524714078,3,6,3,2,1,1,0,15685,7,18609,232,58,-516,266,23.2,1568.5,6,3,8,0,0,0,0,16201,6.8,18343,208,45,516,-266,20.8,1620.1,red,1,4.67,12,15,red
4525034220,6,4,7,1,0,1,0,17530,7.2,19895,221,68,2577,2592,22.1,1753,4,6,3,1,1,0,0,14953,6.8,17303,196,46,-2577,-2592,19.6,1495.3,blue,3.25,1.17,18,19,blue
4524969283,6,6,10,0,0,0,0,16260,6.8,17516,205,59,-402,-520,20.5,1626,6,6,7,1,0,1,0,16662,7,18036,219,51,402,520,21.9,1666.2,red,2.67,2.17,16,20,blue
4515929191,5,10,5,0,0,0,0,15668,6.8,16531,183,60,-4404,-3165,18.3,1566.8,10,5,9,1,1,0,0,20072,7.2,19696,256,48,4404,3165,25.6,2007.2,red,1,3.8,22,19,red
4516530158,7,10,7,1,0,1,0,16511,7.2,18667,209,43,-2922,-1424,20.9,1651.1,10,7,13,0,0,0,0,19433,7.4,20091,212,72,2922,1424,21.2,1943.3,red,1.4,3.29,36,12,red
4515690341,8,11,13,1,1,0,0,16965,6.8,17225,200,44,-659,-701,20,1696.5,11,8,15,0,0,0,0,17624,6.8,17926,220,44,659,701,22,1762.4,blue,1.91,3.25,22,24,blue
4524181297,11,6,17,0,0,0,0,18212,7,18286,201,47,1924,1938,20.1,1821.2,6,11,5,0,0,0,0,16288,6.6,16348,212,52,-1924,-1938,21.2,1628.8,red,4.67,1,18,17,blue
4502754942,4,7,2,0,0,0,0,15042,7,17849,207,55,-2075,-738,20.7,1504.2,7,4,5,2,1,1,0,17117,7,18587,236,40,2075,738,23.6,1711.7,red,0.86,3,61,32,red
4470811112,4,6,2,0,0,0,0,15661,6.8,17735,235,38,-1055,-1236,23.5,1566.1,6,4,8,0,0,0,0,16716,7.2,18971,222,52,1055,1236,22.2,1671.6,red,1,3.5,16,17,blue
4470174827,10,3,11,1,0,1,0,17986,7,18856,218,50,3239,2494,21.8,1798.6,3,10,4,0,0,0,0,14747,6.6,16362,198,53,-3239,-2494,19.8,1474.7,blue,7,0.7,18,15,blue
4459430310,0,5,0,1,0,1,0,13776,6.8,16664,218,60,-2765,-2677,21.8,1377.6,5,0,6,1,1,0,0,16541,7.2,19341,256,53,2765,2677,25.6,1654.1,red,0,12.65,18,22,red
4462104144,7,8,6,0,0,0,0,15330,6.2,15016,186,24,-1183,-1425,18.6,1533,8,7,10,1,1,0,0,16513,6.6,16441,199,37,1183,1425,19.9,1651.3,red,1.62,2.57,21,22,red
4449382907,4,4,0,0,0,0,0,14727,7,17726,197,52,-1012,-1528,19.7,1472.7,4,4,7,1,1,0,0,15739,7.2,19254,238,56,1012,1528,23.8,1573.9,red,1,2.75,14,16,blue
4522775881,7,4,8,1,1,0,0,17651,6.8,18454,229,60,3245,307,22.9,1765.1,4,7,3,0,0,0,0,14406,6.8,18147,179,52,-3245,-307,17.9,1440.6,blue,3.75,1,16,18,blue
4472468602,5,3,10,0,0,0,0,15496,6.6,16654,184,47,-157,-269,18.4,1549.6,3,5,4,1,1,0,0,15653,6.6,16923,229,55,157,269,22.9,1565.3,red,5,1.4,22,20,blue
4520001049,9,6,10,1,1,0,0,18395,7.4,19262,242,45,2862,1862,24.2,1839.5,6,9,4,0,0,0,0,15533,6.8,17400,200,40,-2862,-1862,20,1553.3,blue,3.17,1.11,44,20,blue
4452176098,7,4,8,1,1,0,0,16866,6.8,17217,220,27,789,-1212,22,1686.6,4,7,5,0,0,0,0,16077,6.8,18429,224,52,-789,1212,22.4,1607.7,blue,3.75,1.29,17,13,blue
4511777552,7,7,12,0,0,0,0,16449,7,18091,211,39,-986,-484,21.1,1644.9,7,7,13,1,1,0,0,17435,7.2,18575,238,53,986,484,23.8,1743.5,red,2.71,2.86,15,13,red
4481584807,5,8,4,1,1,0,0,16142,7,18926,218,58,-812,-202,21.8,1614.2,8,5,2,0,0,0,0,16954,7.2,19128,233,48,812,202,23.3,1695.4,blue,1.12,2,18,17,red
4449261764,4,7,2,0,0,0,0,15099,6.6,17573,205,52,-3196,-3217,20.5,1509.9,7,4,10,1,1,0,0,18295,7.4,20790,226,71,3196,3217,22.6,1829.5,red,0.86,4.25,19,19,blue
4522089265,9,8,7,1,1,0,0,18044,7.2,18900,207,69,738,1289,20.7,1804.4,8,9,11,0,0,0,0,17306,6.8,17611,188,41,-738,-1289,18.8,1730.6,blue,2,2.11,15,12,blue
4520798455,5,5,6,0,0,0,0,16248,7.2,18554,251,40,1144,464,25.1,1624.8,5,5,5,0,0,0,0,15104,7,18090,199,56,-1144,-464,19.9,1510.4,blue,2.2,2,17,16,blue
4427468467,5,2,5,1,1,0,0,15182,7,17949,205,44,246,759,20.5,1518.2,2,5,2,1,0,1,0,14936,7,17190,230,56,-246,-759,23,1493.6,blue,5,0.8,17,21,red
4483120111,6,6,5,0,0,0,0,15651,6.8,17769,195,44,-919,-483,19.5,1565.1,6,6,5,1,1,0,0,16570,7,18252,203,68,919,483,20.3,1657,red,1.83,1.83,43,18,red
4515211180,5,4,1,2,1,1,0,15917,7,18370,211,64,805,691,21.1,1591.7,4,5,4,0,0,0,0,15112,6.8,17679,187,60,-805,-691,18.7,1511.2,blue,1.5,1.6,17,16,blue
4509595307,2,5,2,0,0,0,0,13889,6.8,16733,193,57,-1656,-453,19.3,1388.9,5,2,8,1,1,0,0,15545,6.6,17186,229,44,1656,453,22.9,1554.5,red,0.8,6.5,42,16,red
4524476319,7,5,5,0,0,0,0,16858,7,18305,241,44,1153,930,24.1,1685.8,5,7,11,1,1,0,0,15705,7,17375,211,46,-1153,-930,21.1,1570.5,red,2.4,2.29,53,38,blue
4525063460,9,8,17,0,0,0,0,18119,6.4,16050,204,38,740,-692,20.4,1811.9,8,9,18,1,1,0,0,17379,6.8,16742,210,36,-740,692,21,1737.9,blue,3.25,2.89,15,20,blue
4525021746,8,2,9,0,0,0,0,17352,6.8,17199,207,46,2841,858,20.7,1735.2,2,8,4,1,1,0,0,14511,6.6,16341,198,69,-2841,-858,19.8,1451.1,red,8.5,0.75,59,14,blue
4461002538,11,9,15,0,0,0,0,17924,6.6,16556,219,35,449,-260,21.9,1792.4,9,11,10,0,0,0,0,17475,6.8,16816,182,44,-449,260,18.2,1747.5,red,2.89,1.73,16,19,red
4478110348,3,4,2,0,0,0,0,14490,6.8,17534,226,37,-1759,-2019,22.6,1449,4,3,1,1,1,0,0,16249,7.2,19553,247,58,1759,2019,24.7,1624.9,red,1.25,1.67,19,44,blue
4524954902,6,8,10,0,0,0,0,16172,6.8,18147,189,60,-1257,333,18.9,1617.2,8,6,11,1,1,0,0,17429,7,17814,226,36,1257,-333,22.6,1742.9,red,2,3.17,23,23,red
4522545565,1,6,1,0,0,0,0,14555,6.8,17217,239,48,-1824,-613,23.9,1455.5,6,1,6,1,0,1,0,16379,7,17830,204,55,1824,613,20.4,1637.9,red,0.33,12,16,22,red
4484014215,6,5,6,0,0,0,0,15355,7.2,17702,197,51,-843,147,19.7,1535.5,5,6,7,1,1,0,0,16198,7,17555,223,55,843,-147,22.3,1619.8,red,2.4,2,21,26,red
4519513452,4,8,3,1,1,0,0,14395,6.4,16209,175,45,-2618,-1567,17.5,1439.5,8,4,11,0,0,0,0,17013,7,17776,213,50,2618,1567,21.3,1701.3,red,0.88,4.75,21,20,blue
4496639955,6,6,7,1,1,0,0,16630,7,18540,225,48,253,-453,22.5,1663,6,6,3,0,0,0,0,16377,7,18993,213,56,-253,453,21.3,1637.7,red,2.17,1.5,17,18,blue
4490249955,8,5,9,0,0,0,0,16984,7.2,18842,225,60,1229,1913,22.5,1698.4,5,8,3,0,0,0,0,15755,6.8,16929,214,36,-1229,-1913,21.4,1575.5,red,3.4,1,33,17,red
4523721011,7,9,9,1,1,0,0,16675,7,17477,205,30,-938,-1180,20.5,1667.5,9,7,12,0,0,0,0,17613,7.2,18657,199,67,938,1180,19.9,1761.3,red,1.78,3,15,19,red
4497094157,7,4,6,0,0,0,0,16258,7,18355,207,43,-487,764,20.7,1625.8,4,7,4,1,0,1,1,16745,6.6,17591,207,61,487,-764,20.7,1674.5,red,3.25,1.14,51,20,red
4525009090,3,7,3,0,0,0,0,15571,7.2,18029,212,60,-1431,-648,21.2,1557.1,7,3,9,1,1,0,0,17002,7,18677,241,51,1431,648,24.1,1700.2,red,0.86,5.33,14,16,red
4477376343,12,5,13,1,1,0,0,19740,7.4,19505,228,68,4498,4087,22.8,1974,5,12,6,0,0,0,0,15242,6.2,15418,183,40,-4498,-4087,18.3,1524.2,blue,5,0.92,17,22,blue
4497870077,1,7,0,1,1,0,0,13749,6.2,16076,208,43,-3574,-3171,20.8,1374.9,7,1,9,0,0,0,0,17323,7.2,19247,222,67,3574,3171,22.2,1732.3,blue,0.14,16,17,28,red
4484002514,4,1,3,2,1,1,0,16231,7.2,18511,271,52,693,-204,27.1,1623.1,1,4,1,0,0,0,0,15538,7.2,18715,245,59,-693,204,24.5,1553.8,blue,7,0.5,22,19,blue
4485492542,6,7,5,0,0,0,0,15736,7,17285,188,45,-915,3,18.8,1573.6,7,6,4,1,1,0,0,16651,7,17282,199,59,915,-3,19.9,1665.1,blue,1.57,1.83,11,20,red
4522840009,6,3,8,0,0,0,0,17099,7.2,19019,222,69,1847,1663,22.2,1709.9,3,6,5,2,1,1,0,15252,6.8,17356,210,70,-1847,-1663,21,1525.2,red,4.67,1.33,19,16,red
4502951007,8,2,10,0,0,0,0,17620,6.8,17878,236,41,2978,-438,23.6,1762,2,8,4,0,0,0,0,14642,7.2,18316,180,67,-2978,438,18,1464.2,blue,9,0.75,17,20,blue
4481782791,5,4,6,0,0,0,0,16250,6.6,17489,231,48,1245,1084,23.1,1625,4,5,5,0,0,0,0,15005,6.6,16405,216,52,-1245,-1084,21.6,1500.5,blue,2.75,1.8,19,18,red
4521225250,8,10,11,1,1,0,0,17136,7,17495,207,54,-1632,562,20.7,1713.6,10,8,17,1,0,1,1,18768,6.8,16933,173,32,1632,-562,17.3,1876.8,red,1.9,3.38,16,17,red
4505017372,13,7,10,1,1,0,3,22228,7.2,18219,234,54,8657,7609,23.4,2222.8,7,13,9,0,0,0,0,13571,4.8,10610,107,29,-8657,-7609,10.7,1357.1,blue,3.29,1.23,15,12,blue
4498508859,9,6,15,0,0,0,0,18847,7,19097,218,68,2197,233,21.8,1884.7,6,9,8,1,1,0,0,16650,7.4,18864,236,44,-2197,-233,23.6,1665,blue,4,1.56,15,17,blue
4499715260,2,15,2,0,0,0,0,13462,5.4,12212,130,42,-9152,-8290,13,1346.2,15,2,12,0,0,0,1,22614,7.4,20502,247,80,9152,8290,24.7,2261.4,red,0.27,13.5,5,18,red
4515579882,7,4,7,0,0,0,0,16364,7.2,18941,239,28,687,-291,23.9,1636.4,4,7,7,1,1,0,0,15677,7.2,19232,232,62,-687,291,23.2,1567.7,red,3.5,1.57,18,53,red
4518960621,6,8,9,0,0,0,0,17279,6.8,17886,233,36,220,-740,23.3,1727.9,8,6,10,1,1,0,0,17059,7.2,18626,211,56,-220,740,21.1,1705.9,blue,1.88,3,17,15,red
4520723739,1,2,1,0,0,0,0,14654,6.8,16892,225,56,-96,-1063,22.5,1465.4,2,1,1,0,0,0,0,14750,7,17955,240,40,96,1063,24,1475,blue,1,3,14,17,blue
4524179867,6,12,8,0,0,0,0,15211,6.4,16421,187,47,-3746,-3014,18.7,1521.1,12,6,18,1,1,0,0,18957,7.2,19435,230,56,3746,3014,23,1895.7,red,1.17,5,16,23,red
4521083858,5,6,11,1,1,0,0,17076,7.4,19064,223,60,629,1496,22.3,1707.6,6,5,11,0,0,0,0,16447,6.8,17568,215,33,-629,-1496,21.5,1644.7,blue,2.67,3.4,21,20,blue
4515542024,1,4,2,1,0,1,0,14536,7,17837,214,63,-1476,-346,21.4,1453.6,4,1,4,1,1,0,0,16012,7,18183,253,48,1476,346,25.3,1601.2,blue,0.75,8,16,24,red
4524456630,7,9,7,1,1,0,0,17308,6.8,17903,198,59,-575,-1680,19.8,1730.8,9,7,6,0,0,0,0,17883,7,19583,227,40,575,1680,22.7,1788.3,red,1.56,2.14,14,11,red
4467557868,4,6,4,1,0,1,0,16203,6.8,17228,205,45,-635,-1525,20.5,1620.3,6,4,8,1,1,0,0,16838,7.2,18753,206,61,635,1525,20.6,1683.8,red,1.33,3.5,35,18,blue
4489796229,6,5,4,1,1,0,0,16130,6.8,17004,235,36,149,447,23.5,1613,5,6,3,0,0,0,0,15981,6.6,16557,241,40,-149,-447,24.1,1598.1,blue,2,1.33,23,22,blue
4521744333,2,4,3,1,0,1,0,15739,7,16738,223,46,657,-1141,22.3,1573.9,4,2,5,1,1,0,0,15082,6.8,17879,199,60,-657,1141,19.9,1508.2,red,1.25,4.5,18,16,blue
4457608127,9,11,13,0,0,0,0,17498,7.2,18569,228,43,-958,264,22.8,1749.8,11,9,18,1,1,0,0,18456,7.2,18305,200,45,958,-264,20,1845.6,red,2,3.22,15,13,red
4515902763,6,9,3,0,0,0,0,14947,6.6,16859,165,63,-2922,-2165,16.5,1494.7,9,6,6,1,1,0,0,17869,7.2,19024,239,44,2922,2165,23.9,1786.9,blue,1,2.5,22,18,red
4458352494,3,11,3,0,0,0,0,14893,6.4,16350,217,48,-3410,-3134,21.7,1489.3,11,3,13,1,1,0,0,18303,7.4,19484,240,32,3410,3134,24,1830.3,red,0.55,8,20,20,red
4495755195,11,8,11,1,0,1,0,18817,7,17845,192,54,311,559,19.2,1881.7,8,11,6,0,0,0,1,18506,6.8,17286,228,36,-311,-559,22.8,1850.6,blue,2.75,1.27,11,17,red
4465307866,9,6,10,1,0,1,0,17704,7,18715,197,64,1792,1373,19.7,1770.4,6,9,2,1,1,0,0,15912,6.6,17342,205,48,-1792,-1373,20.5,1591.2,blue,3.17,0.89,18,15,blue
4519846925,1,6,1,1,0,1,1,15717,6.6,16927,241,52,-856,-2269,24.1,1571.7,6,1,11,1,1,0,0,16573,7.2,19196,245,42,856,2269,24.5,1657.3,red,0.33,17,18,75,red
4441748703,10,6,9,1,1,0,0,17252,7,18227,212,40,1154,999,21.2,1725.2,6,10,5,0,0,0,0,16098,7,17228,220,42,-1154,-999,22,1609.8,blue,3.17,1.1,27,16,blue
4509128702,3,7,3,0,0,0,0,14794,6.8,17179,185,50,-2124,-1109,18.5,1479.4,7,3,7,1,1,0,0,16918,7,18288,217,68,2124,1109,21.7,1691.8,red,0.86,4.67,16,12,red
4514370002,3,4,5,0,0,0,0,14751,6.8,17562,217,39,-982,36,21.7,1475.1,4,3,6,1,1,0,0,15733,6.8,17526,210,72,982,-36,21,1573.3,red,2,3.33,14,14,red
4415410070,2,2,2,1,1,0,0,15430,7,18761,246,71,467,-298,24.6,1543,2,2,2,0,0,0,0,14963,7,19059,236,64,-467,298,23.6,1496.3,blue,2,2,21,11,blue
4522067733,1,7,0,0,0,0,0,14266,6.8,17850,222,56,-3389,-1855,22.2,1426.6,7,1,9,2,1,1,0,17655,7.4,19705,231,76,3389,1855,23.1,1765.5,red,0.14,16,17,42,red
4512191595,6,8,4,2,1,1,0,16168,6.8,17184,204,36,-1003,-491,20.4,1616.8,8,6,7,0,0,0,0,17171,6.8,17675,220,59,1003,491,22,1717.1,red,1.25,2.5,40,22,blue
4502288347,6,7,3,1,1,0,0,17303,7,18417,224,52,572,417,22.4,1730.3,7,6,7,0,0,0,0,16731,7,18000,205,60,-572,-417,20.5,1673.1,blue,1.29,2.33,104,25,blue
4518477698,6,8,7,1,1,0,0,16111,6.8,17170,204,48,-1556,-1808,20.4,1611.1,8,6,5,0,0,0,0,17667,7.2,18978,241,40,1556,1808,24.1,1766.7,red,1.62,2.17,21,17,red
4520601496,8,6,10,0,0,0,0,18029,7.2,18791,199,53,2323,1699,19.9,1802.9,6,8,5,0,0,0,0,15706,6.8,17092,192,38,-2323,-1699,19.2,1570.6,blue,3,1.38,17,17,red
4511958473,7,4,7,0,0,0,0,16695,7.2,18868,222,49,1486,1605,22.2,1669.5,4,7,3,1,1,0,0,15209,6.8,17263,229,44,-1486,-1605,22.9,1520.9,red,3.5,1,39,20,blue
4496579153,8,2,7,1,0,1,0,17755,7.2,19720,228,48,3755,2662,22.8,1775.5,2,8,3,0,0,0,0,14000,6.6,17058,183,51,-3755,-2662,18.3,1400,blue,7.5,0.62,18,15,blue
4472901696,8,8,12,1,1,0,0,17388,6.6,16792,214,40,1327,-741,21.4,1738.8,8,8,6,0,0,0,0,16061,6.6,17533,190,47,-1327,741,19,1606.1,red,2.5,1.75,21,21,red
4524424547,6,0,7,2,1,1,0,16874,7.2,19010,260,51,2929,2507,26,1687.4,0,6,0,0,0,0,0,13945,6.6,16503,239,52,-2929,-2507,23.9,1394.5,blue,12.03,0,17,18,blue
4522182395,3,2,3,0,0,0,0,15591,7,17801,239,42,536,-18,23.9,1559.1,2,3,2,1,0,1,0,15055,7,17819,234,50,-536,18,23.4,1505.5,red,3,1.33,13,13,blue
4509900585,8,3,12,1,1,0,0,17562,7,17702,237,43,3575,1394,23.7,1756.2,3,8,1,1,0,1,0,13987,6.6,16308,176,45,-3575,-1394,17.6,1398.7,blue,6.67,0.5,25,44,blue
4522637303,12,4,16,1,1,0,0,19628,7.2,18889,229,38,4801,2127,22.9,1962.8,4,12,4,0,0,0,0,14827,6.8,16762,198,60,-4801,-2127,19.8,1482.7,blue,7,0.67,26,24,blue
4523312130,5,12,5,0,0,0,0,15871,6.6,16751,202,41,-2201,-2344,20.2,1587.1,12,5,9,1,1,0,0,18072,7.2,19095,221,28,2201,2344,22.1,1807.2,red,0.83,4.2,18,41,red
4502724459,9,5,8,0,0,0,0,17792,7,18238,222,45,2785,1671,22.2,1779.2,5,9,1,1,1,0,0,15007,6.6,16567,204,53,-2785,-1671,20.4,1500.7,red,3.4,0.67,18,18,blue
4470203201,7,8,8,1,0,1,0,16168,6.8,16435,193,44,-692,-736,19.3,1616.8,8,7,6,0,0,0,0,16860,6.8,17171,207,58,692,736,20.7,1686,red,1.88,2,133,41,blue
4525242680,4,11,3,1,1,0,0,15786,6.6,17495,217,55,-4406,-2504,21.7,1578.6,11,4,15,0,0,0,1,20192,7.2,19999,233,68,4406,2504,23.3,2019.2,blue,0.64,6.5,19,25,red
4458767529,8,8,6,2,1,1,0,17889,7.2,19337,235,60,1792,1300,23.5,1788.9,8,8,7,0,0,0,0,16097,7,18037,180,48,-1792,-1300,18,1609.7,blue,1.75,1.88,21,15,red
4519236802,2,14,3,1,0,1,0,13612,6.4,15504,181,48,-6717,-4767,18.1,1361.2,14,2,17,1,1,0,0,20329,7.6,20271,226,56,6717,4767,22.6,2032.9,red,0.36,15.5,52,19,red
4486524151,5,7,4,0,0,0,0,16218,6.8,16863,204,52,-193,-634,20.4,1621.8,7,5,10,2,1,1,0,16411,6.8,17497,202,48,193,634,20.2,1641.1,red,1.29,3.4,22,20,blue
4520399820,8,6,6,0,0,0,0,18188,7.4,20313,252,76,1667,3434,25.2,1818.8,6,8,8,1,1,0,0,16521,6.4,16879,188,51,-1667,-3434,18.8,1652.1,blue,2.33,1.75,18,21,red
4488956857,5,8,5,1,1,0,0,15786,6.6,16737,219,44,-1860,-2194,21.9,1578.6,8,5,11,1,0,1,0,17646,7.2,18931,231,44,1860,2194,23.1,1764.6,red,1.25,3.8,16,14,blue
4462003786,1,7,1,1,1,0,0,14419,6.2,16385,235,50,-3324,-3139,23.5,1441.9,7,1,7,0,0,0,0,17743,7.4,19524,246,60,3324,3139,24.6,1774.3,red,0.29,14,20,20,blue
4495531076,7,11,10,0,0,0,0,16575,6.8,17151,194,46,-1655,-1744,19.4,1657.5,11,7,7,1,1,0,0,18230,7.2,18895,208,52,1655,1744,20.8,1823,red,1.55,2.57,16,17,blue
4524125619,5,5,4,0,0,0,0,15068,6.8,17487,203,45,-321,272,20.3,1506.8,5,5,5,2,1,1,0,15389,6.6,17215,211,45,321,-272,21.1,1538.9,red,1.8,2,22,22,red
4427379345,10,1,9,1,1,0,0,19225,7.4,20071,253,43,4947,2051,25.3,1922.5,1,10,1,1,0,1,0,14278,6.8,18020,200,49,-4947,-2051,20,1427.8,blue,19,0.2,20,18,blue
4523555451,10,6,10,0,0,0,0,18688,7.2,18613,218,47,3424,3153,21.8,1868.8,6,10,7,0,0,0,0,15264,6.2,15460,170,40,-3424,-3153,17,1526.4,blue,3.33,1.3,42,17,blue
4525226714,10,5,10,1,1,0,0,18650,7.2,18563,236,44,3028,1818,23.6,1865,5,10,4,0,0,0,0,15622,6.8,16745,216,36,-3028,-1818,21.6,1562.2,blue,4,0.9,20,19,blue
4524281018,3,2,3,2,1,1,0,15207,7,18559,234,54,-211,843,23.4,1520.7,2,3,4,0,0,0,0,15418,7,17716,211,48,211,-843,21.1,1541.8,red,3,2,20,23,blue
4518387667,11,5,8,1,1,0,0,17522,7,18787,204,44,2123,1612,20.4,1752.2,5,11,3,0,0,0,0,15399,7,17175,194,52,-2123,-1612,19.4,1539.9,blue,3.8,0.73,21,39,blue
4523454499,12,9,13,0,0,0,0,18131,7,17297,193,40,1025,439,19.3,1813.1,9,12,13,1,1,0,0,17106,6.8,16858,213,40,-1025,-439,21.3,1710.6,red,2.78,1.83,93,27,red
4445701647,10,7,9,1,0,1,0,18209,7.2,18851,209,50,2343,2878,20.9,1820.9,7,10,8,1,1,0,0,15866,6.4,15973,170,54,-2343,-2878,17,1586.6,blue,2.71,1.5,77,20,red
4511234926,5,7,4,0,0,0,0,16162,7,18589,230,55,-565,738,23,1616.2,7,5,12,0,0,0,0,16727,7,17851,234,44,565,-738,23.4,1672.7,red,1.29,3.8,18,60,red
4503340964,7,10,4,0,0,0,0,16805,7,18285,229,55,-1785,-1131,22.9,1680.5,10,7,12,2,1,1,0,18590,7.4,19416,248,56,1785,1131,24.8,1859,blue,1.1,3.14,21,21,blue
4525135236,3,6,3,1,0,1,0,15742,7,18244,220,64,-873,-1792,22,1574.2,6,3,6,0,0,0,0,16615,7.4,20036,215,62,873,1792,21.5,1661.5,blue,1,4,16,20,red
4522207483,11,9,8,0,0,0,0,18649,7.2,19509,207,57,1641,1386,20.7,1864.9,9,11,9,0,0,0,0,17008,7,18123,199,39,-1641,-1386,19.9,1700.8,blue,2.11,1.64,32,8,blue
4489939324,4,12,4,1,0,1,1,16643,6.6,15836,202,51,-1111,-1185,20.2,1664.3,12,4,15,1,1,0,1,17754,6.4,17021,188,40,1111,1185,18.8,1775.4,blue,0.67,6.75,21,18,red
4525132603,5,9,6,0,0,0,0,16500,7,17896,238,60,-2390,-1796,23.8,1650,9,5,11,1,1,0,0,18890,7.2,19692,240,49,2390,1796,24,1889,blue,1.22,4,17,24,red
4454963096,7,6,8,1,1,0,0,16972,7,18412,221,51,1807,733,22.1,1697.2,6,7,3,1,0,1,0,15165,7,17679,211,40,-1807,-733,21.1,1516.5,red,2.5,1.29,34,15,blue
4486440363,3,11,5,0,0,0,0,14496,6.4,16377,215,48,-5003,-4682,21.5,1449.6,11,3,17,1,1,0,0,19499,7.6,21059,208,83,5003,4682,20.8,1949.9,red,0.73,9.33,39,56,blue
4512338231,7,5,5,1,1,0,0,16790,7.6,19460,241,62,651,1744,24.1,1679,5,7,10,0,0,0,0,16139,6.8,17716,186,65,-651,-1744,18.6,1613.9,blue,2.4,2.14,17,16,blue
4512768961,3,3,5,1,1,0,0,15704,7.2,18700,240,74,928,955,24,1570.4,3,3,1,0,0,0,0,14776,7,17745,232,45,-928,-955,23.2,1477.6,blue,2.67,1.33,35,64,red
4450562955,7,0,8,1,1,0,0,18285,7.4,20035,259,52,4649,3488,25.9,1828.5,0,7,0,0,0,0,0,13636,6.4,16547,215,56,-4649,-3488,21.5,1363.6,blue,12.03,0,25,37,blue
4524571135,3,11,4,0,0,0,0,14414,6.4,16744,173,39,-4743,-2650,17.3,1441.4,11,3,10,2,1,1,0,19157,7.4,19394,245,52,4743,2650,24.5,1915.7,red,0.64,7,23,17,red
4515559203,3,1,3,0,0,0,0,16981,7.2,20082,269,64,1775,1652,26.9,1698.1,1,3,2,2,1,1,0,15206,7,18430,256,72,-1775,-1652,25.6,1520.6,blue,6,1,17,63,blue
4449098612,10,6,12,1,1,0,0,18516,7,19255,240,58,2019,674,24,1851.6,6,10,8,0,0,0,0,16497,7.2,18581,214,49,-2019,-674,21.4,1649.7,blue,3.67,1.4,15,106,blue
4477446374,3,1,0,1,1,0,0,15594,7.4,20342,241,72,1402,2404,24.1,1559.4,1,3,1,0,0,0,0,14192,6.8,17938,215,59,-1402,-2404,21.5,1419.2,blue,3,0.67,42,16,red
4523100745,8,9,5,0,0,0,0,17259,7,18116,214,46,240,399,21.4,1725.9,9,8,14,1,1,0,0,17019,6.8,17717,223,32,-240,-399,22.3,1701.9,blue,1.44,2.88,12,17,blue
4517640142,10,7,9,0,0,0,0,17741,7,17857,208,48,2281,546,20.8,1774.1,7,10,5,1,1,0,0,15460,6.8,17311,183,57,-2281,-546,18.3,1546,blue,2.71,1.2,18,16,blue
4502562701,8,7,6,2,1,1,0,17867,7.2,19316,226,76,764,2490,22.6,1786.7,7,8,6,0,0,0,0,17103,6.6,16826,178,59,-764,-2490,17.8,1710.3,blue,2,1.62,18,19,blue
4496308488,15,4,16,0,0,0,1,21462,6.8,18193,208,27,7579,4666,20.8,2146.2,4,15,7,0,0,0,0,13883,5.8,13527,139,41,-7579,-4666,13.9,1388.3,blue,7.75,0.73,19,16,blue
4447660498,4,4,3,0,0,0,0,15548,6.8,17592,221,54,-112,398,22.1,1554.8,4,4,3,2,1,1,0,15660,6.8,17194,232,63,112,-398,23.2,1566,blue,1.75,1.75,14,15,red
4490133266,8,5,8,1,1,0,0,17405,7.2,19297,229,46,1198,197,22.9,1740.5,5,8,1,0,0,0,0,16207,7.2,19100,237,64,-1198,-197,23.7,1620.7,blue,3.2,0.75,17,39,red
4427465886,9,5,12,2,1,1,0,17112,7,18205,204,52,2199,1291,20.4,1711.2,5,9,9,0,0,0,0,14913,7,16914,197,36,-2199,-1291,19.7,1491.3,blue,4.2,1.56,18,14,red
4511030012,8,4,9,0,0,0,0,17917,6.8,17609,239,33,2992,258,23.9,1791.7,4,8,3,0,0,0,0,14925,6.8,17351,205,44,-2992,-258,20.5,1492.5,blue,4.25,0.88,20,17,blue
4513819617,5,13,8,0,0,0,0,15465,6,14469,169,49,-4292,-4133,16.9,1546.5,13,5,13,0,0,0,0,19757,7.2,18602,230,50,4292,4133,23,1975.7,red,1,5.2,20,32,blue
4509989116,5,8,6,0,0,0,0,16020,6.8,17044,240,46,-1407,-1305,24,1602,8,5,12,1,1,0,0,17427,7.2,18349,226,50,1407,1305,22.6,1742.7,red,1.38,4,22,32,blue
4496436861,8,2,9,0,0,0,0,16708,7.2,18529,230,41,1860,1500,23,1670.8,2,8,3,0,0,0,0,14848,6.6,17029,226,50,-1860,-1500,22.6,1484.8,blue,8.5,0.62,30,45,blue
4519730219,3,5,3,0,0,0,0,14384,6.8,16893,206,38,-1554,-704,20.6,1438.4,5,3,6,1,1,0,0,15938,7,17597,197,49,1554,704,19.7,1593.8,red,1.2,3.67,16,14,red
4412284612,11,14,10,0,0,0,0,18420,7.2,19093,225,46,-1004,-515,22.5,1842,14,11,14,0,0,0,0,19424,7.2,19608,205,52,1004,515,20.5,1942.4,red,1.5,2.55,17,16,red
4463008615,3,2,3,0,0,0,0,14804,7,17782,223,52,258,-298,22.3,1480.4,2,3,3,1,1,0,0,14546,7,18080,200,60,-258,298,20,1454.6,red,3,1.67,26,83,blue
4523567216,6,5,3,0,0,0,0,16279,7,18977,234,49,190,-57,23.4,1627.9,5,6,6,2,1,1,0,16089,7.2,19034,218,68,-190,57,21.8,1608.9,blue,1.8,1.83,23,24,blue
4480250709,15,4,16,1,1,0,1,21711,7.4,19183,247,48,7413,4895,24.7,2171.1,4,15,5,0,0,0,0,14298,5.8,14288,136,51,-7413,-4895,13.6,1429.8,blue,7.75,0.6,22,22,blue
4513101672,8,6,8,1,0,1,0,17124,6.4,16900,207,55,1315,63,20.7,1712.4,6,8,6,0,0,0,0,15809,6.6,16837,209,33,-1315,-63,20.9,1580.9,red,2.67,1.5,17,20,blue
4484137639,5,4,2,0,0,0,0,15895,7.2,18881,229,57,688,872,22.9,1589.5,4,5,3,0,0,0,0,15207,7,18009,231,44,-688,-872,23.1,1520.7,red,1.75,1.4,15,25,blue
4513907463,6,3,5,1,0,1,0,15960,6.8,17046,180,44,664,185,18,1596,3,6,1,1,1,0,0,15296,6.6,16861,205,64,-664,-185,20.5,1529.6,red,3.67,0.67,17,16,blue
4514601074,10,7,6,1,1,0,0,17678,7.4,18832,189,76,1754,433,18.9,1767.8,7,10,4,0,0,0,0,15924,6.8,18399,207,54,-1754,-433,20.7,1592.4,blue,2.29,1.1,49,15,blue
4503216707,12,7,15,0,0,0,0,18193,6.6,16895,182,44,1083,554,18.2,1819.3,7,12,8,1,1,0,0,17110,6.8,16341,225,47,-1083,-554,22.5,1711,blue,3.86,1.25,30,21,blue
4523105841,2,11,1,1,1,0,0,14643,6.8,17019,230,56,-4728,-3668,23,1464.3,11,2,14,0,0,0,0,19371,7.6,20687,236,64,4728,3668,23.6,1937.1,red,0.27,12.5,14,32,red
4525248629,8,5,9,1,1,0,0,16840,7.2,18289,185,74,1015,1543,18.5,1684,5,8,7,1,0,1,0,15825,6.6,16746,195,38,-1015,-1543,19.5,1582.5,blue,3.4,1.5,37,82,blue
4459452565,2,4,2,1,1,0,0,14707,7,18199,209,64,-410,-194,20.9,1470.7,4,2,3,0,0,0,0,15117,7,18393,201,52,410,194,20.1,1511.7,blue,1,3.5,19,16,red
4504853489,4,7,1,1,1,0,0,14467,6.6,16468,222,33,-1663,-1174,22.2,1446.7,7,4,5,0,0,0,0,16130,6.8,17642,186,36,1663,1174,18.6,1613,blue,0.71,3,23,21,blue
4514530540,7,2,8,0,0,0,0,17633,6.6,17885,226,47,3373,2234,22.6,1763.3,2,7,2,0,0,0,0,14260,6.6,15651,205,36,-3373,-2234,20.5,1426,blue,7.5,0.57,18,13,blue
4524622541,3,5,3,0,0,0,0,14837,6.6,15974,200,44,-1044,-2760,20,1483.7,5,3,7,1,1,0,0,15881,7.2,18734,183,68,1044,2760,18.3,1588.1,red,1.2,4,17,30,blue
4458223509,4,11,6,0,0,0,0,15826,6.8,17438,235,57,-2803,-1709,23.5,1582.6,11,4,12,1,1,0,0,18629,7,19147,238,38,2803,1709,23.8,1862.9,red,0.91,5.75,17,18,red
4463368363,8,5,7,2,1,1,0,18357,7,19718,269,56,3346,3707,26.9,1835.7,5,8,4,0,0,0,0,15011,6.6,16011,176,45,-3346,-3707,17.6,1501.1,blue,3,1.12,19,82,blue
4457158751,7,4,6,1,0,1,0,16460,7,18260,241,51,1561,-87,24.1,1646,4,7,0,1,1,0,0,14899,7.2,18347,197,77,-1561,87,19.7,1489.9,red,3.25,0.57,22,21,blue
4521415877,7,14,6,0,0,0,0,16054,6.4,16044,176,40,-3304,-3201,17.6,1605.4,14,7,8,1,1,0,0,19358,7.2,19245,170,58,3304,3201,17,1935.8,red,0.93,3.14,18,13,blue
4506682192,3,6,1,0,0,0,0,13899,6.4,16444,202,36,-3238,-2465,20.2,1389.9,6,3,7,1,1,0,0,17137,7.2,18909,261,45,3238,2465,26.1,1713.7,red,0.67,4.33,13,18,red
4479670533,3,5,6,2,1,1,0,15911,7,18170,231,63,-357,221,23.1,1591.1,5,3,7,0,0,0,0,16268,7,17949,224,51,357,-221,22.4,1626.8,blue,1.8,4,25,24,red
4435440889,2,4,4,0,0,0,0,15215,6.8,18360,231,52,-714,233,23.1,1521.5,4,2,6,1,1,0,0,15929,7,18127,208,60,714,-233,20.8,1592.9,blue,1.5,5,25,28,blue
4445687037,9,4,11,1,0,1,0,18036,7,18597,236,46,2806,1391,23.6,1803.6,4,9,7,1,1,0,0,15230,6.6,17206,232,49,-2806,-1391,23.2,1523,blue,5,1.22,21,50,blue
4520321309,6,4,5,0,0,0,0,16304,6.8,17328,212,36,205,-1306,21.2,1630.4,4,6,5,2,1,1,0,16099,7,18634,203,75,-205,1306,20.3,1609.9,red,2.75,1.5,14,18,blue
4518244695,2,3,4,0,0,0,0,15267,6.8,17987,226,80,-392,-995,22.6,1526.7,3,2,1,1,1,0,0,15659,7.4,18982,254,60,392,995,25.4,1565.9,red,2,2,33,19,red
4494472776,4,8,5,0,0,0,0,16055,6.8,17241,252,50,-1176,-1456,25.2,1605.5,8,4,9,1,1,0,0,17231,7,18697,225,51,1176,1456,22.5,1723.1,red,1.12,4.25,18,62,blue
4487367871,8,7,8,0,0,0,0,17404,7,18717,204,60,-882,-740,20.4,1740.4,7,8,9,1,1,0,0,18286,7.4,19457,253,63,882,740,25.3,1828.6,blue,2.29,2,17,28,red
4519628071,1,7,1,1,0,1,0,13741,6.4,15605,179,56,-2955,-2776,17.9,1374.1,7,1,7,1,1,0,0,16696,7,18381,220,47,2955,2776,22,1669.6,red,0.29,14,14,18,red
4486111513,5,7,6,0,0,0,0,16402,7,17710,223,68,194,-220,22.3,1640.2,7,5,8,0,0,0,0,16208,7,17930,195,56,-194,220,19.5,1620.8,blue,1.57,3,20,19,red
4514105796,2,9,1,0,0,0,0,14933,6.6,16470,225,56,-3251,-3208,22.5,1493.3,9,2,7,0,0,0,0,18184,7.4,19678,241,43,3251,3208,24.1,1818.4,red,0.33,8,15,17,red
4522061542,3,7,4,1,0,1,0,14665,6.8,17020,192,47,-1761,-1206,19.2,1466.5,7,3,10,1,1,0,0,16426,7,18226,213,52,1761,1206,21.3,1642.6,red,1,5.67,17,19,red
4434622213,14,8,15,1,0,1,0,19372,7,18802,180,62,1342,13,18,1937.2,8,14,9,0,0,0,0,18030,7.4,18789,229,51,-1342,-13,22.9,1803,blue,3.62,1.21,14,13,blue
4517858736,6,3,7,0,0,0,0,16310,7,18578,235,48,690,998,23.5,1631,3,6,5,1,1,0,0,15620,6.8,17580,230,40,-690,-998,23,1562,red,4.33,1.33,16,19,blue
4445279107,6,14,4,0,0,0,0,14643,6.8,17028,154,49,-4073,-3038,15.4,1464.3,14,6,11,1,1,0,0,18716,7.4,20066,207,44,4073,3038,20.7,1871.6,red,0.71,4.17,19,18,red
4504404678,3,1,3,1,1,0,0,16426,7.4,19543,251,75,2296,2033,25.1,1642.6,1,3,2,0,0,0,0,14130,6.8,17510,236,46,-2296,-2033,23.6,1413,blue,6,1,19,18,blue
4479765492,6,9,3,0,0,0,0,16331,7,18513,229,47,-1081,-953,22.9,1633.1,9,6,9,1,1,0,0,17412,7.2,19466,235,56,1081,953,23.5,1741.2,red,1,3,19,17,red
4497591005,6,10,4,0,0,0,0,15895,6.6,16900,222,44,-1664,-602,22.2,1589.5,10,6,10,1,1,0,0,17559,7,17502,218,45,1664,602,21.8,1755.9,blue,1,3.33,23,21,red
4441908556,10,6,15,1,1,0,0,18176,7,18682,216,47,2287,376,21.6,1817.6,6,10,3,0,0,0,0,15889,7.2,18306,202,52,-2287,-376,20.2,1588.9,blue,4.17,0.9,19,22,blue
4525134229,7,1,11,1,1,0,0,17566,7.2,19634,243,56,2821,2755,24.3,1756.6,1,7,3,0,0,0,0,14745,6.8,16879,234,54,-2821,-2755,23.4,1474.5,blue,18,0.57,21,16,blue
4502024151,2,11,3,0,0,0,0,13832,6.6,16157,203,47,-6240,-4315,20.3,1383.2,11,2,11,2,1,1,1,20072,7.6,20472,233,49,6240,4315,23.3,2007.2,red,0.45,11,13,16,red
4522076814,8,6,7,1,1,0,0,17751,7.2,19165,238,60,1570,643,23.8,1775.1,6,8,1,0,0,0,0,16181,7,18522,226,52,-1570,-643,22.6,1618.1,blue,2.5,0.88,21,41,blue
4499734031,3,4,5,1,1,0,0,15382,7,18298,239,59,39,238,23.9,1538.2,4,3,7,0,0,0,0,15343,7,18060,225,40,-39,-238,22.5,1534.3,red,2,3.67,37,15,red
4496572597,9,4,11,0,0,0,0,17326,7.2,19014,226,44,1132,269,22.6,1732.6,4,9,5,1,1,0,0,16194,7.2,18745,203,59,-1132,-269,20.3,1619.4,blue,5,1,19,41,blue
4462606052,8,10,11,0,0,0,0,16756,6.8,16405,192,48,-1429,-1521,19.2,1675.6,10,8,11,1,0,1,0,18185,6.8,17926,209,60,1429,1521,20.9,1818.5,red,1.9,2.62,26,28,blue
4521989162,4,9,3,1,1,0,0,16289,6.8,17304,223,67,-1764,-1997,22.3,1628.9,9,4,11,0,0,0,0,18053,7.2,19301,244,51,1764,1997,24.4,1805.3,blue,0.78,5,22,19,blue
4524510632,7,9,7,0,0,0,0,16581,6.8,17538,197,48,-172,-21,19.7,1658.1,9,7,9,1,1,0,0,16753,7,17559,196,48,172,21,19.6,1675.3,blue,1.56,2.57,14,18,blue
4505847017,7,5,6,0,0,0,0,16555,7.2,18712,204,57,201,303,20.4,1655.5,5,7,6,1,1,0,0,16354,7.2,18409,210,64,-201,-303,21,1635.4,blue,2.6,1.57,41,52,red
4508447638,3,9,4,0,0,0,0,15700,7,17393,250,48,-2185,-2444,25,1570,9,3,9,0,0,0,0,17885,7.6,19837,216,60,2185,2444,21.6,1788.5,red,0.78,6,30,27,blue
4518499489,2,11,2,0,0,0,0,13494,5.8,14660,213,24,-5020,-4792,21.3,1349.4,11,2,9,1,1,0,0,18514,7.4,19452,246,57,5020,4792,24.6,1851.4,red,0.36,10,18,17,red
4519559671,3,9,2,1,0,1,0,13876,6.2,15218,183,36,-5694,-3457,18.3,1387.6,9,3,15,0,0,0,1,19570,6.8,18675,204,51,5694,3457,20.4,1957,red,0.56,8,68,78,blue
4523408050,7,12,6,0,0,0,0,16668,6.8,17267,193,51,-2781,-1104,19.3,1666.8,12,7,15,1,0,1,1,19449,7.2,18371,205,36,2781,1104,20.5,1944.9,red,1.08,3.86,21,48,blue
4485581328,5,5,3,1,0,1,0,16009,7.2,19116,206,45,565,2073,20.6,1600.9,5,5,4,0,0,0,0,15444,6.8,17043,218,49,-565,-2073,21.8,1544.4,blue,1.6,1.8,21,24,red
4518069605,4,3,7,1,1,0,0,16321,7,18950,250,52,508,-183,25,1632.1,3,4,7,0,0,0,0,15813,7,19133,225,74,-508,183,22.5,1581.3,blue,3.67,2.5,79,19,red
4524524823,9,5,7,0,0,0,0,16755,6.8,16362,179,40,2154,2068,17.9,1675.5,5,9,3,0,0,0,0,14601,5.8,14294,199,11,-2154,-2068,19.9,1460.1,blue,3.2,0.89,21,19,blue
4514486964,7,5,5,0,0,0,0,16407,7,18954,189,62,1063,1501,18.9,1640.7,5,7,0,0,0,0,0,15344,6.8,17453,205,40,-1063,-1501,20.5,1534.4,blue,2.4,0.71,13,16,blue
4489773127,5,9,6,0,0,0,0,15061,6.4,16082,203,44,-1805,-2303,20.3,1506.1,9,5,8,1,1,0,0,16866,7,18385,201,49,1805,2303,20.1,1686.6,red,1.22,3.4,15,20,blue
4439065205,6,9,9,0,0,0,0,16552,7,17597,215,48,-1026,-982,21.5,1655.2,9,6,7,1,1,0,0,17578,7,18579,234,52,1026,982,23.4,1757.8,red,1.67,2.67,31,22,red
4522097852,8,5,5,0,0,0,0,16538,7.4,19266,238,36,1664,1691,23.8,1653.8,5,8,1,1,1,0,0,14874,6.8,17575,190,56,-1664,-1691,19,1487.4,red,2.6,0.75,20,42,red
4465798223,5,8,6,0,0,0,0,15958,6.6,16741,233,44,-84,-22,23.3,1595.8,8,5,9,0,0,0,0,16042,6.6,16763,190,36,84,22,19,1604.2,red,1.38,3.4,19,41,red
4481808097,7,5,7,1,0,1,0,16851,7.2,18450,221,48,936,386,22.1,1685.1,5,7,2,1,1,0,0,15915,7,18064,253,59,-936,-386,25.3,1591.5,red,2.8,1,56,21,blue
4520001245,6,2,8,1,1,0,0,16753,7.4,18695,201,63,2631,2349,20.1,1675.3,2,6,1,1,0,1,0,14122,6.4,16346,207,48,-2631,-2349,20.7,1412.2,blue,7,0.5,15,25,red
4501055152,2,3,2,1,1,0,0,14607,6.6,16424,222,45,-1183,-2491,22.2,1460.7,3,2,1,0,0,0,0,15790,7,18915,228,58,1183,2491,22.8,1579,red,1.33,2,52,17,blue
4516962004,5,8,8,1,1,0,0,17160,7.2,19481,245,64,-312,37,24.5,1716,8,5,12,0,0,0,0,17472,7.2,19444,231,60,312,-37,23.1,1747.2,red,1.62,4,17,16,red
4475690414,7,9,4,1,0,1,0,16360,6.6,16891,187,52,-833,-773,18.7,1636,9,7,13,1,1,0,0,17193,6.8,17664,197,56,833,773,19.7,1719.3,red,1.22,3.14,17,21,red
4449928172,5,7,5,1,0,1,0,15288,6.6,17567,192,56,-1308,-564,19.2,1528.8,7,5,6,1,1,0,0,16596,7,18131,223,49,1308,564,22.3,1659.6,red,1.43,2.6,24,33,red
4516845664,11,5,7,0,0,0,0,18415,7.4,20355,221,51,2862,3250,22.1,1841.5,5,11,7,0,0,0,0,15553,7,17105,223,44,-2862,-3250,22.3,1555.3,blue,3.6,1.09,20,14,red
4518824724,3,4,3,0,0,0,0,15190,7,18530,231,51,-1449,313,23.1,1519,4,3,4,2,1,1,0,16639,7,18217,264,48,1449,-313,26.4,1663.9,blue,1.5,2.67,14,19,red
4510011476,7,3,9,0,0,0,0,17188,7.2,19483,244,57,2010,1365,24.4,1718.8,3,7,0,0,0,0,0,15178,6.8,18118,226,71,-2010,-1365,22.6,1517.8,blue,5.33,0.43,18,12,blue
4517927232,10,7,9,0,0,0,0,16900,6.8,18173,170,54,-52,258,17,1690,7,10,5,1,1,0,0,16952,7,17915,222,40,52,-258,22.2,1695.2,blue,2.71,1.2,20,17,blue
4484624714,8,5,5,0,0,0,0,16208,6.4,16287,190,40,-315,-1874,19,1620.8,5,8,5,1,1,0,0,16523,7,18161,242,58,315,1874,24.2,1652.3,red,2.6,1.25,21,19,blue
4509591728,3,9,3,0,0,0,0,15477,7,17532,223,56,-1579,-655,22.3,1547.7,9,3,12,1,0,1,0,17056,7,18187,192,52,1579,655,19.2,1705.6,blue,0.67,7,18,62,red
4523849418,4,5,5,0,0,0,0,15574,7,17489,219,52,-616,-1349,21.9,1557.4,5,4,3,1,1,0,0,16190,7.2,18838,232,72,616,1349,23.2,1619,red,1.8,2,58,17,red
4500004334,4,6,3,1,1,0,0,15377,7.2,18315,215,51,-1262,614,21.5,1537.7,6,4,5,0,0,0,0,16639,7,17701,225,66,1262,-614,22.5,1663.9,red,1.17,2.75,19,15,red
4496878235,1,4,0,0,0,0,0,13649,6,14620,189,41,-2564,-2920,18.9,1364.9,4,1,6,0,0,0,0,16213,6.8,17540,213,72,2564,2920,21.3,1621.3,red,0.25,10,14,70,red
4521285475,11,8,11,1,1,0,0,19239,7.6,19698,209,47,2587,1759,20.9,1923.9,8,11,4,0,0,0,0,16652,6.8,17939,195,44,-2587,-1759,19.5,1665.2,red,2.75,1.09,19,16,blue
4522272294,15,4,18,1,1,0,0,20186,7.2,19725,216,40,5491,5335,21.6,2018.6,4,15,2,0,0,0,0,14695,6,14390,159,48,-5491,-5335,15.9,1469.5,blue,8.25,0.4,42,17,blue
4518392490,9,7,9,1,1,0,0,19034,7.4,19369,240,43,4051,3552,24,1903.4,7,9,6,0,0,0,0,14983,6.6,15817,178,28,-4051,-3552,17.8,1498.3,blue,2.57,1.44,20,16,red
4495300852,13,3,13,0,0,0,0,20183,7.6,20925,239,48,5712,4581,23.9,2018.3,3,13,3,0,0,0,0,14471,6.6,16344,208,36,-5712,-4581,20.8,1447.1,blue,8.67,0.46,20,17,blue
4522063947,3,9,3,1,1,0,0,15877,6.8,17848,234,50,-1232,-659,23.4,1587.7,9,3,7,0,0,0,0,17109,7,18507,221,37,1232,659,22.1,1710.9,red,0.67,5.33,17,17,red
4438188395,9,8,8,0,0,0,0,16823,6.8,17411,219,33,-1071,-1667,21.9,1682.3,8,9,10,1,1,0,0,17894,7.2,19078,210,63,1071,1667,21,1789.4,red,2.12,2,22,20,red
4480457394,5,5,4,1,1,0,0,16525,7,18498,230,57,1262,413,23,1652.5,5,5,3,0,0,0,0,15263,7,18085,212,54,-1262,-413,21.2,1526.3,blue,1.8,1.6,17,19,red
4508312193,2,5,2,1,1,0,0,15103,7,18559,246,66,-1761,-881,24.6,1510.3,5,2,6,1,0,1,0,16864,7.4,19440,268,52,1761,881,26.8,1686.4,blue,0.8,5.5,20,20,red
4494450044,1,4,1,0,0,0,0,14899,7,18183,228,61,-420,138,22.8,1489.9,4,1,1,2,1,1,0,15319,6.8,18045,234,48,420,-138,23.4,1531.9,blue,0.5,5,19,23,red
4524640273,7,5,7,0,0,0,0,16602,7,17918,211,59,888,1005,21.1,1660.2,5,7,4,0,0,0,0,15714,7,16913,227,33,-888,-1005,22.7,1571.4,blue,2.8,1.29,17,23,blue
4493693106,4,11,3,0,0,0,0,14504,6.8,16897,191,40,-3926,-1387,19.1,1450.4,11,4,11,0,0,0,0,18430,6.8,18284,211,40,3926,1387,21.1,1843,red,0.64,5.5,18,18,red
4523309426,10,6,10,0,0,0,0,17332,7,18045,195,42,1711,1235,19.5,1733.2,6,10,3,0,0,0,0,15621,6.6,16810,203,37,-1711,-1235,20.3,1562.1,blue,3.33,0.9,15,15,red
4462628331,7,11,8,0,0,0,0,16749,6.8,17223,226,47,-2320,-1204,22.6,1674.9,11,7,12,2,1,1,0,19069,6.8,18427,207,60,2320,1204,20.7,1906.9,blue,1.36,3.29,19,39,blue
4509275227,6,8,5,1,1,0,0,16423,6.8,16900,204,59,-1900,-1052,20.4,1642.3,8,6,10,1,0,1,0,18323,7,17952,215,44,1900,1052,21.5,1832.3,blue,1.38,3,19,26,red
4492023139,4,8,1,0,0,0,0,15135,6.6,17280,240,54,-1634,-1916,24,1513.5,8,4,7,0,0,0,0,16769,7.4,19196,220,54,1634,1916,22,1676.9,red,0.62,3.75,19,19,blue
4524538726,7,5,5,0,0,0,0,16704,7,18000,225,47,1002,-743,22.5,1670.4,5,7,8,2,1,1,0,15702,7.4,18743,212,62,-1002,743,21.2,1570.2,blue,2.4,1.86,17,16,blue
4470439990,10,6,14,1,1,0,0,17835,7,18791,212,42,1568,1001,21.2,1783.5,6,10,7,0,0,0,0,16267,6.8,17790,209,54,-1568,-1001,20.9,1626.7,blue,4,1.3,13,22,red
4415547977,6,8,4,0,0,0,0,15342,6.6,15988,221,39,-1758,-2010,22.1,1534.2,8,6,10,1,1,0,0,17100,7,17998,226,48,1758,2010,22.6,1710,red,1.25,3,22,23,red
4506087855,6,8,5,1,0,1,0,16022,6.8,17899,206,44,-3063,-1676,20.6,1602.2,8,6,12,1,1,0,0,19085,7.2,19575,240,55,3063,1676,24,1908.5,red,1.38,3.33,24,22,red
4522140067,6,8,10,1,1,0,0,15678,6.6,17592,181,44,-1859,-1340,18.1,1567.8,8,6,6,0,0,0,0,17537,7.2,18932,214,59,1859,1340,21.4,1753.7,red,2,2.33,14,15,red
4509935762,7,11,6,0,0,0,0,16513,7,17530,197,44,-1696,-1187,19.7,1651.3,11,7,12,1,1,0,0,18209,7.2,18717,218,53,1696,1187,21.8,1820.9,red,1.18,3.29,43,19,red
4493753133,7,7,10,0,0,0,0,16095,6.8,17497,228,24,-986,-1163,22.8,1609.5,7,7,6,0,0,0,0,17081,7.2,18660,237,46,986,1163,23.7,1708.1,red,2.43,1.86,16,38,red
4518753838,5,3,5,0,0,0,0,15892,6.8,18043,216,48,822,25,21.6,1589.2,3,5,3,2,1,1,0,15070,7.2,18018,229,55,-822,-25,22.9,1507,red,3.33,1.2,15,14,blue
4524396763,7,9,6,0,0,0,0,16806,6.6,17623,218,49,-369,-1242,21.8,1680.6,9,7,6,1,1,0,0,17175,7.2,18865,200,44,369,1242,20,1717.5,blue,1.44,2.14,22,20,blue
4520934653,8,3,8,0,0,0,0,16847,7.2,18705,195,68,1255,2754,19.5,1684.7,3,8,2,0,0,0,0,15592,6.4,15951,247,33,-1255,-2754,24.7,1559.2,blue,5.33,0.62,16,13,red
4451080922,5,4,3,0,0,0,0,16373,7.2,19296,247,62,317,639,24.7,1637.3,4,5,1,1,1,0,0,16056,7.2,18657,254,52,-317,-639,25.4,1605.6,blue,2,1,23,40,red
4525129730,1,9,2,0,0,0,0,13299,6.4,15911,189,48,-7285,-4379,18.9,1329.9,9,1,17,1,1,0,1,20584,7.6,20290,251,60,7285,4379,25.1,2058.4,red,0.33,26,14,17,red
4516210841,9,6,17,1,1,0,0,18249,7,18327,222,57,1909,-108,22.2,1824.9,6,9,10,0,0,0,0,16340,7,18435,231,34,-1909,108,23.1,1634,blue,4.33,1.78,18,24,blue
4457376464,6,4,9,0,0,0,0,16641,7.2,18364,213,60,1446,446,21.3,1664.1,4,6,3,1,1,0,0,15195,7,17918,218,59,-1446,-446,21.8,1519.5,blue,3.75,1.17,105,61,red
4474770389,5,4,7,1,1,0,0,16359,7,18199,210,64,917,-90,21,1635.9,4,5,4,0,0,0,0,15442,7,18289,218,55,-917,90,21.8,1544.2,blue,3,1.6,21,16,blue
4509889466,7,3,4,1,1,0,0,16956,7,19127,234,43,1712,1983,23.4,1695.6,3,7,5,1,0,1,0,15244,6.8,17144,236,51,-1712,-1983,23.6,1524.4,blue,3.67,1.14,20,20,blue
4524454688,7,4,9,0,0,0,0,16992,7,18716,224,36,1582,1344,22.4,1699.2,4,7,6,1,1,0,0,15410,7,17372,209,47,-1582,-1344,20.9,1541,blue,4,1.43,24,24,blue
4446215269,5,12,4,0,0,0,0,16154,6.8,18081,216,44,-2129,-2255,21.6,1615.4,12,5,12,0,0,0,0,18283,7.4,20336,206,72,2129,2255,20.6,1828.3,red,0.75,4.8,13,27,red
4510920769,13,4,13,2,1,1,0,19755,7.4,20163,207,60,5240,5663,20.7,1975.5,4,13,2,0,0,0,0,14515,6,14500,220,11,-5240,-5663,22,1451.5,blue,6.5,0.46,14,15,blue
4490077553,4,2,4,0,0,0,0,16181,7,18426,261,49,873,-52,26.1,1618.1,2,4,2,2,1,1,0,15308,7.2,18478,249,61,-873,52,24.9,1530.8,blue,4,1,17,16,blue
4524960112,4,8,6,0,0,0,0,15263,6.8,16941,203,50,-2548,-2906,20.3,1526.3,8,4,14,1,1,0,0,17811,7.2,19847,232,62,2548,2906,23.2,1781.1,red,1.25,5.5,24,38,blue
4448713389,10,5,9,1,1,0,0,18889,7.4,19825,257,56,3136,2512,25.7,1888.9,5,10,6,0,0,0,0,15753,6.8,17313,175,59,-3136,-2512,17.5,1575.3,red,3.8,1.1,25,18,blue
4516238539,8,2,10,1,1,0,0,19630,7.2,20181,246,64,5082,2398,24.6,1963,2,8,2,0,0,0,0,14548,6.8,17783,226,60,-5082,-2398,22.6,1454.8,blue,9,0.5,16,16,blue
4515242299,4,10,1,0,0,0,0,16172,6.8,18087,219,69,-1867,555,21.9,1617.2,10,4,18,0,0,0,0,18039,6.8,17532,202,60,1867,-555,20.2,1803.9,blue,0.5,7,16,18,red
4518736479,7,7,6,0,0,0,0,17345,7,19182,226,56,179,953,22.6,1734.5,7,7,5,0,0,0,0,17166,7,18229,252,44,-179,-953,25.2,1716.6,red,1.86,1.71,14,18,blue
4491194203,10,5,15,0,0,0,0,17688,7.2,19492,197,48,1937,2816,19.7,1768.8,5,10,4,0,0,0,0,15751,6.8,16676,192,44,-1937,-2816,19.2,1575.1,blue,5,0.9,27,51,red
4522653633,1,3,1,0,0,0,0,14859,6.8,17412,225,51,-520,-1073,22.5,1485.9,3,1,3,1,1,0,0,15379,7,18485,228,60,520,1073,22.8,1537.9,red,0.67,6,38,23,blue
4515525902,9,4,15,1,1,0,0,18144,6.8,18210,224,52,1834,281,22.4,1814.4,4,9,4,0,0,0,0,16310,7,17929,231,42,-1834,-281,23.1,1631,blue,6,0.89,19,42,blue
4495641349,5,4,6,0,0,0,0,16400,6.8,17409,222,40,492,-1509,22.2,1640,4,5,6,1,1,0,0,15908,7.2,18918,220,58,-492,1509,22,1590.8,red,2.75,2,20,16,red
4504189660,2,4,3,0,0,0,0,14779,6.6,16944,214,64,-1024,-571,21.4,1477.9,4,2,5,1,1,0,0,15803,7,17515,227,52,1024,571,22.7,1580.3,red,1.25,4.5,18,17,blue
4513367721,5,3,5,1,0,1,0,16128,7,17286,226,62,822,363,22.6,1612.8,3,5,5,0,0,0,0,15306,6.6,16923,229,44,-822,-363,22.9,1530.6,red,3.33,1.6,19,21,blue
4471506446,18,4,14,2,1,1,0,21416,7.6,21031,235,57,7482,6466,23.5,2141.6,4,18,3,0,0,0,0,13934,6,14565,144,39,-7482,-6466,14.4,1393.4,blue,8,0.39,24,16,blue
4450720876,2,4,3,0,0,0,0,14592,7,17915,217,60,-2168,-1356,21.7,1459.2,4,2,7,1,1,0,0,16760,7.2,19271,221,76,2168,1356,22.1,1676,blue,1.25,5.5,18,19,red
4427497326,8,6,11,0,0,0,0,17483,7.2,18392,215,36,1232,-128,21.5,1748.3,6,8,7,0,0,0,0,16251,7.2,18520,233,48,-1232,128,23.3,1625.1,blue,3.17,1.62,21,22,blue
4522544095,4,10,5,0,0,0,0,16205,6.8,17509,234,52,-3102,-2025,23.4,1620.5,10,4,12,1,1,0,0,19307,7.4,19534,235,51,3102,2025,23.5,1930.7,red,0.9,5.5,16,21,red
4524917684,8,9,6,0,0,0,1,18363,7.2,18592,224,52,321,368,22.4,1836.3,9,8,12,0,0,0,0,18042,7,18224,215,44,-321,-368,21.5,1804.2,blue,1.56,2.62,18,20,red
4421884287,9,8,19,1,1,0,0,18401,7,18207,237,51,506,620,23.7,1840.1,8,9,13,0,0,0,0,17895,7,17587,239,44,-506,-620,23.9,1789.5,blue,3.5,2.33,24,19,blue
4522467340,6,5,5,0,0,0,0,16391,6.8,17693,222,44,709,946,22.2,1639.1,5,6,6,0,0,0,0,15682,6.8,16747,188,59,-709,-946,18.8,1568.2,blue,2.2,1.83,24,43,red
4522435963,7,3,7,1,1,0,0,16409,7.4,19634,215,51,1261,2149,21.5,1640.9,3,7,4,0,0,0,0,15148,7,17485,242,56,-1261,-2149,24.2,1514.8,blue,4.67,1,29,100,red
4424123529,8,3,5,0,0,0,0,16739,7.4,19178,218,54,1630,1005,21.8,1673.9,3,8,3,0,0,0,0,15109,7,18173,196,64,-1630,-1005,19.6,1510.9,blue,4.33,0.75,18,34,blue
4522641245,4,6,5,0,0,0,0,15986,6.8,17620,212,52,-46,-1226,21.2,1598.6,6,4,4,1,1,0,0,16032,7.2,18846,229,52,46,1226,22.9,1603.2,blue,1.5,2.5,93,17,blue
4519452833,3,4,4,1,1,0,0,14267,6.6,17033,186,58,-1190,-762,18.6,1426.7,4,3,3,0,0,0,0,15457,7,17795,206,44,1190,762,20.6,1545.7,red,1.75,2.33,22,21,red
4524973886,2,5,4,1,1,0,0,14692,6.8,16959,226,55,-1488,-572,22.6,1469.2,5,2,6,0,0,0,0,16180,6.8,17531,234,55,1488,572,23.4,1618,red,1.2,5.5,60,22,blue
4491667305,6,6,4,0,0,0,0,17045,7.2,18787,245,56,848,129,24.5,1704.5,6,6,8,0,0,0,0,16197,7,18658,192,52,-848,-129,19.2,1619.7,red,1.67,2.33,17,14,blue
4523353558,1,7,0,0,0,0,0,13633,6.4,16221,202,53,-5800,-3960,20.2,1363.3,7,1,15,1,1,0,1,19433,7.6,20181,245,74,5800,3960,24.5,1943.3,red,0.14,22,17,13,red
4523617002,11,11,13,0,0,0,0,18592,6.8,17780,213,44,981,42,21.3,1859.2,11,11,13,1,1,0,0,17611,7,17738,197,42,-981,-42,19.7,1761.1,red,2.18,2.18,14,15,red
4495172463,4,6,5,0,0,0,0,15154,6.6,17363,170,56,-2642,-1908,17,1515.4,6,4,7,1,1,0,0,17796,7.2,19271,258,64,2642,1908,25.8,1779.6,blue,1.5,3.25,12,18,red
4523420672,4,7,6,0,0,0,0,16045,7,17984,229,56,-794,-1320,22.9,1604.5,7,4,6,0,0,0,0,16839,7.2,19304,228,56,794,1320,22.8,1683.9,red,1.43,3.25,26,18,blue
4494792014,8,8,8,1,1,0,0,17137,6.8,17147,195,56,-718,-1666,19.5,1713.7,8,8,8,0,0,0,0,17855,7,18813,215,61,718,1666,21.5,1785.5,blue,2,2,14,13,red
4521533129,4,7,5,1,1,0,0,14559,6.8,16634,200,52,-1833,-2171,20,1455.9,7,4,4,0,0,0,0,16392,7.4,18805,215,48,1833,2171,21.5,1639.2,red,1.29,2.75,13,50,red
4472461570,2,5,2,0,0,0,0,14758,6.8,16974,237,50,-1369,-1808,23.7,1475.8,5,2,2,1,0,1,0,16127,7.2,18782,242,57,1369,1808,24.2,1612.7,red,0.8,3.5,49,19,red
4521488040,9,6,11,0,0,0,0,18508,7.4,19340,239,51,2625,1026,23.9,1850.8,6,9,3,1,0,1,0,15883,7,18314,207,51,-2625,-1026,20.7,1588.3,red,3.33,1,36,31,blue
4470033546,3,12,5,0,0,0,0,15978,6.2,15862,192,46,-2818,-3710,19.2,1597.8,12,3,11,1,1,0,0,18796,7.2,19572,211,66,2818,3710,21.1,1879.6,red,0.67,7.67,15,17,red
4465145737,8,5,9,0,0,0,0,17759,7.2,18407,232,44,2450,216,23.2,1775.9,5,8,5,1,1,0,0,15309,6.8,18191,174,60,-2450,-216,17.4,1530.9,blue,3.4,1.25,14,54,blue
4517673973,8,2,10,1,1,0,1,18590,6.6,18032,237,48,3618,1086,23.7,1859,2,8,1,0,0,0,0,14972,6.6,16946,238,43,-3618,-1086,23.8,1497.2,blue,9,0.38,50,16,blue
4495913544,9,9,4,1,0,1,0,16749,6.4,16518,172,52,-645,-2890,17.2,1674.9,9,9,7,1,1,0,0,17394,7,19408,202,48,645,2890,20.2,1739.4,red,1.44,1.78,15,19,blue
4524572866,7,2,8,0,0,0,0,17314,7.2,18785,207,47,3307,1705,20.7,1731.4,2,7,3,2,1,1,0,14007,7,17080,195,48,-3307,-1705,19.5,1400.7,blue,7.5,0.71,26,19,blue
4521092176,11,12,12,1,0,1,0,18983,6.8,17893,211,44,2457,255,21.1,1898.3,12,11,10,1,1,0,0,16526,7,17638,175,42,-2457,-255,17.5,1652.6,blue,1.92,2,32,39,red
4524338050,6,9,6,0,0,0,0,16325,6.4,16171,199,48,-852,-2912,19.9,1632.5,9,6,4,1,1,0,0,17177,7.2,19083,203,71,852,2912,20.3,1717.7,red,1.33,2.17,14,14,blue
4523735052,3,8,2,0,0,0,0,14478,6.6,16879,205,44,-2153,-2381,20.5,1447.8,8,3,8,2,1,1,0,16631,7.2,19260,215,52,2153,2381,21.5,1663.1,red,0.62,5.33,17,88,red
4516510079,2,11,2,1,1,0,0,14099,6.6,16884,201,59,-3938,-2767,20.1,1409.9,11,2,8,0,0,0,0,18037,7.2,19651,218,53,3938,2767,21.8,1803.7,red,0.36,9.5,35,19,red
4524907104,4,7,6,2,1,1,0,16234,7,18544,218,58,-449,-83,21.8,1623.4,7,4,5,0,0,0,0,16683,7.2,18627,202,60,449,83,20.2,1668.3,red,1.43,3,37,20,red
4457745439,7,11,5,1,1,0,0,17892,7.2,18922,205,72,273,1428,20.5,1789.2,11,7,14,0,0,0,0,17619,6.8,17494,191,31,-273,-1428,19.1,1761.9,red,1.09,3.57,14,44,red
4445240846,7,5,6,1,1,0,0,16304,6.8,17968,230,43,0,845,23,1630.4,5,7,8,0,0,0,0,16304,6.6,17123,234,44,0,-845,23.4,1630.4,red,2.6,1.86,18,18,red
4508349018,8,10,10,1,0,1,0,16688,6.8,17007,201,51,-1198,-768,20.1,1668.8,10,8,14,1,1,0,0,17886,7.2,17775,209,49,1198,768,20.9,1788.6,blue,1.8,3,16,22,red
4512263036,11,6,14,2,1,1,0,18894,6.8,17315,201,51,3536,1244,20.1,1889.4,6,11,5,0,0,0,0,15358,6.6,16071,187,36,-3536,-1244,18.7,1535.8,blue,4.17,1,38,51,blue
4494430397,5,9,3,0,0,0,0,15761,6.8,16587,200,36,-1632,-1461,20,1576.1,9,5,7,0,0,0,0,17393,7,18048,212,28,1632,1461,21.2,1739.3,red,0.89,3.2,35,20,blue
4524898178,4,10,4,0,0,0,0,15028,6.8,17417,207,52,-3472,-2256,20.7,1502.8,10,4,5,1,1,0,0,18500,7.4,19673,230,52,3472,2256,23,1850,red,0.8,3.75,13,20,red
4487058187,9,1,9,1,1,0,0,17239,7.2,19459,232,46,3497,3543,23.2,1723.9,1,9,2,0,0,0,0,13742,6.4,15916,223,53,-3497,-3543,22.3,1374.2,blue,18,0.33,20,17,blue
4514719397,1,5,1,0,0,0,0,14181,6.8,17487,234,49,-2489,-1271,23.4,1418.1,5,1,7,0,0,0,0,16670,7,18758,253,49,2489,1271,25.3,1667,red,0.4,12,16,19,red
4524953398,5,13,3,0,0,0,0,15557,6.6,16910,190,65,-4197,-2772,19,1555.7,13,5,20,1,1,0,0,19754,7.2,19682,228,46,4197,2772,22.8,1975.4,red,0.62,6.6,17,21,blue
4522097208,6,3,7,1,1,0,0,16067,6.4,16652,218,42,841,-1456,21.8,1606.7,3,6,1,0,0,0,0,15226,7,18108,246,53,-841,1456,24.6,1522.6,red,4.33,0.67,17,23,blue
4520686446,6,4,10,1,1,0,0,16386,6.6,17424,216,45,742,-654,21.6,1638.6,4,6,3,0,0,0,0,15644,6.8,18078,255,37,-742,654,25.5,1564.4,red,4,1.17,19,21,red
4450814847,9,3,8,0,0,0,0,17997,7.6,20432,210,56,3087,2543,21,1799.7,3,9,4,1,1,0,0,14910,7.2,17889,225,60,-3087,-2543,22.5,1491,red,5.67,0.78,19,42,blue
4523456850,5,11,3,0,0,0,1,15961,6.6,16916,199,36,-2066,3,19.9,1596.1,11,5,14,1,1,0,0,18027,6.8,16913,200,56,2066,-3,20,1802.7,red,0.73,5,16,13,red
4448491393,0,6,0,0,0,0,0,13395,6.8,16282,207,47,-3275,-3254,20.7,1339.5,6,0,5,0,0,0,0,16670,7.2,19536,257,40,3275,3254,25.7,1667,red,0,12.65,22,23,red
4522600992,5,5,3,1,0,1,0,17048,7.2,18886,249,51,1337,885,24.9,1704.8,5,5,4,0,0,0,0,15711,7,18001,199,64,-1337,-885,19.9,1571.1,red,1.6,1.8,22,16,red
4458543967,8,4,14,1,1,0,0,16924,6.6,17168,194,59,1258,-124,19.4,1692.4,4,8,5,0,0,0,0,15666,6.8,17292,220,52,-1258,124,22,1566.6,blue,5.5,1.12,16,13,blue
4445189250,2,5,1,1,1,0,0,14902,7,17656,242,44,-1186,-892,24.2,1490.2,5,2,6,0,0,0,0,16088,7,18548,215,47,1186,892,21.5,1608.8,red,0.6,5.5,21,18,blue
4455545387,3,11,4,0,0,0,0,14341,6.6,16688,184,64,-5295,-3863,18.4,1434.1,11,3,10,1,1,0,0,19636,7.6,20551,260,64,5295,3863,26,1963.6,red,0.64,7,15,21,red
4512309053,10,7,7,0,0,0,0,17984,7.2,18275,229,44,2086,1202,22.9,1798.4,7,10,5,0,0,0,0,15898,6.8,17073,189,39,-2086,-1202,18.9,1589.8,red,2.43,1.2,22,21,red
4524922890,5,12,7,0,0,0,0,15893,6.8,17285,202,35,-3909,-1904,20.2,1589.3,12,5,13,1,0,1,0,19802,7.2,19189,228,35,3909,1904,22.8,1980.2,red,1,5,46,22,red
4520572542,5,5,10,1,1,0,0,16138,6.6,16397,208,54,-732,-813,20.8,1613.8,5,5,4,1,0,1,1,16870,6.8,17210,218,40,732,813,21.8,1687,blue,3,1.8,21,17,red
4466130719,6,2,9,2,1,1,0,16260,6.8,17559,224,49,1481,528,22.4,1626,2,6,5,0,0,0,0,14779,6.6,17031,195,64,-1481,-528,19.5,1477.9,red,7.5,1.17,17,18,red
4519467350,6,7,10,2,1,1,0,15931,7,17903,202,48,-1613,-836,20.2,1593.1,7,6,10,0,0,0,0,17544,7.2,18739,217,58,1613,836,21.7,1754.4,red,2.29,2.83,15,18,red
4524708254,8,5,16,2,1,1,0,16693,6.4,16725,187,32,2123,1219,18.7,1669.3,5,8,1,0,0,0,0,14570,6.2,15506,172,51,-2123,-1219,17.2,1457,blue,4.8,0.75,21,17,blue
4524995647,9,4,6,2,1,1,0,18200,7.2,19696,247,44,2756,2028,24.7,1820,4,9,5,0,0,0,0,15444,7,17668,208,51,-2756,-2028,20.8,1544.4,blue,3.75,1,22,19,blue
4510877210,5,6,6,0,0,0,0,15771,6.8,16977,237,38,-1091,-1990,23.7,1577.1,6,5,5,0,0,0,0,16862,7.2,18967,226,46,1091,1990,22.6,1686.2,red,1.83,2.2,17,22,red
4515910703,6,7,8,1,1,0,0,16682,6.8,17677,197,44,-970,-482,19.7,1668.2,7,6,8,0,0,0,0,17652,7,18159,227,43,970,482,22.7,1765.2,blue,2,2.5,16,22,blue
4477266895,15,5,17,0,0,0,0,19074,6.6,17514,191,35,3941,2200,19.1,1907.4,5,15,3,0,0,0,0,15133,6.6,15314,199,40,-3941,-2200,19.9,1513.3,blue,6.4,0.53,29,24,blue
4524342553,10,5,14,1,1,0,0,19052,7.2,19366,226,64,3754,2642,22.6,1905.2,5,10,7,0,0,0,0,15298,6.8,16724,215,47,-3754,-2642,21.5,1529.8,blue,4.8,1.2,21,19,blue
4523414264,5,9,7,0,0,0,0,15220,6.4,16145,174,46,-3679,-3273,17.4,1522,9,5,11,0,0,0,0,18899,7,19418,266,64,3679,3273,26.6,1889.9,blue,1.33,4,68,16,red
4523908586,11,5,9,1,1,0,0,18604,7.4,20075,214,53,2998,3108,21.4,1860.4,5,11,4,0,0,0,0,15606,7,16967,203,42,-2998,-3108,20.3,1560.6,blue,4,0.82,14,17,red
4524888119,4,5,3,1,1,0,0,15131,6.8,17618,223,44,-735,46,22.3,1513.1,5,4,5,0,0,0,0,15866,7,17572,221,55,735,-46,22.1,1586.6,blue,1.4,2.5,15,19,red
4445477359,1,11,1,0,0,0,0,12789,6.4,15191,157,48,-6470,-5355,15.7,1278.9,11,1,13,1,1,0,0,19259,7.4,20546,256,63,6470,5355,25.6,1925.9,red,0.18,24,20,17,red
4524656905,9,8,10,1,1,0,0,17586,7.2,18812,227,56,319,1558,22.7,1758.6,8,9,6,0,0,0,0,17267,6.8,17254,232,35,-319,-1558,23.2,1726.7,red,2.38,1.56,19,17,red
4525013818,8,8,7,0,0,0,0,16072,6.6,16342,214,42,-1247,-835,21.4,1607.2,8,8,12,1,1,0,0,17319,6.6,17177,229,41,1247,835,22.9,1731.9,blue,1.88,2.5,15,23,red
4521490447,8,5,8,1,0,1,0,17473,7,18577,228,48,1179,-736,22.8,1747.3,5,8,5,0,0,0,0,16294,7.4,19313,225,52,-1179,736,22.5,1629.4,blue,3.2,1.25,85,39,blue
4519250621,5,6,4,0,0,0,0,15693,6.8,17493,230,48,-1285,-2097,23,1569.3,6,5,7,2,1,1,0,16978,7.4,19590,236,58,1285,2097,23.6,1697.8,red,1.5,2.6,21,42,blue
4487077116,4,3,5,0,0,0,0,16079,7,18772,221,54,752,1388,22.1,1607.9,3,4,5,1,1,0,0,15327,6.6,17384,223,52,-752,-1388,22.3,1532.7,blue,3,2,17,25,red
4493432338,8,5,8,0,0,0,0,17109,7.2,18272,247,40,2006,2256,24.7,1710.9,5,8,7,0,0,0,0,15103,6.6,16016,200,36,-2006,-2256,20,1510.3,blue,3.2,1.5,27,21,red
4524714438,6,5,9,0,0,0,0,15890,6.6,16918,170,48,-902,-1082,17,1589,5,6,5,0,0,0,0,16792,7,18000,227,58,902,1082,22.7,1679.2,blue,3,1.67,28,15,blue
4521611632,7,6,11,2,1,1,0,17410,7.2,18496,239,62,1590,971,23.9,1741,6,7,8,0,0,0,0,15820,7,17525,216,46,-1590,-971,21.6,1582,blue,3,2,11,12,blue
4520750319,9,5,8,1,1,0,0,17491,7.2,19706,216,53,2599,3321,21.6,1749.1,5,9,3,0,0,0,0,14892,6.4,16385,189,47,-2599,-3321,18.9,1489.2,blue,3.4,0.89,13,16,red
4506182731,8,1,9,1,0,1,0,17887,7.2,19263,221,56,4590,3681,22.1,1788.7,1,8,1,0,0,0,0,13297,6.4,15582,213,40,-4590,-3681,21.3,1329.7,blue,17,0.25,18,22,blue
4435256740,7,4,5,1,1,0,0,17030,7.2,19832,250,49,1207,1638,25,1703,4,7,8,0,0,0,0,15823,7,18194,234,46,-1207,-1638,23.4,1582.3,red,3,1.71,19,42,blue
4515894243,4,3,3,1,1,0,0,15762,7.2,19056,240,56,229,398,24,1576.2,3,4,4,0,0,0,0,15533,7.2,18658,239,60,-229,-398,23.9,1553.3,red,2.33,1.75,14,13,blue
4519851176,3,5,2,1,1,0,0,14444,6.4,16768,231,27,-1501,-878,23.1,1444.4,5,3,4,0,0,0,0,15945,7,17646,215,47,1501,878,21.5,1594.5,red,1,3,17,21,red
4523819154,13,7,14,0,0,0,1,20294,7,17966,216,45,3903,1239,21.6,2029.4,7,13,5,0,0,0,0,16391,6.8,16727,171,44,-3903,-1239,17.1,1639.1,blue,3.86,0.92,16,15,red
4431859691,7,3,7,0,0,0,0,16592,7,19045,220,40,1709,880,22,1659.2,3,7,1,1,1,0,0,14883,7.2,18165,203,60,-1709,-880,20.3,1488.3,blue,4.67,0.57,21,17,red
4494978251,5,5,7,1,1,0,0,16291,6.8,17415,211,56,-699,-580,21.1,1629.1,5,5,3,1,0,1,1,16990,6.8,17995,218,44,699,580,21.8,1699,red,2.4,1.6,19,40,red
4432336301,2,7,1,0,0,0,0,14639,6.6,16690,222,40,-2862,-3209,22.2,1463.9,7,2,12,1,1,0,0,17501,7.6,19899,237,62,2862,3209,23.7,1750.1,red,0.43,9.5,21,20,blue
4513519782,7,8,5,0,0,0,0,16447,7.4,19247,215,52,-1422,345,21.5,1644.7,8,7,10,1,1,0,0,17869,7.2,18902,244,48,1422,-345,24.4,1786.9,blue,1.5,2.57,18,17,red
4519837274,7,6,9,1,1,0,0,16147,6.6,17632,201,45,-666,-290,20.1,1614.7,6,7,7,0,0,0,0,16813,7.2,17922,217,55,666,290,21.7,1681.3,blue,2.67,1.86,16,17,blue
4479366531,3,2,4,0,0,0,0,15751,7,18853,252,56,991,1570,25.2,1575.1,2,3,2,0,0,0,0,14760,6.8,17283,222,56,-991,-1570,22.2,1476,blue,3.5,1.33,36,21,blue
4510604428,1,8,1,0,0,0,0,14742,6.8,16872,219,51,-2177,-2726,21.9,1474.2,8,1,15,2,1,1,0,16919,7.2,19598,197,61,2177,2726,19.7,1691.9,red,0.25,23,17,15,blue
4502653498,6,6,12,1,1,0,0,16618,6.8,17463,192,54,1354,1326,19.2,1661.8,6,6,12,0,0,0,0,15264,6.6,16137,203,31,-1354,-1326,20.3,1526.4,blue,3,3,20,19,red
4451378349,9,15,7,0,0,0,0,17492,7.2,19413,189,60,-1988,-616,18.9,1749.2,15,9,17,2,1,1,0,19480,7.4,20029,204,56,1988,616,20.4,1948,red,1.07,3.56,14,53,red
4440086244,11,3,13,1,1,0,0,18208,7.4,19838,219,56,3199,2629,21.9,1820.8,3,11,2,0,0,0,0,15009,6.8,17209,209,41,-3199,-2629,20.9,1500.9,blue,8,0.45,16,39,blue
4511859865,3,3,2,1,1,0,0,15584,6.8,17413,230,68,639,-470,23,1558.4,3,3,2,1,0,1,0,14945,7,17883,215,44,-639,470,21.5,1494.5,blue,1.67,1.67,20,37,red
4516533526,8,4,11,2,1,1,0,17094,6.8,17845,202,45,1509,-543,20.2,1709.4,4,8,4,0,0,0,0,15585,7,18388,220,60,-1509,543,22,1558.5,blue,4.75,1,36,17,blue
4521949679,6,7,8,1,1,0,0,15307,6.4,15025,175,48,-660,-922,17.5,1530.7,7,6,12,0,0,0,0,15967,6.4,15947,171,37,660,922,17.1,1596.7,red,2,3.17,16,45,blue
4521560352,1,8,2,0,0,0,0,13880,6.2,15178,191,54,-3063,-2326,19.1,1388,8,1,9,1,1,0,0,16943,6.8,17504,187,40,3063,2326,18.7,1694.3,red,0.38,17,17,48,red
4497457937,4,8,4,0,0,0,0,16059,7,18190,221,41,-1521,-2185,22.1,1605.9,8,4,14,1,1,0,0,17580,7.4,20375,246,50,1521,2185,24.6,1758,blue,1,5.5,44,43,blue
4519701142,2,6,3,1,1,0,0,15471,7.2,18538,228,65,-814,1199,22.8,1547.1,6,2,10,0,0,0,0,16285,6.8,17339,225,47,814,-1199,22.5,1628.5,red,0.83,8,18,23,red
4525058133,12,8,17,1,1,0,0,19198,6.6,17559,199,46,3024,2225,19.9,1919.8,8,12,15,0,0,0,0,16174,6.4,15334,176,34,-3024,-2225,17.6,1617.4,blue,3.62,1.92,19,52,red
4524469439,8,10,7,1,1,0,0,16576,7,17437,226,34,-1147,-1294,22.6,1657.6,10,8,11,0,0,0,0,17723,7.2,18731,210,35,1147,1294,21,1772.3,blue,1.5,2.62,18,22,blue
4520720657,3,3,3,1,0,1,0,16076,7,18079,238,52,1113,1392,23.8,1607.6,3,3,2,1,1,0,0,14963,6.6,16687,185,64,-1113,-1392,18.5,1496.3,blue,2,1.67,21,14,red
4480560501,6,4,7,0,0,0,0,16041,6.8,18070,223,48,550,1023,22.3,1604.1,4,6,5,1,1,0,0,15491,6.6,17047,214,40,-550,-1023,21.4,1549.1,blue,3.25,1.5,19,89,red
4452777029,4,3,8,1,1,0,0,15714,7,17817,230,49,589,675,23,1571.4,3,4,6,1,0,1,0,15125,6.8,17142,199,67,-589,-675,19.9,1512.5,red,4,2.25,19,18,red
4513297103,4,14,4,1,0,1,0,14608,6,15029,188,44,-7480,-4460,18.8,1460.8,14,4,15,1,1,0,1,22088,7.4,19489,218,56,7480,4460,21.8,2208.8,red,0.57,7.25,16,19,red
4523109527,3,5,3,0,0,0,0,15001,7,17799,218,48,-685,-1871,21.8,1500.1,5,3,2,1,0,1,0,15686,7.2,19670,214,64,685,1871,21.4,1568.6,red,1.2,2.33,93,19,blue
4510678710,5,7,5,0,0,0,0,14459,6.4,14990,182,40,-2251,-2427,18.2,1445.9,7,5,10,1,1,0,0,16710,6.8,17417,198,60,2251,2427,19.8,1671,red,1.43,3.4,18,21,red
4491485082,3,2,5,1,0,1,0,14783,6.6,16564,205,54,401,95,20.5,1478.3,2,3,4,1,1,0,0,14382,6.8,16469,209,42,-401,-95,20.9,1438.2,red,4,2,27,24,blue
4505728929,3,4,2,0,0,0,0,15211,6.8,18224,234,53,-834,-1333,23.4,1521.1,4,3,2,1,1,0,0,16045,7.4,19557,217,73,834,1333,21.7,1604.5,red,1.25,2,38,20,blue
4524848216,6,8,4,0,0,0,0,15589,6.6,16619,181,40,-1535,-2054,18.1,1558.9,8,6,10,1,0,1,0,17124,7,18673,210,56,1535,2054,21,1712.4,red,1.25,3,38,39,red
4465674600,4,9,1,1,1,0,0,16223,6.8,17597,222,63,-2086,-1696,22.2,1622.3,9,4,8,0,0,0,0,18309,7,19293,228,52,2086,1696,22.8,1830.9,red,0.56,4.25,21,18,blue
4521553541,7,7,6,1,1,0,0,16375,7.2,18784,217,55,-270,-1095,21.7,1637.5,7,7,4,1,0,1,0,16645,7.4,19879,209,52,270,1095,20.9,1664.5,blue,1.86,1.57,16,14,blue
4519515708,11,1,18,1,1,0,0,18190,7.6,20017,225,65,4069,3954,22.5,1819,1,11,1,0,0,0,0,14121,6.6,16063,224,51,-4069,-3954,22.4,1412.1,blue,29,0.18,20,21,blue
4519078225,8,7,7,1,0,1,1,19120,7,19644,248,43,2171,1375,24.8,1912,7,8,7,1,1,0,0,16949,7,18269,217,56,-2171,-1375,21.7,1694.9,red,2.14,1.75,91,23,blue
4505621420,3,7,2,1,0,1,1,16532,6.8,18522,245,52,151,878,24.5,1653.2,7,3,9,1,1,0,0,16381,7,17644,215,40,-151,-878,21.5,1638.1,red,0.71,5.33,17,47,red
4513650091,8,3,4,1,0,1,1,19224,7.6,20086,225,56,4674,2219,22.5,1922.4,3,8,4,1,1,0,0,14550,7,17867,189,64,-4674,-2219,18.9,1455,red,4,0.88,22,37,blue
4503214718,1,2,1,0,0,0,0,13993,6.6,16977,213,43,-961,-1080,21.3,1399.3,2,1,2,1,0,1,0,14954,7,18057,235,63,961,1080,23.5,1495.4,red,1,4,22,40,blue
4512586696,4,6,8,0,0,0,0,15235,6.8,17736,208,59,-1089,378,20.8,1523.5,6,4,8,1,1,0,0,16324,6.6,17358,208,50,1089,-378,20.8,1632.4,blue,2,3.5,23,21,red
4520417782,12,6,12,0,0,0,0,17839,7,18147,158,43,1278,816,15.8,1783.9,6,12,2,0,0,0,0,16561,7,17331,200,48,-1278,-816,20,1656.1,blue,4,0.67,13,15,red
4493896445,6,1,8,0,0,0,0,16932,7.4,19607,243,55,2545,1922,24.3,1693.2,1,6,1,0,0,0,0,14387,6.8,17685,240,56,-2545,-1922,24,1438.7,blue,14,0.33,23,17,red
4491385625,6,11,7,1,1,0,0,15990,6.4,16813,191,44,-1800,-1035,19.1,1599,11,6,11,0,0,0,0,17790,7,17848,217,47,1800,1035,21.7,1779,blue,1.18,3.67,19,28,red
4467563573,8,6,15,1,1,0,0,16501,6.2,15376,190,27,-383,-667,19,1650.1,6,8,9,0,0,0,0,16884,6.6,16043,229,50,383,667,22.9,1688.4,red,3.83,1.88,21,21,red
4498236446,4,8,4,1,1,0,0,16193,7.4,19464,225,76,-420,1215,22.5,1619.3,8,4,8,0,0,0,0,16613,7.2,18249,207,32,420,-1215,20.7,1661.3,blue,1,4,16,17,red
4489628926,3,3,3,0,0,0,0,14696,6.2,14840,185,50,-1033,-1797,18.5,1469.6,3,3,5,0,0,0,0,15729,6.8,16637,217,48,1033,1797,21.7,1572.9,red,2,2.67,19,38,red
4500848108,2,5,1,1,1,0,0,13980,6.8,16415,221,52,-1860,-1622,22.1,1398,5,2,7,0,0,0,0,15840,7.2,18037,210,40,1860,1622,21,1584,red,0.6,6,18,21,red
4523591630,4,3,5,0,0,0,0,15132,6.8,17330,197,53,-1487,-473,19.7,1513.2,3,4,4,0,0,0,0,16619,7,17803,235,64,1487,473,23.5,1661.9,red,3,1.75,19,20,red
4515862927,5,9,8,1,0,1,0,14927,6.6,16626,194,44,-3214,-2318,19.4,1492.7,9,5,11,1,1,0,0,18141,7,18944,239,39,3214,2318,23.9,1814.1,red,1.44,4,22,22,blue
4523860316,6,8,10,0,0,0,0,17394,7,18465,213,68,-14,-776,21.3,1739.4,8,6,8,2,1,1,0,17408,7.2,19241,215,63,14,776,21.5,1740.8,red,2,2.67,34,45,red
4508952905,3,4,2,0,0,0,0,14961,7,18313,230,52,33,817,23,1496.1,4,3,3,1,1,0,0,14928,7,17496,191,55,-33,-817,19.1,1492.8,red,1.25,2.33,18,29,red
4524741088,5,8,3,1,1,0,0,15256,6.6,16807,192,55,-1857,-2651,19.2,1525.6,8,5,10,0,0,0,0,17113,7.4,19458,209,58,1857,2651,20.9,1711.3,red,1,3.6,19,16,blue
4520989053,5,9,2,1,0,1,0,16235,7.2,18790,213,67,-1126,-601,21.3,1623.5,9,5,6,1,1,0,0,17361,7.2,19391,230,44,1126,601,23,1736.1,red,0.78,3,87,22,blue
4519161912,6,11,9,0,0,0,0,15536,6.4,15213,179,31,-4562,-3519,17.9,1553.6,11,6,14,2,1,1,1,20098,7.2,18732,226,51,4562,3519,22.6,2009.8,red,1.36,4.17,18,25,red
4521683040,6,6,14,1,1,0,0,16805,7,18793,230,63,11,64,23,1680.5,6,6,7,0,0,0,0,16794,7.2,18729,223,56,-11,-64,22.3,1679.4,blue,3.33,2.17,48,33,blue
4515256232,4,10,5,0,0,0,0,15684,6.6,17047,240,44,-2797,-2649,24,1568.4,10,4,9,1,1,0,0,18481,7.4,19696,220,66,2797,2649,22,1848.1,red,0.9,4.75,17,17,blue
4510123428,10,10,14,0,0,0,0,17207,6.8,17379,179,40,519,-748,17.9,1720.7,10,10,5,0,0,0,0,16688,7.2,18127,188,55,-519,748,18.8,1668.8,red,2.4,1.5,20,27,blue
4516541142,8,6,12,0,0,0,0,17106,7,17729,206,51,1192,779,20.6,1710.6,6,8,9,0,0,0,0,15914,6.8,16950,217,47,-1192,-779,21.7,1591.4,blue,3.33,1.88,15,9,blue
4482346658,5,1,6,1,1,0,0,18002,7.2,19467,254,76,3761,2092,25.4,1800.2,1,5,1,0,0,0,0,14241,6.8,17375,248,48,-3761,-2092,24.8,1424.1,blue,11,0.4,21,21,blue
4501257883,5,3,9,0,0,0,0,16725,7,18674,228,66,1279,384,22.8,1672.5,3,5,1,1,1,0,0,15446,7,18290,251,52,-1279,-384,25.1,1544.6,red,4.67,0.8,21,21,blue
4498209224,7,7,15,0,0,0,0,17045,7,17969,214,48,-883,-1495,21.4,1704.5,7,7,7,0,0,0,0,17928,7.2,19464,250,52,883,1495,25,1792.8,red,3.14,2,21,23,blue
4477622010,2,12,3,1,1,0,0,13902,6.6,16677,173,60,-4535,-3079,17.3,1390.2,12,2,10,0,0,0,0,18437,7.2,19756,240,47,4535,3079,24,1843.7,red,0.42,11,18,21,red
4518337928,13,4,12,1,1,0,1,21986,7.4,20283,263,58,7242,4995,26.3,2198.6,4,13,5,1,0,1,0,14744,6.2,15288,168,40,-7242,-4995,16.8,1474.4,blue,6.25,0.69,22,42,blue
4494974867,3,5,3,0,0,0,0,15673,7.2,18504,234,47,-546,760,23.4,1567.3,5,3,3,2,1,1,0,16219,6.8,17744,237,55,546,-760,23.7,1621.9,red,1.2,2.67,13,14,red
4517893176,4,12,4,0,0,0,0,14958,6.2,15925,192,52,-4917,-4426,19.2,1495.8,12,4,9,0,0,0,1,19875,7.4,20351,241,52,4917,4426,24.1,1987.5,red,0.67,5.25,13,16,red
4484950651,10,0,8,0,0,0,0,18408,7.4,19945,243,52,5041,3633,24.3,1840.8,0,10,0,0,0,0,0,13367,6.6,16312,202,57,-5041,-3633,20.2,1336.7,blue,12.03,0,21,18,blue
4490390200,7,5,2,1,1,0,0,17247,7.2,19189,249,63,2152,2575,24.9,1724.7,5,7,7,0,0,0,0,15095,6.8,16614,178,40,-2152,-2575,17.8,1509.5,blue,1.8,1.71,16,19,red
4470135007,9,6,10,1,1,0,0,17590,7.2,18788,200,56,1783,2066,20,1759,6,9,6,0,0,0,0,15807,6.8,16722,183,52,-1783,-2066,18.3,1580.7,blue,3.17,1.33,21,48,red
4521318452,9,8,8,1,0,1,0,17657,7.2,19166,227,56,545,1033,22.7,1765.7,8,9,9,1,1,0,0,17112,7,18133,198,40,-545,-1033,19.8,1711.2,blue,2.12,1.89,17,16,red
4455647637,2,10,3,0,0,0,0,14094,6.2,15768,197,57,-5521,-3591,19.7,1409.4,10,2,14,1,1,0,0,19615,7.4,19359,258,52,5521,3591,25.8,1961.5,red,0.5,12,15,21,red
4499330396,3,4,1,0,0,0,0,14629,6.8,17474,184,57,-1623,-951,18.4,1462.9,4,3,7,2,1,1,0,16252,7,18425,243,65,1623,951,24.3,1625.2,blue,1,3.67,15,17,blue
4523305725,1,8,0,0,0,0,0,12791,6.6,16317,173,46,-4684,-3216,17.3,1279.1,8,1,3,1,1,0,0,17475,7.2,19533,239,44,4684,3216,23.9,1747.5,red,0.12,11,12,14,red
4457630115,6,5,7,0,0,0,0,16879,7.4,19265,203,68,-29,1014,20.3,1687.9,5,6,7,2,1,1,0,16908,7,18251,249,43,29,-1014,24.9,1690.8,red,2.6,2,35,41,blue
4460755163,5,7,5,0,0,0,0,16005,6.8,17737,218,55,-1313,-1424,21.8,1600.5,7,5,8,0,0,0,0,17318,7,19161,239,52,1313,1424,23.9,1731.8,blue,1.43,3,17,35,red
4476394657,12,5,10,0,0,0,0,18876,7,18737,218,63,3210,3591,21.8,1887.6,5,12,6,0,0,0,1,15666,6,15146,184,32,-3210,-3591,18.4,1566.6,blue,4.4,0.92,22,16,blue
4482930107,14,4,13,0,0,0,1,20319,7.2,18956,216,57,5774,2869,21.6,2031.9,4,14,1,0,0,0,0,14545,6.4,16087,218,34,-5774,-2869,21.8,1454.5,blue,6.75,0.36,16,19,red
4468373148,12,12,6,2,1,1,1,19975,7.4,20209,213,56,1843,518,21.3,1997.5,12,12,9,0,0,0,0,18132,7.2,19691,183,43,-1843,-518,18.3,1813.2,red,1.5,1.75,12,15,blue
4521573510,2,3,4,0,0,0,0,13761,6.6,16433,187,48,-1400,-2239,18.7,1376.1,3,2,1,1,1,0,0,15161,7,18672,247,52,1400,2239,24.7,1516.1,red,2,2,15,14,red
4523445497,7,5,8,1,1,0,0,16940,7,18209,238,44,1995,345,23.8,1694,5,7,4,1,0,1,0,14945,7.2,17864,193,50,-1995,-345,19.3,1494.5,blue,3,1.29,26,80,blue
4523418547,3,8,2,0,0,0,0,14585,6.6,16310,225,38,-1321,-274,22.5,1458.5,8,3,4,2,1,1,0,15906,6.8,16584,185,64,1321,274,18.5,1590.6,red,0.62,4,13,11,red
4521814295,7,4,7,1,0,1,0,16806,6.8,17149,217,50,1904,892,21.7,1680.6,4,7,4,0,0,0,0,14902,6.4,16257,200,55,-1904,-892,20,1490.2,red,3.5,1.14,20,44,red
4499812377,5,5,5,1,1,0,0,15371,6.8,16868,224,43,-612,-1300,22.4,1537.1,5,5,7,0,0,0,0,15983,7.2,18168,194,56,612,1300,19.4,1598.3,red,2,2.4,25,20,blue
4473202955,12,9,8,0,0,0,0,18086,6.8,17120,190,42,1030,705,19,1808.6,9,12,9,0,0,0,0,17056,6.6,16415,174,48,-1030,-705,17.4,1705.6,blue,2.22,1.5,18,14,blue
4465525606,4,12,5,0,0,0,0,14246,6.4,16141,189,52,-5112,-2602,18.9,1424.6,12,4,19,1,1,0,0,19358,7,18743,200,46,5112,2602,20,1935.8,red,0.75,7.75,20,21,blue
4429858119,4,7,4,0,0,0,0,15220,6.4,16809,236,45,-2475,-2226,23.6,1522,7,4,9,0,0,0,0,17695,7.2,19035,247,64,2475,2226,24.7,1769.5,red,1.14,4,19,22,blue
4515332748,5,3,4,1,1,0,0,16448,7.2,19635,245,62,1619,1470,24.5,1644.8,3,5,3,1,0,1,0,14829,6.8,18165,209,55,-1619,-1470,20.9,1482.9,blue,3,1.2,25,13,blue
4489438593,8,6,6,0,0,0,0,16947,7,18862,184,64,-538,1677,18.4,1694.7,6,8,8,2,1,1,1,17485,6.8,17185,198,47,538,-1677,19.8,1748.5,blue,2.33,1.75,17,19,red
4520807181,2,3,1,1,1,0,0,14516,6.8,17487,229,55,-1558,-1472,22.9,1451.6,3,2,3,0,0,0,0,16074,7,18959,255,64,1558,1472,25.5,1607.4,blue,1,3,17,39,red
4523540564,4,6,2,1,0,1,0,14933,6.6,16336,190,56,-2781,-2752,19,1493.3,6,4,8,1,1,0,0,17714,7.2,19088,204,81,2781,2752,20.4,1771.4,red,1,3.5,12,14,red
4524450625,9,5,6,0,0,0,1,17795,7,18241,220,36,1642,878,22,1779.5,5,9,5,1,1,0,0,16153,6.8,17363,216,61,-1642,-878,21.6,1615.3,blue,3,1.11,15,18,blue
4426718140,5,8,7,1,0,1,0,16137,6.6,17271,219,51,-80,-155,21.9,1613.7,8,5,9,1,1,0,0,16217,7,17426,205,40,80,155,20.5,1621.7,blue,1.5,3.4,27,22,blue
4480049039,6,7,8,1,1,0,0,15390,6.8,17104,194,47,-1423,-1150,19.4,1539,7,6,3,0,0,0,0,16813,7.2,18254,218,56,1423,1150,21.8,1681.3,red,2,1.67,17,19,red
4524125396,3,11,3,0,0,0,0,13998,6.4,16659,171,59,-4911,-2529,17.1,1399.8,11,3,13,1,1,0,0,18909,7.4,19188,236,53,4911,2529,23.6,1890.9,red,0.55,8,14,45,red
4515858089,6,12,7,1,0,1,0,16203,6.4,16391,203,51,-2787,-1507,20.3,1620.3,12,6,23,1,1,0,0,18990,7,17898,209,42,2787,1507,20.9,1899,red,1.08,5.83,21,23,blue
4521541761,2,0,2,1,1,0,0,15081,6.6,17517,240,59,865,-933,24,1508.1,0,2,0,0,0,0,0,14216,6.8,18450,252,51,-865,933,25.2,1421.6,blue,12.03,0,20,44,blue
4461960551,4,2,5,0,0,0,0,16161,6.8,17916,230,60,901,-1138,23,1616.1,2,4,3,1,1,0,0,15260,7,19054,246,60,-901,1138,24.6,1526,blue,4.5,1.25,56,14,blue
4481377931,4,9,5,1,0,1,0,15664,6.8,17373,208,60,-2078,-188,20.8,1566.4,9,4,10,1,1,0,0,17742,7,17561,214,44,2078,188,21.4,1774.2,red,1,4.75,19,18,red
4451815876,9,9,9,0,0,0,0,16896,7,17253,187,61,-1603,-2388,18.7,1689.6,9,9,12,1,1,0,0,18499,7.2,19641,250,48,1603,2388,25,1849.9,red,2,2.33,21,26,red
4511218061,17,6,17,1,1,0,1,22296,7.8,21451,251,72,6535,5732,25.1,2229.6,6,17,8,0,0,0,0,15761,6.4,15719,177,40,-6535,-5732,17.7,1576.1,blue,5.67,0.82,19,19,red
4515879923,5,11,7,1,0,1,0,15285,6.6,15530,185,44,-2302,-1871,18.5,1528.5,11,5,14,1,1,0,0,17587,6.8,17401,165,44,2302,1871,16.5,1758.7,red,1.09,5,18,46,blue
4494889837,3,7,4,0,0,0,0,14584,6.8,16798,220,49,-2543,-1202,22,1458.4,7,3,7,1,1,0,0,17127,7,18000,258,38,2543,1202,25.8,1712.7,red,1,4.67,17,21,red
4515734376,3,8,3,0,0,0,0,15206,6.8,17404,205,59,-1711,-1201,20.5,1520.6,8,3,11,1,1,0,0,16917,7,18605,217,43,1711,1201,21.7,1691.7,red,0.75,6.33,12,23,blue
4465399083,1,7,1,0,0,0,0,13745,6.6,16710,198,55,-3426,-997,19.8,1374.5,7,1,9,1,1,0,0,17171,7,17707,212,60,3426,997,21.2,1717.1,red,0.29,16,17,76,red
4459608159,4,1,3,0,0,0,0,16210,6.8,19051,261,41,1169,564,26.1,1621,1,4,1,1,1,0,0,15041,7,18487,232,69,-1169,-564,23.2,1504.1,blue,7,0.5,31,25,blue
4520057961,6,3,6,1,1,0,0,16498,7.2,18910,233,60,1857,1385,23.3,1649.8,3,6,4,0,0,0,0,14641,7,17525,204,60,-1857,-1385,20.4,1464.1,blue,4,1.17,19,61,blue
4423795870,5,7,6,0,0,0,0,15778,6.8,17304,235,40,-1829,-1429,23.5,1577.8,7,5,3,1,1,0,1,17607,6.8,18733,244,51,1829,1429,24.4,1760.7,blue,1.57,2,21,26,red
4514312367,3,9,5,0,0,0,0,14347,6.4,15496,182,53,-3221,-2950,18.2,1434.7,9,3,14,1,1,0,0,17568,7.2,18446,192,70,3221,2950,19.2,1756.8,red,0.89,7.67,12,19,red
4524908921,7,10,4,0,0,0,0,16663,6.8,17192,214,55,-1514,-1142,21.4,1666.3,10,7,19,1,1,0,0,18177,7,18334,217,39,1514,1142,21.7,1817.7,blue,1.1,4.14,15,15,blue
4454242326,4,5,6,0,0,0,0,16580,7.6,20102,236,72,409,2037,23.6,1658,5,4,6,0,0,0,0,16171,7,18065,211,46,-409,-2037,21.1,1617.1,red,2,2.75,17,39,red
4407776093,6,1,7,1,1,0,0,16036,6.8,17948,200,56,2083,1282,20,1603.6,1,6,2,0,0,0,0,13953,6.8,16666,221,46,-2083,-1282,22.1,1395.3,blue,13,0.5,125,26,blue
4523651939,2,4,4,0,0,0,0,13298,6.6,16659,192,37,-3826,-2595,19.2,1329.8,4,2,5,1,1,0,0,17124,7.2,19254,250,74,3826,2595,25,1712.4,red,1.5,4.5,20,17,red
4487099602,9,5,8,0,0,0,0,16959,7.2,19195,199,43,1788,1922,19.9,1695.9,5,9,2,0,0,0,0,15171,6.6,17273,187,44,-1788,-1922,18.7,1517.1,blue,3.4,0.78,34,17,blue
4513836142,11,4,12,0,0,0,0,18173,7,18943,218,39,3036,1949,21.8,1817.3,4,11,4,0,0,0,0,15137,6.8,16994,203,40,-3036,-1949,20.3,1513.7,blue,5.75,0.73,19,11,red
4471166821,5,5,5,2,1,1,0,16122,7.2,19143,236,59,-221,1274,23.6,1612.2,5,5,7,0,0,0,0,16343,7,17869,225,41,221,-1274,22.5,1634.3,blue,2,2.4,18,17,red
4515396713,5,4,5,1,0,1,0,16582,6.8,18262,216,66,380,-239,21.6,1658.2,4,5,6,1,1,0,0,16202,6.8,18501,246,41,-380,239,24.6,1620.2,blue,2.5,2,16,62,blue
4523523934,5,13,3,0,0,0,0,15126,6.8,16897,206,31,-4864,-2252,20.6,1512.6,13,5,11,0,0,0,0,19990,7.4,19149,217,57,4864,2252,21.7,1999,red,0.62,4.8,12,18,red
4450708282,11,4,9,1,0,1,0,17666,7.4,19949,218,45,2405,3251,21.8,1766.6,4,11,4,1,1,0,0,15261,6.6,16698,204,45,-2405,-3251,20.4,1526.1,blue,5,0.73,15,19,red
4421809925,6,10,7,0,0,0,0,16172,6.4,15969,191,52,-1260,-2264,19.1,1617.2,10,6,12,1,1,0,0,17432,6.8,18233,207,49,1260,2264,20.7,1743.2,blue,1.3,3.67,18,20,blue
4498562536,7,9,3,0,0,0,0,15609,6.8,16832,182,38,-2569,-2934,18.2,1560.9,9,7,9,0,0,0,0,18178,7.6,19766,212,70,2569,2934,21.2,1817.8,blue,1.11,2.57,21,16,blue
4523583459,5,7,8,1,1,0,0,15897,7.2,17465,216,59,-503,-896,21.6,1589.7,7,5,7,0,0,0,0,16400,7,18361,225,44,503,896,22.5,1640,red,1.86,2.8,55,32,blue
4475009487,8,1,12,0,0,0,0,18810,7,19127,261,42,5189,2522,26.1,1881,1,8,1,1,1,0,0,13621,6.6,16605,194,53,-5189,-2522,19.4,1362.1,blue,20,0.25,20,23,blue
4491027419,3,4,2,1,0,1,0,15759,7,17815,245,53,-183,-779,24.5,1575.9,4,3,3,1,1,0,0,15942,7.4,18594,230,64,183,779,23,1594.2,red,1.25,2.33,26,120,red
4516488092,5,4,6,0,0,0,0,15411,7,17827,215,39,-43,-152,21.5,1541.1,4,5,3,0,0,0,0,15454,7,17979,224,54,43,152,22.4,1545.4,blue,2.75,1.4,37,15,blue
4453299408,8,10,10,1,1,0,0,16526,7,18130,174,44,-2720,-2680,17.4,1652.6,10,8,7,0,0,0,0,19246,7.6,20810,239,79,2720,2680,23.9,1924.6,blue,1.8,2.12,44,24,blue
4510397182,11,4,8,1,0,1,0,17781,7.2,19581,225,45,2359,1828,22.5,1778.1,4,11,3,0,0,0,0,15422,6.8,17753,215,60,-2359,-1828,21.5,1542.2,red,4.75,0.64,21,82,blue
4500504137,13,4,17,1,1,0,1,20028,7,18736,213,43,4887,2100,21.3,2002.8,4,13,2,0,0,0,0,15141,6.6,16636,207,56,-4887,-2100,20.7,1514.1,blue,7.5,0.46,23,21,blue
4510816810,10,2,7,1,1,0,0,18725,7.2,19463,248,69,4073,1397,24.8,1872.5,2,10,1,0,0,0,0,14652,6.8,18066,225,63,-4073,-1397,22.5,1465.2,blue,8.5,0.3,20,21,blue
4513104795,3,5,6,0,0,0,0,15365,6.8,18102,216,60,-1519,-1284,21.6,1536.5,5,3,5,0,0,0,0,16884,7.4,19386,245,59,1519,1284,24.5,1688.4,red,1.8,3.33,45,26,red
4485509508,5,15,4,0,0,0,0,15727,6.8,17147,198,46,-4245,-3455,19.8,1572.7,15,5,20,0,0,0,0,19972,7.4,20602,227,47,4245,3455,22.7,1997.2,red,0.6,7,12,15,red
4500865627,3,6,3,0,0,0,0,15541,7,18700,236,48,-376,-71,23.6,1554.1,6,3,5,1,1,0,0,15917,7,18771,226,48,376,71,22.6,1591.7,red,1,3.67,42,14,blue
4515483383,2,8,1,0,0,0,0,14183,7,17123,221,51,-4625,-1753,22.1,1418.3,8,2,12,1,1,0,0,18808,7,18876,248,56,4625,1753,24.8,1880.8,red,0.38,10,15,17,red
4461019811,8,6,7,1,1,0,0,17135,7.6,19855,216,60,1247,2354,21.6,1713.5,6,8,9,0,0,0,0,15888,6.8,17501,196,42,-1247,-2354,19.6,1588.8,blue,2.5,1.88,13,14,blue
4485701075,5,0,4,0,0,0,0,16637,7,18095,250,51,2712,1161,25,1663.7,0,5,0,1,1,0,0,13925,7,16934,215,62,-2712,-1161,21.5,1392.5,blue,12.03,0,15,41,blue
4452674976,4,7,6,1,0,1,0,15536,6.6,16788,234,48,-1972,-1064,23.4,1553.6,7,4,14,1,1,0,0,17508,7,17852,223,58,1972,1064,22.3,1750.8,blue,1.43,5.25,20,25,red
4473512482,5,14,7,0,0,0,0,15755,6.4,16436,203,39,-4136,-3444,20.3,1575.5,14,5,12,1,1,0,0,19891,7.4,19880,222,52,4136,3444,22.2,1989.1,red,0.86,5.2,47,17,red
4513334506,5,5,2,1,0,1,0,15795,7.2,18512,201,53,187,1356,20.1,1579.5,5,5,3,0,0,0,0,15608,7,17156,204,45,-187,-1356,20.4,1560.8,red,1.4,1.6,19,20,red
4466458124,2,6,2,1,1,0,0,13590,6.6,15723,170,56,-3089,-1857,17,1359,6,2,6,0,0,0,0,16679,6.8,17580,215,47,3089,1857,21.5,1667.9,red,0.67,6,16,19,red
4485619170,4,5,6,1,0,1,0,16260,6.8,18128,225,63,266,-282,22.5,1626,5,4,10,1,1,0,0,15994,7.2,18410,224,48,-266,282,22.4,1599.4,red,2,3.75,18,80,blue
4524601777,6,5,13,0,0,0,0,15859,6.8,16551,209,44,-947,-2043,20.9,1585.9,5,6,6,0,0,0,0,16806,6.8,18594,218,61,947,2043,21.8,1680.6,red,3.8,1.83,20,28,blue
4521679491,11,1,12,1,0,1,0,18137,7,18617,207,51,4177,2615,20.7,1813.7,1,11,0,0,0,0,0,13960,6.4,16002,205,54,-4177,-2615,20.5,1396,blue,23,0.09,18,37,blue
4525188268,8,4,14,1,1,0,0,17451,6.8,17118,210,53,2470,1058,21,1745.1,4,8,3,0,0,0,0,14981,6.6,16060,219,30,-2470,-1058,21.9,1498.1,blue,5.5,0.88,18,15,blue
4484473320,5,4,5,0,0,0,0,15679,6.6,16202,224,36,812,237,22.4,1567.9,4,5,7,0,0,0,0,14867,6.4,15965,220,36,-812,-237,22,1486.7,blue,2.5,2.2,21,24,blue
4479644130,9,7,8,1,0,1,1,18502,7.2,19709,212,51,2010,2112,21.2,1850.2,7,9,11,1,1,0,0,16492,6.6,17597,194,48,-2010,-2112,19.4,1649.2,red,2.43,2,130,54,red
4489264481,4,3,5,1,1,0,0,15120,6.8,16751,218,48,938,2052,21.8,1512,3,4,3,0,0,0,0,14182,5.8,14699,178,46,-938,-2052,17.8,1418.2,blue,3,1.5,52,14,red
4509926355,5,9,4,1,0,1,0,15539,6.4,16163,163,50,-1337,-1246,16.3,1553.9,9,5,9,0,0,0,0,16876,7,17409,190,42,1337,1246,19,1687.6,red,1,3.6,17,20,red
4508408940,3,6,2,1,1,0,0,13879,6.6,16319,148,62,-2967,-3336,14.8,1387.9,6,3,2,0,0,0,0,16846,7.2,19655,223,69,2967,3336,22.3,1684.6,red,0.83,2.67,38,16,red
4493890322,6,9,4,0,0,0,0,15640,7,17472,195,41,-1567,-232,19.5,1564,9,6,13,1,1,0,0,17207,7,17704,216,46,1567,232,21.6,1720.7,red,1.11,3.67,17,21,red
4448470981,9,4,9,0,0,0,0,18738,7,18081,246,48,3660,577,24.6,1873.8,4,9,5,1,1,0,0,15078,6.8,17504,196,68,-3660,-577,19.6,1507.8,blue,4.5,1,23,18,blue
4518263954,8,3,13,0,0,0,0,18509,7,18932,270,36,3602,274,27,1850.9,3,8,3,1,1,0,0,14907,7,18658,217,62,-3602,-274,21.7,1490.7,red,7,0.75,16,15,blue
4483939120,3,5,5,0,0,0,0,15441,7,18222,226,55,329,601,22.6,1544.1,5,3,3,2,1,1,0,15112,6.8,17621,203,56,-329,-601,20.3,1511.2,blue,1.6,2.67,17,15,blue
4520328098,5,4,6,0,0,0,0,15887,6.8,16554,201,44,231,-446,20.1,1588.7,4,5,4,0,0,0,0,15656,6.4,17000,210,44,-231,446,21,1565.6,blue,2.75,1.6,24,24,blue
4524104535,7,2,5,1,0,1,0,16242,7,17867,218,48,2156,2101,21.8,1624.2,2,7,3,0,0,0,0,14086,6.4,15766,212,38,-2156,-2101,21.2,1408.6,blue,6,0.71,15,17,blue
4519143177,4,0,5,1,0,1,0,15714,7,17384,210,56,1378,-144,21,1571.4,0,4,0,1,1,0,0,14336,6.8,17528,259,60,-1378,144,25.9,1433.6,red,12.03,0,21,20,blue
4505526199,3,4,1,0,0,0,0,15087,7,17316,250,48,-523,-224,25,1508.7,4,3,7,0,0,0,0,15610,6.8,17540,203,52,523,224,20.3,1561,red,1,3.67,15,15,red
4487201030,7,6,4,1,0,1,0,16680,6.8,17712,196,43,-72,-118,19.6,1668,6,7,5,0,0,0,0,16752,7,17830,223,44,72,118,22.3,1675.2,red,1.83,1.57,23,21,red
4521835060,8,13,8,0,0,0,0,17639,6.6,16561,194,48,-887,-501,19.4,1763.9,13,8,20,1,1,0,0,18526,6.8,17062,198,36,887,501,19.8,1852.6,blue,1.23,4.12,45,56,red
4395442745,9,7,16,0,0,0,0,18000,7,18178,204,40,796,290,20.4,1800,7,9,17,0,0,0,0,17204,6.8,17888,187,64,-796,-290,18.7,1720.4,blue,3.57,2.67,28,19,blue
4521381994,2,7,3,0,0,0,0,13443,6.4,15718,192,40,-3241,-2297,19.2,1344.3,7,2,3,2,1,1,0,16684,6.8,18015,217,60,3241,2297,21.7,1668.4,red,0.71,5,19,22,red
4516450809,10,8,18,0,0,0,0,18121,7.4,19091,230,49,833,-523,23,1812.1,8,10,7,2,1,1,0,17288,7.2,19614,217,56,-833,523,21.7,1728.8,red,3.5,1.5,14,26,blue
4510608090,3,9,2,1,1,0,0,14765,6.4,16630,200,47,-2462,-558,20,1476.5,9,3,15,0,0,0,0,17227,6.8,17188,205,47,2462,558,20.5,1722.7,blue,0.56,8,16,19,blue
4520514832,8,12,7,2,1,1,0,17474,7.2,18038,226,54,-2112,-582,22.6,1747.4,12,8,14,0,0,0,0,19586,7.2,18620,223,34,2112,582,22.3,1958.6,blue,1.25,3.25,22,22,red
4494748194,12,5,18,2,1,1,1,20176,7,18972,218,60,4634,2354,21.8,2017.6,5,12,3,0,0,0,0,15542,6.6,16618,217,43,-4634,-2354,21.7,1554.2,blue,6,0.67,19,16,blue
4471380498,9,3,6,0,0,0,1,19574,7.6,20323,237,59,4279,3408,23.7,1957.4,3,9,6,0,0,0,0,15295,6.8,16915,234,58,-4279,-3408,23.4,1529.5,blue,5,1,42,25,blue
4523516940,5,7,4,0,0,0,0,15866,6.6,16957,222,51,-635,-2299,22.2,1586.6,7,5,5,1,1,0,0,16501,7.2,19256,215,56,635,2299,21.5,1650.1,red,1.29,2.4,19,16,blue
4467196417,12,5,8,0,0,0,0,19313,7.8,21625,237,56,4185,3858,23.7,1931.3,5,12,2,0,0,0,0,15128,7.2,17767,182,68,-4185,-3858,18.2,1512.8,blue,4,0.58,39,14,blue
4522422210,2,5,1,0,0,0,0,15125,6.8,17716,241,56,-1770,-1069,24.1,1512.5,5,2,5,0,0,0,0,16895,7,18785,250,57,1770,1069,25,1689.5,red,0.6,5,19,18,red
4488482640,6,6,4,0,0,0,0,16485,7.2,18589,220,44,-750,-906,22,1648.5,6,6,6,1,1,0,0,17235,7.4,19495,242,64,750,906,24.2,1723.5,red,1.67,2,17,14,blue
4524632974,2,5,1,1,0,1,0,14815,7,18080,233,54,-931,1384,23.3,1481.5,5,2,4,0,0,0,0,15746,6.6,16696,209,52,931,-1384,20.9,1574.6,red,0.6,4.5,16,89,red
4477769511,4,5,4,0,0,0,0,15176,6.6,17215,227,46,-676,359,22.7,1517.6,5,4,6,2,1,1,0,15852,6.8,16856,225,56,676,-359,22.5,1585.2,blue,1.6,2.75,89,17,red
4502201524,1,10,0,1,0,1,0,13589,6.6,16161,207,60,-5793,-4650,20.7,1358.9,10,1,12,1,1,0,0,19382,7.8,20811,250,60,5793,4650,25,1938.2,red,0.1,22,16,18,red
4475735084,7,4,11,0,0,0,0,17012,7,17924,226,35,1595,-63,22.6,1701.2,4,7,3,1,1,0,0,15417,6.8,17987,230,56,-1595,63,23,1541.7,blue,4.5,1,27,55,red
4513473008,5,2,7,1,1,0,0,17126,6.8,17880,248,53,1936,448,24.8,1712.6,2,5,2,0,0,0,0,15190,6.8,17432,230,71,-1936,-448,23,1519,blue,6,0.8,49,20,red
4472174741,4,9,4,0,0,0,0,15102,6.8,17421,214,56,-2173,-2274,21.4,1510.2,9,4,9,1,1,0,0,17275,7.4,19695,212,59,2173,2274,21.2,1727.5,red,0.89,4.5,18,23,red
4484824395,8,5,16,1,1,0,0,17338,7,18403,214,54,1554,727,21.4,1733.8,5,8,6,0,0,0,0,15784,6.6,17676,239,48,-1554,-727,23.9,1578.4,blue,4.8,1.38,18,19,blue
4472737059,5,4,6,1,0,1,0,17402,7.4,19335,246,60,2067,2098,24.6,1740.2,4,5,4,1,1,0,0,15335,7,17237,230,40,-2067,-2098,23,1533.5,blue,2.75,1.6,20,20,blue
4513724737,2,5,2,1,1,0,0,14514,7,17851,211,63,-1386,-450,21.1,1451.4,5,2,1,0,0,0,0,15900,6.8,18301,242,55,1386,450,24.2,1590,red,0.8,3,19,41,blue
4521086709,9,2,13,1,1,0,0,18442,7,18882,256,56,4401,2408,25.6,1844.2,2,9,5,0,0,0,0,14041,6.6,16474,193,47,-4401,-2408,19.3,1404.1,blue,11,0.78,16,20,red
4521912721,1,2,2,0,0,0,0,15231,7,18127,262,52,-13,-378,26.2,1523.1,2,1,3,1,1,0,0,15244,7,18505,232,67,13,378,23.2,1524.4,red,1.5,5,21,16,red
4516001794,6,6,4,0,0,0,0,17328,7.2,20229,245,72,1336,1171,24.5,1732.8,6,6,5,2,1,1,0,15992,7.2,19058,224,52,-1336,-1171,22.4,1599.2,red,1.67,1.83,18,23,red
4465212739,10,8,12,0,0,0,0,17767,7.4,18168,194,52,163,-368,19.4,1776.7,8,10,13,0,0,0,0,17604,7,18536,211,52,-163,368,21.1,1760.4,red,2.75,2.1,16,16,blue
4494142673,3,3,5,0,0,0,0,15389,6.8,17782,231,60,-1930,-1452,23.1,1538.9,3,3,4,2,1,1,1,17319,7.2,19234,276,52,1930,1452,27.6,1731.9,red,2.67,2.33,17,23,blue
4458300431,3,7,4,0,0,0,0,15298,6.8,17815,223,42,-960,-1574,22.3,1529.8,7,3,4,1,1,0,0,16258,7.2,19389,240,52,960,1574,24,1625.8,red,1,3.67,19,15,red
4461096215,5,6,5,0,0,0,1,17659,7,18422,225,44,2021,-274,22.5,1765.9,6,5,7,1,1,0,0,15638,7,18696,196,48,-2021,274,19.6,1563.8,red,1.67,2.6,18,14,blue
4520353212,6,4,8,0,0,0,0,17201,7.2,19652,239,57,1820,1893,23.9,1720.1,4,6,5,1,1,0,0,15381,7,17759,219,58,-1820,-1893,21.9,1538.1,blue,3.5,1.5,17,14,red
4515605515,2,3,2,0,0,0,0,15656,6.8,17712,240,51,265,682,24,1565.6,3,2,6,2,1,1,0,15391,6.6,17030,201,55,-265,-682,20.1,1539.1,red,1.33,4.5,21,61,red
4519369420,6,6,10,0,0,0,0,16889,6.8,17536,240,28,505,-255,24,1688.9,6,6,6,1,1,0,0,16384,7,17791,230,53,-505,255,23,1638.4,red,2.67,2,46,20,blue
4510527608,11,6,13,1,1,0,0,18520,7.2,18859,204,48,2413,2181,20.4,1852,6,11,8,0,0,0,0,16107,6.6,16678,206,48,-2413,-2181,20.6,1610.7,blue,4,1.27,42,18,blue
4518777335,3,6,4,0,0,0,0,14564,6.6,16320,209,51,-1966,-1998,20.9,1456.4,6,3,8,1,1,0,0,16530,7,18318,220,64,1966,1998,22,1653,red,1.17,4.67,26,16,blue
4522379320,5,4,6,2,1,1,0,16635,7,18522,217,51,799,239,21.7,1663.5,4,5,9,0,0,0,0,15836,6.8,18283,240,52,-799,-239,24,1583.6,red,2.75,2.6,20,61,blue
4449308789,4,9,2,1,1,0,0,15230,6.6,17421,192,68,-2169,-1630,19.2,1523,9,4,7,0,0,0,0,17399,7.2,19051,218,26,2169,1630,21.8,1739.9,red,0.67,4,16,17,red
4446151894,2,8,1,1,1,0,0,14906,6.8,17928,229,55,-2361,-1663,22.9,1490.6,8,2,10,1,0,1,0,17267,7,19591,230,52,2361,1663,23,1726.7,blue,0.38,9,16,13,red
4477325608,8,3,9,2,1,1,0,17706,6.8,17285,221,52,3588,1289,22.1,1770.6,3,8,4,0,0,0,0,14118,6.6,15996,190,52,-3588,-1289,19,1411.8,blue,5.67,0.88,18,46,blue
4524879567,4,4,4,1,1,0,0,16238,7,18332,234,64,-348,-11,23.4,1623.8,4,4,3,1,0,1,0,16586,7,18343,236,72,348,11,23.6,1658.6,blue,2,1.75,18,18,blue
4520786519,5,4,5,1,1,0,0,16221,7,18135,241,49,1457,1939,24.1,1622.1,4,5,9,0,0,0,0,14764,6.6,16196,205,43,-1457,-1939,20.5,1476.4,red,2.5,2.6,27,24,red
4441621695,6,7,7,1,1,0,0,16564,7,17725,222,48,-850,-256,22.2,1656.4,7,6,7,1,0,1,0,17414,7,17981,201,56,850,256,20.1,1741.4,blue,1.86,2.33,14,20,red
4466034400,2,13,2,0,0,0,0,14712,6.2,15826,202,52,-4016,-3206,20.2,1471.2,13,2,17,1,1,0,0,18728,7,19032,253,48,4016,3206,25.3,1872.8,red,0.31,15,16,19,blue
4497614780,7,6,5,0,0,0,0,17042,7.6,20182,189,62,1264,2805,18.9,1704.2,6,7,4,2,1,1,0,15778,6.8,17377,225,46,-1264,-2805,22.5,1577.8,blue,2,1.43,60,18,red
4522392922,10,2,11,0,0,0,0,18104,7.4,19373,201,60,4142,2934,20.1,1810.4,2,10,1,0,0,0,0,13962,6.6,16439,176,49,-4142,-2934,17.6,1396.2,blue,10.5,0.3,17,24,blue
4484464676,3,4,3,0,0,0,0,15128,6.8,18400,215,54,-279,577,21.5,1512.8,4,3,5,1,1,0,0,15407,7,17823,244,48,279,-577,24.4,1540.7,red,1.5,3,50,20,red
4522611755,7,4,5,1,1,0,0,17773,7,18860,262,48,2521,2240,26.2,1777.3,4,7,4,0,0,0,0,15252,6.6,16620,197,51,-2521,-2240,19.7,1525.2,blue,3,1.14,19,22,blue
4520736553,7,5,5,1,1,0,0,17263,7.4,19542,237,66,715,-69,23.7,1726.3,5,7,5,0,0,0,0,16548,7.6,19611,231,68,-715,69,23.1,1654.8,blue,2.4,1.43,17,18,blue
4516073213,8,7,5,1,1,0,0,17325,7,19648,246,55,744,1657,24.6,1732.5,7,8,6,1,0,1,0,16581,6.8,17991,216,36,-744,-1657,21.6,1658.1,blue,1.86,1.62,11,15,blue
4515414704,13,5,9,0,0,0,0,19195,7.2,19569,205,44,2818,1675,20.5,1919.5,5,13,4,0,0,0,0,16377,7,17894,200,56,-2818,-1675,20,1637.7,blue,4.4,0.69,15,15,blue
4492812373,3,2,1,1,0,1,0,16246,7.2,19387,253,60,2679,3685,25.3,1624.6,2,3,2,1,1,0,0,13567,6.6,15702,169,60,-2679,-3685,16.9,1356.7,blue,2,1.33,27,15,red
4498670956,7,9,10,1,1,0,0,16570,7,18238,206,56,-1262,-769,20.6,1657,9,7,14,0,0,0,0,17832,7,19007,231,50,1262,769,23.1,1783.2,blue,1.89,3.29,133,18,red
4515291762,5,2,5,1,1,0,0,15790,7.2,18873,216,56,1074,1004,21.6,1579,2,5,1,0,0,0,0,14716,7,17869,211,72,-1074,-1004,21.1,1471.6,blue,5,0.6,17,56,blue
4518176859,6,9,6,0,0,0,0,16598,6.8,17279,196,64,-1814,-946,19.6,1659.8,9,6,13,1,1,0,0,18412,6.8,18225,231,40,1814,946,23.1,1841.2,red,1.33,3.67,25,25,red
4443034912,12,4,5,1,0,1,2,20018,7.6,20654,226,44,6489,4212,22.6,2001.8,4,12,0,1,1,0,0,13529,6.6,16442,172,37,-6489,-4212,17.2,1352.9,blue,4.25,0.33,14,14,blue
4500080040,9,6,8,1,1,0,0,17797,7.2,19126,220,48,2094,2788,22,1779.7,6,9,8,0,0,0,0,15703,6.8,16338,203,40,-2094,-2788,20.3,1570.3,blue,2.83,1.56,42,19,blue
4520888635,7,6,7,0,0,0,0,16160,6.8,17319,206,60,-106,-62,20.6,1616,6,7,5,0,0,0,0,16266,6.8,17381,229,36,106,62,22.9,1626.6,blue,2.33,1.57,20,59,blue
4510983130,1,11,1,0,0,0,0,12926,6.2,14637,164,55,-7952,-5684,16.4,1292.6,11,1,12,2,1,1,1,20878,7.4,20321,254,44,7952,5684,25.4,2087.8,red,0.18,23,13,17,red
4450369263,2,4,2,1,1,0,0,14922,7.2,18119,227,65,-1316,-1111,22.7,1492.2,4,2,1,0,0,0,0,16238,6.8,19230,247,65,1316,1111,24.7,1623.8,blue,1,2.5,20,24,blue
4497173280,11,9,5,0,0,0,0,18702,7.4,18736,234,53,1713,1791,23.4,1870.2,9,11,6,0,0,0,0,16989,6.6,16945,179,38,-1713,-1791,17.9,1698.9,blue,1.78,1.36,20,18,blue
4492401281,7,4,5,2,1,1,0,17111,7,17761,231,48,1318,764,23.1,1711.1,4,7,4,0,0,0,0,15793,6.8,16997,226,42,-1318,-764,22.6,1579.3,red,3,1.14,16,16,blue
4461378771,11,10,8,1,0,1,0,18762,7,18724,202,40,1378,1187,20.2,1876.2,10,11,6,0,0,0,0,17384,7,17537,212,52,-1378,-1187,21.2,1738.4,blue,1.9,1.45,18,17,blue
4450008187,6,8,3,0,0,0,0,16386,7,18401,207,62,-610,514,20.7,1638.6,8,6,11,1,1,0,0,16996,7,17887,211,36,610,-514,21.1,1699.6,red,1.12,3.17,22,18,blue
4463558465,7,7,8,0,0,0,0,15887,6.8,17319,171,57,-560,-1443,17.1,1588.7,7,7,3,0,0,0,0,16447,7,18762,209,39,560,1443,20.9,1644.7,blue,2.14,1.43,19,17,blue
4525076026,5,7,2,0,0,0,0,16363,7,18270,225,63,244,-408,22.5,1636.3,7,5,7,2,1,1,0,16119,7,18678,197,60,-244,408,19.7,1611.9,red,1,2.8,18,16,blue
4494051117,8,4,11,0,0,0,0,17356,7,18583,206,64,2028,1844,20.6,1735.6,4,8,2,1,1,0,0,15328,6.8,16739,227,55,-2028,-1844,22.7,1532.8,blue,4.75,0.75,17,18,blue
4451562915,10,8,7,0,0,0,0,17677,7,17477,184,67,-44,-2245,18.4,1767.7,8,10,9,0,0,0,0,17721,7.4,19722,224,40,44,2245,22.4,1772.1,blue,2.12,1.7,14,18,blue
4461785475,5,8,2,2,1,1,0,16101,7.2,18784,230,68,-2069,-242,23,1610.1,8,5,6,0,0,0,0,18170,7,19026,239,52,2069,242,23.9,1817,blue,0.88,2.8,12,14,red
4524121467,8,2,15,0,0,0,0,18257,7,18323,209,49,4340,1841,20.9,1825.7,2,8,2,0,0,0,0,13917,6.6,16482,194,46,-4340,-1841,19.4,1391.7,blue,11.5,0.5,16,27,blue
4464520808,8,5,8,1,1,0,0,16801,7.2,19121,198,54,-209,417,19.8,1680.1,5,8,6,0,0,0,0,17010,7,18704,229,52,209,-417,22.9,1701,red,3.2,1.38,77,16,blue
4524429073,9,7,10,0,0,0,0,17352,6.6,17764,220,45,612,678,22,1735.2,7,9,3,1,1,0,0,16740,6.8,17086,223,48,-612,-678,22.3,1674,red,2.71,1.11,15,17,red
4491965198,7,9,12,0,0,0,0,16594,6.6,16531,210,40,-712,-537,21,1659.4,9,7,16,1,1,0,0,17306,6.8,17068,170,64,712,537,17,1730.6,red,2.11,3.57,21,20,blue
4513150611,6,10,5,0,0,0,0,15796,6.6,17324,195,59,-2815,-2607,19.5,1579.6,10,6,11,1,1,0,0,18611,7.6,19931,243,72,2815,2607,24.3,1861.1,red,1.1,3.5,16,20,red
4521085748,5,5,6,0,0,0,0,16372,7,18609,234,44,611,817,23.4,1637.2,5,5,5,1,1,0,0,15761,6.8,17792,222,47,-611,-817,22.2,1576.1,red,2.2,2,17,51,red
4450278971,7,6,6,2,1,1,0,17088,7.2,19719,220,55,1358,641,22,1708.8,6,7,4,0,0,0,0,15730,7.2,19078,211,50,-1358,-641,21.1,1573,blue,2.17,1.43,26,20,blue
4522449879,6,7,8,0,0,0,0,16086,7,17888,199,48,-756,-831,19.9,1608.6,7,6,8,1,1,0,0,16842,7.2,18719,235,60,756,831,23.5,1684.2,red,2,2.5,19,41,blue
4480568800,7,5,6,1,0,1,0,17323,7.2,18801,240,49,1248,-243,24,1732.3,5,7,4,1,1,0,0,16075,7.2,19044,222,58,-1248,243,22.2,1607.5,blue,2.6,1.29,20,23,red
4477952822,4,2,4,0,0,0,0,15205,6.8,17501,234,44,457,690,23.4,1520.5,2,4,2,1,1,0,0,14748,6.6,16811,250,45,-457,-690,25,1474.8,blue,4,1,20,20,red
4524760091,4,8,4,0,0,0,0,16009,7,17560,214,47,-1917,823,21.4,1600.9,8,4,11,1,1,0,1,17926,6.8,16737,198,36,1917,-823,19.8,1792.6,blue,1,4.75,10,15,red
4520303900,5,3,5,1,0,1,1,17531,7.4,19484,241,46,2351,1317,24.1,1753.1,3,5,3,1,1,0,0,15180,7,18167,223,44,-2351,-1317,22.3,1518,blue,3.33,1.2,15,14,red
4524417546,3,5,5,1,1,0,0,15310,7.2,18085,228,52,-354,-8,22.8,1531,5,3,2,0,0,0,0,15664,7,18093,239,43,354,8,23.9,1566.4,blue,1.6,2.33,13,63,red
4505421525,4,9,2,0,0,0,0,14882,6.6,17103,192,36,-5337,-2474,19.2,1488.2,9,4,12,2,1,1,1,20219,7.2,19577,249,56,5337,2474,24.9,2021.9,red,0.67,5.25,17,19,red
4468771669,4,9,4,1,0,1,0,15628,6.8,16659,233,42,-2316,-2043,23.3,1562.8,9,4,10,0,0,0,0,17944,7,18702,243,40,2316,2043,24.3,1794.4,red,0.89,4.75,22,22,blue
4521731006,3,10,6,0,0,0,0,14208,6.4,14744,212,36,-4960,-3887,21.2,1420.8,10,3,17,2,1,1,0,19168,7.2,18631,235,54,4960,3887,23.5,1916.8,red,0.9,9,17,17,red
4491372975,9,3,12,2,1,1,1,19629,7.6,21016,232,59,3865,4032,23.2,1962.9,3,9,7,0,0,0,0,15764,6.8,16984,225,47,-3865,-4032,22.5,1576.4,blue,7,1.11,37,17,blue
4453449535,7,3,13,1,1,0,0,17782,7.2,19382,225,72,2506,1793,22.5,1778.2,3,7,3,0,0,0,0,15276,6.8,17589,220,57,-2506,-1793,22,1527.6,blue,6.67,0.86,19,21,blue
4515416526,2,4,1,0,0,0,0,14790,7.2,18109,240,58,-1156,466,24,1479,4,2,5,1,1,0,0,15946,6.8,17643,240,48,1156,-466,24,1594.6,red,0.75,4.5,25,22,red
4480098596,8,6,8,1,0,1,0,17381,7,18978,218,60,-119,-766,21.8,1738.1,6,8,6,1,1,0,0,17500,7.2,19744,235,75,119,766,23.5,1750,red,2.67,1.5,17,55,blue
4518871878,6,6,9,0,0,0,0,16450,7,17518,212,61,-577,-1953,21.2,1645,6,6,5,2,1,1,0,17027,7.2,19471,239,55,577,1953,23.9,1702.7,red,2.5,1.83,20,17,blue
4505244721,5,7,6,0,0,0,0,16456,6.6,17035,213,51,355,-798,21.3,1645.6,7,5,5,2,1,1,0,16101,6.8,17833,223,60,-355,798,22.3,1610.1,red,1.57,2.4,13,20,red
4505132813,4,9,2,0,0,0,0,15201,7,16780,174,64,-2381,-461,17.4,1520.1,9,4,13,1,1,0,0,17582,6.6,17241,208,44,2381,461,20.8,1758.2,red,0.67,5.5,19,53,red
4523900693,8,5,8,2,1,1,0,17523,7,18222,240,51,1928,1805,24,1752.3,5,8,7,0,0,0,0,15595,6.8,16417,209,45,-1928,-1805,20.9,1559.5,blue,3.2,1.5,20,16,blue
4476189386,7,7,8,0,0,0,0,17072,7,17587,228,52,166,-650,22.8,1707.2,7,7,8,2,1,1,0,16906,7,18237,223,50,-166,650,22.3,1690.6,red,2.14,2.14,19,16,blue
4522477887,11,11,13,0,0,0,0,18878,6.8,18276,222,48,1212,-257,22.2,1887.8,11,11,8,0,0,0,0,17666,7,18533,212,40,-1212,257,21.2,1766.6,red,2.18,1.73,23,20,blue
4483846553,4,4,5,0,0,0,0,14782,6.8,16617,211,47,-1430,-2438,21.1,1478.2,4,4,3,2,1,1,0,16212,7.2,19055,236,64,1430,2438,23.6,1621.2,red,2.25,1.75,14,39,red
4510971608,3,11,4,1,1,0,0,14017,6.6,16410,182,56,-4941,-2777,18.2,1401.7,11,3,8,0,0,0,0,18958,7.4,19187,227,44,4941,2777,22.7,1895.8,red,0.64,6.33,18,20,red
4485213247,7,8,8,0,0,0,0,16670,7,17287,220,42,-508,-1385,22,1667,8,7,6,0,0,0,0,17178,7,18672,217,54,508,1385,21.7,1717.8,red,1.88,2,25,23,red
4519004936,5,9,2,0,0,0,0,14681,6.8,17137,174,44,-2985,-3019,17.4,1468.1,9,5,8,1,1,0,0,17666,7.6,20156,213,55,2985,3019,21.3,1766.6,red,0.78,3.4,11,9,blue
4497704754,3,4,3,0,0,0,0,15268,6.2,15740,202,60,460,-952,20.2,1526.8,4,3,9,1,1,0,0,14808,6.6,16692,209,40,-460,952,20.9,1480.8,blue,1.5,4.33,21,19,blue
4518710566,5,5,10,0,0,0,0,15748,7,17980,203,52,-326,833,20.3,1574.8,5,5,5,2,1,1,0,16074,6.6,17147,204,54,326,-833,20.4,1607.4,red,3,2,16,93,red
4496314087,9,4,9,1,1,0,0,17284,7,18315,238,44,2670,1589,23.8,1728.4,4,9,3,0,0,0,0,14614,6.6,16726,208,42,-2670,-1589,20.8,1461.4,blue,4.5,0.78,20,18,blue
4462815416,6,7,5,0,0,0,0,16806,6.8,17635,205,56,-210,-130,20.5,1680.6,7,6,7,1,0,1,0,17016,6.6,17765,230,45,210,130,23,1701.6,red,1.57,2.33,12,15,blue
4522058891,5,6,7,0,0,0,0,15334,6.8,17065,193,45,-2412,-2055,19.3,1533.4,6,5,5,0,0,0,0,17746,7.2,19120,243,54,2412,2055,24.3,1774.6,blue,2,2.2,12,18,red
4525082822,3,8,4,0,0,0,0,15333,7.2,18245,220,60,-3737,-1022,22,1533.3,8,3,12,2,1,1,1,19070,7.4,19267,260,44,3737,1022,26,1907,red,0.88,6.67,19,22,red
4427770144,7,5,5,0,0,0,0,17491,7.2,19044,251,60,2026,460,25.1,1749.1,5,7,3,1,0,1,0,15465,7.2,18584,189,73,-2026,-460,18.9,1546.5,blue,2.4,1.14,13,13,red
4511070503,4,5,3,1,1,0,0,15698,7.4,18966,214,64,-544,671,21.4,1569.8,5,4,5,0,0,0,0,16242,6.8,18295,238,44,544,-671,23.8,1624.2,blue,1.4,2.5,15,14,blue
4506375047,7,4,10,2,1,1,0,18223,7.2,18996,230,52,3399,2362,23,1822.3,4,7,1,0,0,0,0,14824,6.8,16634,200,39,-3399,-2362,20,1482.4,blue,4.25,0.71,132,99,blue
4521408413,10,8,14,2,1,1,0,18360,7.2,19276,222,44,793,475,22.2,1836,8,10,7,0,0,0,0,17567,7.4,18801,215,56,-793,-475,21.5,1756.7,blue,3,1.5,16,14,blue
4485497527,4,5,4,1,0,1,0,16178,7.6,19249,223,80,297,1259,22.3,1617.8,5,4,5,0,0,0,0,15881,7,17990,225,48,-297,-1259,22.5,1588.1,blue,1.6,2.5,23,23,red
4524501044,3,3,4,1,1,0,0,15048,6.8,17795,223,52,-394,-1174,22.3,1504.8,3,3,3,0,0,0,0,15442,7.2,18969,253,47,394,1174,25.3,1544.2,blue,2.33,2,140,17,blue
4523400040,7,4,14,0,0,0,0,16865,6.8,17583,211,59,1897,1014,21.1,1686.5,4,7,5,0,0,0,0,14968,6.6,16569,182,28,-1897,-1014,18.2,1496.8,blue,5.25,1.29,18,16,red
4469659542,7,9,8,0,0,0,1,18072,7.2,18740,221,40,222,1327,22.1,1807.2,9,7,10,1,1,0,0,17850,6.8,17413,202,51,-222,-1327,20.2,1785,red,1.67,2.71,15,15,red
4506218156,11,7,6,0,0,0,0,17500,7.2,18895,193,54,658,747,19.3,1750,7,11,10,0,0,0,0,16842,6.8,18148,193,64,-658,-747,19.3,1684.2,red,2.43,1.55,18,14,blue
4519740726,6,7,5,0,0,0,0,16688,6.8,17793,213,44,-214,-334,21.3,1668.8,7,6,8,1,1,0,0,16902,7,18127,201,71,214,334,20.1,1690.2,red,1.57,2.5,15,38,blue
4491959967,9,9,6,0,0,0,0,17384,6.8,18722,227,48,-898,-939,22.7,1738.4,9,9,9,2,1,1,0,18282,7.2,19661,225,56,898,939,22.5,1828.2,red,1.67,2,14,12,blue
4518806486,3,8,1,1,0,1,0,15126,7.2,18480,214,72,-3439,-1460,21.4,1512.6,8,3,6,1,1,0,0,18565,7.2,19940,251,56,3439,1460,25.1,1856.5,red,0.5,4.67,15,14,blue
4517729652,7,5,4,0,0,0,0,17214,7,18791,241,64,1892,1261,24.1,1721.4,5,7,5,0,0,0,0,15322,6.8,17530,214,43,-1892,-1261,21.4,1532.2,blue,2.2,1.43,37,26,blue
4523495162,9,11,6,0,0,0,0,17389,6.8,17933,226,36,-1428,-656,22.6,1738.9,11,9,12,1,1,0,0,18817,7,18589,237,43,1428,656,23.7,1881.7,red,1.36,2.56,14,16,red
4515338642,3,4,2,0,0,0,0,14564,6.6,17178,214,43,-1999,-647,21.4,1456.4,4,3,5,1,1,0,0,16563,7,17825,238,64,1999,647,23.8,1656.3,red,1.25,3,21,27,red
4472752313,5,6,3,0,0,0,1,17670,7,19067,253,56,1191,1276,25.3,1767,6,5,5,1,1,0,0,16479,6.8,17791,166,67,-1191,-1276,16.6,1647.9,red,1.33,2.2,12,12,red
4459226162,6,6,5,0,0,0,0,16296,7.2,18903,216,52,301,872,21.6,1629.6,6,6,5,1,1,0,0,15995,6.8,18031,229,44,-301,-872,22.9,1599.5,blue,1.83,1.83,13,14,red
4523400104,5,7,6,0,0,0,0,15738,6.8,16794,191,56,-1712,-2334,19.1,1573.8,7,5,9,1,1,0,0,17450,7.2,19128,222,66,1712,2334,22.2,1745,red,1.57,3.2,14,19,blue
4511018113,1,3,0,0,0,0,0,14118,7,17794,215,64,-2079,-538,21.5,1411.8,3,1,4,0,0,0,0,16197,7,18332,244,53,2079,538,24.4,1619.7,red,0.33,7,14,15,blue
4477706484,8,7,11,0,0,0,0,16343,6.8,16580,179,28,-1182,-1113,17.9,1634.3,7,8,3,1,0,1,1,17525,7,17693,204,55,1182,1113,20.4,1752.5,red,2.71,1.25,21,24,red
4488299127,2,12,3,0,0,0,0,14579,6.4,15758,196,52,-4225,-2478,19.6,1457.9,12,2,16,0,0,0,0,18804,7.2,18236,230,32,4225,2478,23,1880.4,red,0.42,14,15,14,red
4508637954,9,2,15,0,0,0,0,18485,7.2,18688,232,48,4318,2821,23.2,1848.5,2,9,3,1,0,1,0,14167,6.4,15867,197,44,-4318,-2821,19.7,1416.7,blue,12,0.56,17,18,red
4502917237,12,5,11,0,0,0,0,18982,7,18664,234,48,2741,2415,23.4,1898.2,5,12,5,0,0,0,0,16241,6.6,16249,205,48,-2741,-2415,20.5,1624.1,red,4.6,0.83,15,15,blue
4511239909,6,7,5,1,1,0,0,16688,6.8,17678,223,44,-405,437,22.3,1668.8,7,6,11,0,0,0,0,17093,6.6,17241,205,55,405,-437,20.5,1709.3,blue,1.57,3,42,21,blue
4515353757,1,2,1,1,1,0,0,14836,7,18769,261,60,-425,-316,26.1,1483.6,2,1,2,0,0,0,0,15261,7.2,19085,255,64,425,316,25.5,1526.1,blue,1,4,18,66,red
4521770795,2,7,1,0,0,0,0,14573,6.8,17827,212,58,-2928,-1796,21.2,1457.3,7,2,8,2,1,1,0,17501,7.2,19623,239,55,2928,1796,23.9,1750.1,red,0.43,7.5,17,16,red
4441984502,4,11,4,0,0,0,0,15704,6.4,16313,206,46,-3874,-2608,20.6,1570.4,11,4,17,1,1,0,1,19578,7.4,18921,238,45,3874,2608,23.8,1957.8,red,0.73,7,23,20,blue
4496833105,7,6,10,1,0,1,0,16578,7,18528,206,56,-597,275,20.6,1657.8,6,7,6,1,1,0,0,17175,6.8,18253,242,56,597,-275,24.2,1717.5,red,2.83,1.71,18,26,red
4524620492,5,8,5,0,0,0,0,16045,7,17324,208,55,-215,-165,20.8,1604.5,8,5,6,1,1,0,0,16260,7,17489,216,48,215,165,21.6,1626,red,1.25,2.8,18,15,red
4473856795,3,8,4,0,0,0,0,14076,6.4,16132,184,44,-3613,-2636,18.4,1407.6,8,3,8,2,1,1,0,17689,7,18768,234,52,3613,2636,23.4,1768.9,red,0.88,5.33,17,20,red
4481913524,7,3,9,2,1,1,0,16518,7.2,19145,208,48,1630,2330,20.8,1651.8,3,7,2,0,0,0,0,14888,6.8,16815,218,48,-1630,-2330,21.8,1488.8,blue,5.33,0.71,15,20,blue
4523611830,4,11,5,0,0,0,0,15373,6.6,16233,227,38,-2539,-1447,22.7,1537.3,11,4,20,1,1,0,0,17912,7,17680,174,56,2539,1447,17.4,1791.2,red,0.82,7.75,167,20,red
4497770545,4,6,1,0,0,0,0,15519,7,18527,255,48,-1149,-217,25.5,1551.9,6,4,7,0,0,0,0,16668,7.2,18744,238,64,1149,217,23.8,1666.8,red,0.83,3.25,21,24,red
4503426918,9,3,10,1,0,1,0,16795,7.4,19175,203,41,2011,2996,20.3,1679.5,3,9,3,1,1,0,0,14784,6.6,16179,202,46,-2011,-2996,20.2,1478.4,blue,6.33,0.67,50,89,red
4447467809,8,6,15,1,0,1,0,15941,6.8,17256,162,51,-1870,-1732,16.2,1594.1,6,8,5,1,1,0,0,17811,7.4,18988,245,48,1870,1732,24.5,1781.1,red,3.83,1.38,19,16,red
4457030522,7,4,7,1,1,0,0,17676,7.4,20228,233,57,2296,3462,23.3,1767.6,4,7,4,0,0,0,0,15380,6.8,16766,212,41,-2296,-3462,21.2,1538,blue,3.5,1.14,17,18,blue
4459208674,3,4,1,1,1,0,0,15056,6.8,18397,225,51,-278,571,22.5,1505.6,4,3,7,0,0,0,0,15334,6.8,17826,208,59,278,-571,20.8,1533.4,blue,1,3.67,22,17,red
4509184155,2,5,3,0,0,0,0,15282,6.8,17428,243,52,-1665,-1607,24.3,1528.2,5,2,7,2,1,1,0,16947,7.2,19035,248,72,1665,1607,24.8,1694.7,blue,1,6,17,18,red
4518232196,3,7,2,0,0,0,0,15189,6.8,18569,217,67,-1527,-457,21.7,1518.9,7,3,9,1,1,0,0,16716,7.2,19026,224,44,1527,457,22.4,1671.6,red,0.71,5.33,18,40,red
4519767610,6,5,8,0,0,0,0,16285,7,17681,230,44,160,-337,23,1628.5,5,6,8,0,0,0,0,16125,6.8,18018,204,64,-160,337,20.4,1612.5,blue,2.8,2.17,22,18,red
4484657293,8,4,11,1,1,0,0,18382,7,19220,224,68,2498,1487,22.4,1838.2,4,8,5,0,0,0,0,15884,7,17733,217,52,-2498,-1487,21.7,1588.4,blue,4.75,1.12,25,20,blue
4513433271,4,7,4,1,1,0,0,15746,7,17836,195,62,-1556,286,19.5,1574.6,7,4,6,0,0,0,0,17302,6.8,17550,237,53,1556,-286,23.7,1730.2,blue,1.14,3.25,83,52,red
4454960221,5,12,4,0,0,0,0,16141,7.2,19127,215,52,-3324,-1649,21.5,1614.1,12,5,8,1,1,0,0,19465,7.6,20776,236,58,3324,1649,23.6,1946.5,red,0.75,4,49,20,red
4515557026,5,6,2,1,0,1,0,15558,6.6,17405,221,47,-209,800,22.1,1555.8,6,5,8,1,1,0,0,15767,6.8,16605,185,44,209,-800,18.5,1576.7,blue,1.17,2.8,20,24,red
4517524555,2,0,1,0,0,0,0,15486,7,18701,251,68,1386,1830,25.1,1548.6,0,2,0,0,0,0,0,14100,6.4,16871,234,54,-1386,-1830,23.4,1410,blue,12.03,0,17,21,blue
4523456164,9,6,16,0,0,0,0,17335,6.8,17918,193,50,2094,2937,19.3,1733.5,6,9,14,0,0,0,0,15241,6.2,14981,170,33,-2094,-2937,17,1524.1,blue,4.17,2.22,41,16,blue
4518840906,1,14,1,0,0,0,0,12598,6,14826,204,20,-7070,-4989,20.4,1259.8,14,1,15,0,0,0,0,19668,7.4,19815,220,39,7070,4989,22,1966.8,red,0.14,29,11,49,red
4517025991,9,8,6,2,1,1,0,17385,7.2,18349,216,60,1133,1833,21.6,1738.5,8,9,7,0,0,0,0,16252,6.8,16516,178,28,-1133,-1833,17.8,1625.2,blue,1.88,1.67,14,38,red
4515203264,6,5,11,1,1,0,0,16452,6.8,17946,208,60,906,1330,20.8,1645.2,5,6,7,0,0,0,0,15546,6.6,16616,185,43,-906,-1330,18.5,1554.6,blue,3.4,2,17,17,red
4524451001,8,8,10,0,0,0,0,15996,6.2,15159,185,36,-2523,-2980,18.5,1599.6,8,8,10,1,0,1,0,18519,6.8,18139,231,40,2523,2980,23.1,1851.9,blue,2.25,2.25,21,24,blue
4522089965,6,7,3,0,0,0,0,16370,6.6,16868,231,48,-129,-726,23.1,1637,7,6,8,0,0,0,0,16499,7,17594,182,44,129,726,18.2,1649.9,blue,1.29,2.5,18,45,red
4515344624,1,2,1,1,0,1,0,14264,7,18355,220,63,-1450,340,22,1426.4,2,1,2,1,1,0,0,15714,6.8,18015,259,48,1450,-340,25.9,1571.4,red,1,4,21,25,red
4510754518,5,4,3,1,1,0,0,17061,7.6,20292,249,76,1217,2934,24.9,1706.1,4,5,6,0,0,0,0,15844,6.6,17358,218,48,-1217,-2934,21.8,1584.4,blue,2,2,22,16,red
4489696117,9,6,9,1,1,0,0,16738,6.8,16893,198,44,91,-1992,19.8,1673.8,6,9,5,0,0,0,0,16647,7.2,18885,224,55,-91,1992,22.4,1664.7,red,3,1.22,15,15,blue
4469208357,9,9,5,0,0,0,0,17999,7.2,19369,227,43,1128,1720,22.7,1799.9,9,9,12,1,1,0,0,16871,7,17649,212,40,-1128,-1720,21.2,1687.1,blue,1.56,2.33,73,17,red
4462808439,11,11,11,0,0,0,0,18496,7,17777,213,50,672,-1567,21.3,1849.6,11,11,6,1,1,0,0,17824,7.2,19344,216,54,-672,1567,21.6,1782.4,red,2,1.55,14,12,red
4455347152,7,6,11,0,0,0,0,16414,6.8,17333,205,48,-33,-677,20.5,1641.4,6,7,6,0,0,0,0,16447,7,18010,223,56,33,677,22.3,1644.7,blue,3,1.71,32,26,red
4505414237,5,5,6,0,0,0,0,16563,6.8,17565,226,53,1149,-530,22.6,1656.3,5,5,6,0,0,0,0,15414,6.8,18095,205,51,-1149,530,20.5,1541.4,red,2.2,2.2,20,24,blue
4473172269,1,2,1,1,1,0,0,14314,7,17525,244,49,59,77,24.4,1431.4,2,1,1,0,0,0,0,14255,6.8,17448,224,49,-59,-77,22.4,1425.5,blue,1,3,18,13,red
4517689949,6,6,4,0,0,0,0,16556,7.2,18696,231,56,399,147,23.1,1655.6,6,6,4,2,1,1,0,16157,7,18549,239,54,-399,-147,23.9,1615.7,blue,1.67,1.67,13,16,red
4513337706,4,7,6,1,1,0,0,14604,6.6,16297,190,50,-4058,-3454,19,1460.4,7,4,5,1,0,1,1,18662,7.4,19751,257,52,4058,3454,25.7,1866.2,red,1.43,3,15,16,blue
4524645107,4,5,4,0,0,0,0,16195,7.2,18670,241,64,-339,-868,24.1,1619.5,5,4,4,1,1,0,0,16534,7.4,19538,259,59,339,868,25.9,1653.4,red,1.6,2.25,20,16,red
4459652574,6,7,2,1,1,0,0,14668,6.6,16843,198,40,-3686,-2333,19.8,1466.8,7,6,7,1,0,1,1,18354,7.2,19176,232,46,3686,2333,23.2,1835.4,red,1.14,2.33,20,21,blue
4494605842,6,11,8,0,0,0,0,16557,6.8,17924,232,55,-2564,170,23.2,1655.7,11,6,25,1,1,0,0,19121,6.8,17754,219,55,2564,-170,21.9,1912.1,blue,1.27,6,17,17,red
4424206558,7,8,10,1,1,0,0,16863,6.6,17727,216,48,106,-462,21.6,1686.3,8,7,9,0,0,0,0,16757,7.2,18189,184,52,-106,462,18.4,1675.7,blue,2.12,2.43,18,14,blue
4524523316,13,9,16,2,1,1,0,19694,7.2,19555,215,64,1910,1136,21.5,1969.4,9,13,13,0,0,0,0,17784,7.2,18419,212,44,-1910,-1136,21.2,1778.4,blue,3.22,1.69,39,18,blue
4521614053,10,8,8,1,1,0,0,18523,7.2,19699,229,42,2400,2600,22.9,1852.3,8,10,6,0,0,0,0,16123,6.8,17099,191,34,-2400,-2600,19.1,1612.3,blue,2.25,1.4,12,13,red
4523056314,10,8,8,1,1,0,0,17618,7,18069,212,48,975,1131,21.2,1761.8,8,10,4,0,0,0,0,16643,6.8,16938,196,45,-975,-1131,19.6,1664.3,blue,2.25,1.2,18,26,blue
4452642610,9,4,9,0,0,0,0,18751,7.2,20236,249,58,4671,4193,24.9,1875.1,4,9,5,1,1,0,0,14080,6.6,16043,177,57,-4671,-4193,17.7,1408,red,4.5,1,15,37,blue
4520976634,2,11,2,1,1,0,0,13932,6.4,15660,193,56,-5540,-3682,19.3,1393.2,11,2,13,0,0,0,1,19472,7.2,19342,245,40,5540,3682,24.5,1947.2,red,0.36,12,18,19,blue
4524958032,5,9,9,1,1,0,0,16394,7.2,17514,238,41,-2037,-1895,23.8,1639.4,9,5,12,1,0,1,0,18431,7.2,19409,229,42,2037,1895,22.9,1843.1,red,1.56,4.2,18,18,blue
4519909755,11,7,12,1,1,0,0,18276,6.8,17133,202,51,1281,-5,20.2,1827.6,7,11,10,0,0,0,0,16995,6.6,17138,214,36,-1281,5,21.4,1699.5,blue,3.29,1.55,18,16,blue
4467514491,9,7,14,1,1,0,0,17722,7,18023,215,44,1672,1341,21.5,1772.2,7,9,8,0,0,0,0,16050,6.8,16682,205,35,-1672,-1341,20.5,1605,blue,3.29,1.67,22,20,blue
4440493059,5,2,4,2,1,1,0,16517,7.2,19476,246,56,2123,2669,24.6,1651.7,2,5,4,0,0,0,0,14394,6.6,16807,220,45,-2123,-2669,22,1439.4,red,4.5,1.2,39,160,blue
4514309643,5,7,6,0,0,0,0,15337,6.6,16528,198,39,-646,-148,19.8,1533.7,7,5,9,0,0,0,0,15983,6.6,16676,197,36,646,148,19.7,1598.3,red,1.57,3.2,20,20,red
4497569753,7,9,7,0,0,0,0,17569,7.2,18822,239,42,-72,529,23.9,1756.9,9,7,11,2,1,1,0,17641,7,18293,209,56,72,-529,20.9,1764.1,blue,1.56,2.86,20,41,red
4452121549,9,4,9,1,1,0,0,17585,7.4,18820,240,40,2268,635,24,1758.5,4,9,3,0,0,0,0,15317,7.2,18185,219,43,-2268,-635,21.9,1531.7,blue,4.5,0.78,23,20,blue
4518053944,5,9,4,0,0,0,0,15950,7,18040,231,46,-2365,-2046,23.1,1595,9,5,6,1,1,0,0,18315,7.4,20086,233,56,2365,2046,23.3,1831.5,red,1,3,47,19,red
4510943404,7,6,9,0,0,0,0,16531,7,17534,218,40,-136,-290,21.8,1653.1,6,7,8,2,1,1,0,16667,7,17824,243,55,136,290,24.3,1666.7,blue,2.67,2,24,25,blue
4522252623,8,11,9,1,1,0,0,16599,6.6,16907,189,39,-2683,-1320,18.9,1659.9,11,8,17,1,0,1,0,19282,7.2,18227,209,53,2683,1320,20.9,1928.2,red,1.55,3.5,13,20,red
4518296609,5,4,6,1,1,0,0,16086,7,18044,222,68,441,626,22.2,1608.6,4,5,5,0,0,0,0,15645,6.8,17418,235,44,-441,-626,23.5,1564.5,red,2.75,1.8,18,18,red
4462918469,1,5,1,0,0,0,0,15065,6.8,17423,252,68,-950,-1785,25.2,1506.5,5,1,6,0,0,0,0,16015,7.2,19208,238,55,950,1785,23.8,1601.5,red,0.4,11,28,32,red
4506279067,2,7,1,0,0,0,0,13946,6.4,16248,227,22,-2727,-2041,22.7,1394.6,7,2,10,1,1,0,0,16673,7,18289,220,58,2727,2041,22,1667.3,red,0.43,8.5,18,24,red
4517922682,7,5,10,0,0,0,0,16526,7.2,19072,217,56,-64,239,21.7,1652.6,5,7,4,0,0,0,0,16590,7,18833,214,60,64,-239,21.4,1659,red,3.4,1.29,39,68,red
4523323682,7,6,8,0,0,0,0,16495,6.8,17444,211,48,222,-72,21.1,1649.5,6,7,6,1,1,0,0,16273,6.8,17516,205,52,-222,72,20.5,1627.3,red,2.5,1.71,19,19,blue
4499522050,3,3,1,1,0,1,1,17009,7.2,18492,238,78,862,1098,23.8,1700.9,3,3,5,1,1,0,0,16147,6.8,17394,252,69,-862,-1098,25.2,1614.7,blue,1.33,2.67,22,28,red
4517907047,4,10,3,0,0,0,0,15419,6.4,17517,191,43,-2636,-839,19.1,1541.9,10,4,9,0,0,0,0,18055,6.8,18356,225,48,2636,839,22.5,1805.5,red,0.7,4.75,17,16,blue
4520625365,7,5,9,1,1,0,0,16460,7,17849,220,48,23,-338,22,1646,5,7,8,0,0,0,0,16437,7,18187,222,48,-23,338,22.2,1643.7,blue,3.2,1.86,40,17,red
4451981471,7,11,6,0,0,0,0,16364,6.4,16467,223,29,-1565,-1752,22.3,1636.4,11,7,14,2,1,1,0,17929,7,18219,170,70,1565,1752,17,1792.9,red,1.18,3.57,17,22,red
4465934197,6,3,7,0,0,0,0,16434,6.8,18132,216,77,1545,1824,21.6,1643.4,3,6,3,1,1,0,0,14889,6.4,16308,233,40,-1545,-1824,23.3,1488.9,blue,4.33,1,20,21,blue
4506773682,9,4,11,0,0,0,0,17685,7,17947,224,36,2260,248,22.4,1768.5,4,9,3,0,0,0,0,15425,7,17699,226,47,-2260,-248,22.6,1542.5,red,5,0.78,17,18,blue
4513374819,6,10,8,0,0,0,0,16506,6.8,16828,216,45,-2535,-2654,21.6,1650.6,10,6,10,1,1,0,0,19041,7.4,19482,228,55,2535,2654,22.8,1904.1,blue,1.4,3.33,110,41,red
4471258643,9,6,9,0,0,0,0,17174,6.8,18060,212,32,1514,1421,21.2,1717.4,6,9,6,1,0,1,0,15660,6.8,16639,187,44,-1514,-1421,18.7,1566,blue,3,1.33,17,38,red
4521842384,3,5,6,0,0,0,0,14771,7,17825,227,44,-1426,-26,22.7,1477.1,5,3,4,2,1,1,0,16197,7,17851,218,52,1426,26,21.8,1619.7,blue,1.8,3,16,26,red
4524715450,6,8,10,1,1,0,0,16359,6.4,15794,182,49,-2414,-3087,18.2,1635.9,8,6,4,0,0,0,1,18773,7.2,18881,225,49,2414,3087,22.5,1877.3,blue,2,2,28,42,blue
4523070101,5,5,10,1,1,0,0,15871,7,18125,219,43,1007,1105,21.9,1587.1,5,5,8,1,0,1,0,14864,6.8,17020,164,43,-1007,-1105,16.4,1486.4,blue,3,2.6,19,17,red
4524739257,6,2,6,1,1,0,1,18215,7.2,18418,256,52,4749,3580,25.6,1821.5,2,6,1,0,0,0,0,13466,6.2,14838,207,40,-4749,-3580,20.7,1346.6,blue,6,0.5,21,17,blue
4424119688,5,8,3,0,0,0,0,15747,7,17856,214,52,-1358,-1063,21.4,1574.7,8,5,8,0,0,0,0,17105,7,18919,219,52,1358,1063,21.9,1710.5,blue,1,3.2,15,17,blue
4514193601,7,3,7,0,0,0,0,16464,7.2,18030,209,36,1474,963,20.9,1646.4,3,7,3,0,0,0,0,14990,6.6,17067,225,45,-1474,-963,22.5,1499,blue,4.67,0.86,14,17,red
4518928631,8,2,7,0,0,0,0,16424,6.8,17611,196,48,2588,1543,19.6,1642.4,2,8,0,1,0,1,0,13836,6.6,16068,185,60,-2588,-1543,18.5,1383.6,blue,7.5,0.25,20,18,blue
4413670399,9,8,14,1,1,0,0,17494,6.8,17832,201,44,14,202,20.1,1749.4,8,9,9,0,0,0,0,17480,7,17630,243,44,-14,-202,24.3,1748,red,2.88,1.89,23,20,red
4506003362,8,1,8,1,0,1,0,18691,7.2,20672,228,76,5359,4990,22.8,1869.1,1,8,2,1,1,0,0,13332,6.4,15682,208,36,-5359,-4990,20.8,1333.2,blue,16,0.38,44,20,blue
4519816052,7,11,6,1,0,1,0,16446,7,18130,218,50,-3620,-282,21.8,1644.6,11,7,16,0,0,0,1,20066,6.8,18412,229,34,3620,282,22.9,2006.6,red,1.18,3.86,20,16,red
4518755831,7,10,8,0,0,0,0,16259,6.8,16527,184,46,-2295,-2516,18.4,1625.9,10,7,13,0,0,0,0,18554,7.2,19043,228,47,2295,2516,22.8,1855.4,red,1.5,3.29,17,15,blue
4509249134,4,11,4,1,1,0,0,16231,7.2,18316,211,56,-2932,-2135,21.1,1623.1,11,4,15,0,0,0,0,19163,7.4,20451,215,52,2932,2135,21.5,1916.3,red,0.73,6.5,19,42,blue
4381068813,7,3,8,1,1,0,0,16146,6.6,16204,196,43,2037,-281,19.6,1614.6,3,7,3,0,0,0,0,14109,6.4,16485,172,57,-2037,281,17.2,1410.9,red,5,0.86,43,24,blue
4443689481,9,6,8,1,1,0,0,17344,6.8,17484,191,48,992,-609,19.1,1734.4,6,9,6,0,0,0,0,16352,7,18093,206,57,-992,609,20.6,1635.2,blue,2.83,1.33,22,14,blue
4523513281,8,5,12,0,0,0,0,17327,7,18655,203,65,1568,611,20.3,1732.7,5,8,5,0,0,0,0,15759,7,18044,212,44,-1568,-611,21.2,1575.9,blue,4,1.25,15,16,red
4524371920,6,7,3,1,0,1,0,16568,7,18066,215,60,-727,322,21.5,1656.8,7,6,10,1,1,0,0,17295,7,17744,211,42,727,-322,21.1,1729.5,red,1.29,2.83,15,17,blue
4517907336,3,4,4,0,0,0,0,15732,7,18040,241,50,-185,45,24.1,1573.2,4,3,4,1,1,0,0,15917,7,17995,238,61,185,-45,23.8,1591.7,red,1.75,2.67,18,17,blue
4496746747,7,5,5,0,0,0,0,16812,7,19678,228,56,1322,2276,22.8,1681.2,5,7,5,1,1,0,0,15490,6.6,17402,215,64,-1322,-2276,21.5,1549,blue,2.4,1.43,58,21,blue
4493140120,4,2,2,0,0,0,0,16452,7.2,19307,273,60,1068,618,27.3,1645.2,2,4,4,0,0,0,0,15384,7.2,18689,253,68,-1068,-618,25.3,1538.4,blue,3,1.5,24,20,blue
4517972804,6,3,6,1,1,0,0,17427,7,19221,249,63,1975,1433,24.9,1742.7,3,6,2,0,0,0,0,15452,7,17788,234,60,-1975,-1433,23.4,1545.2,blue,4,0.83,19,20,blue
4520080755,7,3,10,1,1,0,0,16892,7,18221,207,64,2391,1726,20.7,1689.2,3,7,1,0,0,0,0,14501,6.6,16495,190,47,-2391,-1726,19,1450.1,blue,5.67,0.57,21,15,red
4524921520,5,5,4,0,0,0,0,17003,7.2,18752,252,59,570,368,25.2,1700.3,5,5,4,0,0,0,0,16433,7.2,18384,235,52,-570,-368,23.5,1643.3,blue,1.8,1.8,26,77,red
4520997585,7,4,11,1,1,0,0,16836,7.2,18457,205,48,1138,1758,20.5,1683.6,4,7,3,0,0,0,0,15698,6.6,16699,223,44,-1138,-1758,22.3,1569.8,red,4.5,1,50,44,blue
4454798967,3,11,4,1,1,0,0,14434,6.6,16488,181,60,-6972,-3956,18.1,1443.4,11,3,10,1,0,1,1,21406,7.6,20444,240,51,6972,3956,24,2140.6,red,0.64,7,15,14,red
4525230737,7,7,9,0,0,0,0,16696,6.8,17704,202,52,-422,-43,20.2,1669.6,7,7,10,2,1,1,0,17118,7,17747,189,53,422,43,18.9,1711.8,blue,2.29,2.43,16,29,red
4500075336,8,1,12,1,1,0,0,16974,7.2,18550,182,56,2906,2360,18.2,1697.4,1,8,1,0,0,0,0,14068,6.4,16190,201,48,-2906,-2360,20.1,1406.8,blue,20,0.25,27,13,blue
4524067134,2,6,3,1,1,0,0,13653,7,17299,178,55,-4566,-2032,17.8,1365.3,6,2,5,1,0,1,1,18219,7.2,19331,260,46,4566,2032,26,1821.9,red,0.83,5.5,18,30,red
4518945702,1,4,1,1,1,0,0,13934,6.8,17303,222,55,-1571,-693,22.2,1393.4,4,1,6,0,0,0,0,15505,7,17996,191,61,1571,693,19.1,1550.5,red,0.5,10,17,15,red
4509446311,0,7,0,0,0,0,0,13405,6.6,15825,214,42,-3556,-2950,21.4,1340.5,7,0,6,0,0,0,0,16961,7,18775,237,36,3556,2950,23.7,1696.1,red,0,12.65,76,25,red
4517812260,10,6,9,2,1,1,0,18747,7.2,19584,225,53,3015,3067,22.5,1874.7,6,10,5,0,0,0,0,15732,6.8,16517,184,60,-3015,-3067,18.4,1573.2,blue,3.17,1.1,47,19,blue
4524307745,3,4,2,1,0,1,0,15156,7,18116,217,51,-324,1651,21.7,1515.6,4,3,5,1,1,0,0,15480,6.6,16465,220,44,324,-1651,22,1548,blue,1.25,3,20,26,red
4519784011,11,7,12,1,1,0,1,19241,7,18942,198,50,1350,577,19.8,1924.1,7,11,11,0,0,0,0,17891,7,18365,247,44,-1350,-577,24.7,1789.1,blue,3.29,1.64,35,13,red
4515529388,7,5,6,1,1,0,0,15866,6.8,17452,176,59,394,-55,17.6,1586.6,5,7,4,0,0,0,0,15472,6.8,17507,216,45,-394,55,21.6,1547.2,blue,2.6,1.29,16,16,red
4519280079,3,5,2,1,1,0,0,14247,6.6,16806,226,41,-1597,-715,22.6,1424.7,5,3,8,1,0,1,0,15844,6.8,17521,218,47,1597,715,21.8,1584.4,blue,1,4.33,29,43,red
4519506293,3,8,4,0,0,0,0,13493,6.2,14240,167,36,-5355,-5889,16.7,1349.3,8,3,9,1,1,0,0,18848,7.4,20129,234,84,5355,5889,23.4,1884.8,red,0.88,5.67,19,19,red
4442047258,4,5,1,1,1,0,0,15855,7,18078,238,56,145,972,23.8,1585.5,5,4,7,0,0,0,0,15710,6.6,17106,224,36,-145,-972,22.4,1571,blue,1,3,20,20,blue
4494271393,1,1,1,1,0,1,0,15186,7,17891,231,60,1120,477,23.1,1518.6,1,1,2,1,1,0,0,14066,6.8,17414,196,60,-1120,-477,19.6,1406.6,blue,2,3,19,41,blue
4508960855,10,7,12,1,1,0,0,17176,6.8,17299,188,57,99,277,18.8,1717.6,7,10,8,0,0,0,1,17077,6.6,17022,203,38,-99,-277,20.3,1707.7,blue,3.14,1.5,42,23,blue
4474929449,5,5,7,2,1,1,0,16947,7.2,18756,226,68,980,403,22.6,1694.7,5,5,3,0,0,0,0,15967,6.8,18353,243,48,-980,-403,24.3,1596.7,blue,2.4,1.6,24,208,red
4506806960,11,2,10,1,1,0,0,19528,7.2,19357,234,40,5351,3549,23.4,1952.8,2,11,2,0,0,0,0,14177,6.4,15808,211,50,-5351,-3549,21.1,1417.7,blue,10.5,0.36,17,16,blue
4462748470,1,6,1,0,0,0,0,13775,6.8,17108,206,52,-2490,-1110,20.6,1377.5,6,1,4,1,1,0,0,16265,7.2,18218,237,52,2490,1110,23.7,1626.5,red,0.33,10,16,58,red
4445519419,10,5,12,2,1,1,0,18418,7,18311,247,51,3750,2742,24.7,1841.8,5,10,6,0,0,0,0,14668,6.4,15569,194,24,-3750,-2742,19.4,1466.8,blue,4.4,1.1,22,19,blue
4511125320,3,4,3,0,0,0,0,14815,6.4,16774,189,56,-755,-1590,18.9,1481.5,4,3,6,1,1,0,0,15570,7,18364,210,64,755,1590,21,1557,blue,1.5,3.33,52,15,blue
4513249754,13,8,20,1,0,1,2,21728,7.4,20117,242,62,4161,2591,24.2,2172.8,8,13,15,0,0,0,0,17567,6.8,17526,214,58,-4161,-2591,21.4,1756.7,blue,4.12,1.77,18,12,blue
4521266172,5,2,8,1,1,0,0,16348,7,18350,243,47,1476,1149,24.3,1634.8,2,5,4,0,0,0,0,14872,6.8,17201,233,51,-1476,-1149,23.3,1487.2,red,6.5,1.2,17,21,blue
4523722482,6,5,8,2,1,1,0,16302,7.2,18772,231,46,336,936,23.1,1630.2,5,6,5,0,0,0,0,15966,7,17836,223,44,-336,-936,22.3,1596.6,red,2.8,1.67,17,16,red
4524619548,3,5,4,1,0,1,0,15410,6.8,17797,216,65,-234,-406,21.6,1541,5,3,2,1,1,0,0,15644,7,18203,236,40,234,406,23.6,1564.4,red,1.4,2.33,21,34,blue
4502850011,4,8,3,0,0,0,0,15119,6.4,16105,216,35,-1901,-3111,21.6,1511.9,8,4,10,1,1,0,0,17020,7.2,19216,216,64,1901,3111,21.6,1702,red,0.88,4.5,20,19,blue
4516825345,7,8,7,0,0,0,0,16561,7,17480,201,60,-519,-643,20.1,1656.1,8,7,9,2,1,1,0,17080,7,18123,228,52,519,643,22.8,1708,red,1.75,2.43,13,16,blue
4489945010,1,5,2,0,0,0,0,13736,6.6,15897,180,68,-2301,-2659,18,1373.6,5,1,3,2,1,1,0,16037,7.2,18556,226,60,2301,2659,22.6,1603.7,red,0.6,8,19,17,red
4475361791,4,5,5,1,0,1,0,15481,6.6,17390,222,40,481,977,22.2,1548.1,5,4,8,1,1,0,0,15000,6.4,16413,199,51,-481,-977,19.9,1500,red,1.8,3.25,22,22,blue
4459545656,4,6,3,0,0,0,0,15967,7,18406,227,56,-1413,-1302,22.7,1596.7,6,4,9,2,1,1,0,17380,7.2,19708,256,72,1413,1302,25.6,1738,red,1.17,3.75,24,22,red
4525136994,5,6,6,0,0,0,0,16627,7,18363,223,59,-135,-997,22.3,1662.7,6,5,7,1,1,0,0,16762,7,19360,236,68,135,997,23.6,1676.2,blue,1.83,2.6,80,55,red
4524766949,9,8,8,0,0,0,0,17087,6.8,17623,190,33,442,-145,19,1708.7,8,9,7,1,0,1,0,16645,6.8,17768,186,51,-442,145,18.6,1664.5,blue,2.12,1.67,18,15,red
4440143794,6,3,8,1,1,0,0,17612,7.6,19905,246,68,2356,2431,24.6,1761.2,3,6,2,0,0,0,0,15256,7,17474,213,55,-2356,-2431,21.3,1525.6,blue,4.67,0.83,53,20,red
4469179994,8,6,17,0,0,0,0,16731,6.4,16329,205,56,266,-912,20.5,1673.1,6,8,6,1,1,0,0,16465,6.6,17241,218,35,-266,912,21.8,1646.5,red,4.17,1.5,59,21,blue
4470980027,12,8,17,1,1,0,0,18360,6.8,17412,202,39,525,476,20.2,1836,8,12,7,0,0,0,0,17835,6.6,16936,218,38,-525,-476,21.8,1783.5,blue,3.62,1.25,27,19,red
4464908218,8,4,4,1,0,1,0,18075,7.4,19469,237,49,2859,2944,23.7,1807.5,4,8,6,0,0,0,0,15216,6.6,16525,224,48,-2859,-2944,22.4,1521.6,blue,3,1.25,22,20,blue
4523664992,10,5,11,0,0,0,0,19636,7.2,19567,247,55,4253,2731,24.7,1963.6,5,10,6,2,1,1,0,15383,6.6,16836,209,56,-4253,-2731,20.9,1538.3,red,4.2,1.1,47,20,blue
4522444322,6,2,8,1,0,1,0,16897,7,18652,234,56,1923,1300,23.4,1689.7,2,6,2,1,1,0,0,14974,6.8,17352,240,48,-1923,-1300,24,1497.4,blue,7,0.67,14,17,blue
4476291723,4,5,4,0,0,0,0,14538,6.6,16373,211,32,-3278,-1873,21.1,1453.8,5,4,5,1,0,1,1,17816,7.2,18246,255,51,3278,1873,25.5,1781.6,red,1.6,2.5,15,20,blue
4450075643,2,8,2,0,0,0,0,14868,6.6,17584,224,53,-1146,-441,22.4,1486.8,8,2,4,0,0,0,0,16014,6.8,18025,162,44,1146,441,16.2,1601.4,blue,0.5,6,21,22,red
4519262585,14,5,12,1,1,0,0,20979,7.6,20534,250,68,4091,3392,25,2097.9,5,14,8,0,0,0,0,16888,6.8,17142,215,48,-4091,-3392,21.5,1688.8,blue,5.2,0.93,21,22,blue
4522013704,4,6,7,0,0,0,0,16513,6.8,18383,249,43,-379,725,24.9,1651.3,6,4,12,1,1,0,0,16892,6.8,17658,240,52,379,-725,24,1689.2,blue,1.83,4.5,24,25,red
4523105272,4,4,5,1,1,0,0,16180,7,18032,210,68,476,100,21,1618,4,4,2,1,0,1,0,15704,6.8,17932,232,56,-476,-100,23.2,1570.4,blue,2.25,1.5,19,17,red
4524327775,6,3,8,0,0,0,0,16050,7,17867,195,44,2041,1289,19.5,1605,3,6,1,0,0,0,0,14009,6.4,16578,202,44,-2041,-1289,20.2,1400.9,blue,4.67,0.67,25,39,blue
4480343563,2,5,2,0,0,0,0,14428,6.6,16758,210,67,-1552,-1506,21,1442.8,5,2,10,0,0,0,0,15980,6.8,18264,223,57,1552,1506,22.3,1598,red,0.8,7.5,22,13,red
4469769550,6,14,4,0,0,0,0,16150,6.6,16419,194,41,-2243,-2024,19.4,1615,14,6,13,0,0,0,0,18393,7,18443,186,56,2243,2024,18.6,1839.3,red,0.71,4.5,20,18,red
4521100238,7,3,7,0,0,0,0,17576,7.2,18867,227,44,2237,1848,22.7,1757.6,3,7,4,0,0,0,0,15339,6.8,17019,209,60,-2237,-1848,20.9,1533.9,red,4.67,1,56,15,blue
4522815979,4,4,5,1,1,0,0,14990,6.8,17315,187,50,-1395,-711,18.7,1499,4,4,3,0,0,0,0,16385,7,18026,248,44,1395,711,24.8,1638.5,blue,2.25,1.75,43,64,red
4520884097,8,8,7,1,1,0,0,17664,7,19310,220,60,257,1665,22,1766.4,8,8,11,1,0,1,0,17407,6.8,17645,225,56,-257,-1665,22.5,1740.7,blue,1.88,2.38,18,17,red
4439064814,4,3,4,1,1,0,0,16114,7,17563,235,39,1323,25,23.5,1611.4,3,4,5,0,0,0,0,14791,6.8,17538,203,48,-1323,-25,20.3,1479.1,red,2.67,2,24,24,blue
4513417068,3,6,3,1,1,0,0,15299,6.4,17076,230,52,-874,-1276,23,1529.9,6,3,6,0,0,0,0,16173,7,18352,231,44,874,1276,23.1,1617.3,red,1,4,16,40,blue
4481862687,10,2,12,2,1,1,0,18912,7,17839,257,44,4565,2079,25.7,1891.2,2,10,2,0,0,0,0,14347,6.2,15760,197,52,-4565,-2079,19.7,1434.7,blue,11,0.4,23,23,blue
4484833636,7,4,11,1,0,1,2,19915,7.2,18674,246,53,5286,3583,24.6,1991.5,4,7,8,1,1,0,0,14629,6.2,15091,154,45,-5286,-3583,15.4,1462.9,blue,4.5,1.71,25,18,blue
4523328232,7,6,9,1,0,1,1,18273,6.8,17500,207,48,2544,862,20.7,1827.3,6,7,11,1,1,0,0,15729,6.6,16638,185,48,-2544,-862,18.5,1572.9,blue,2.67,2.43,16,20,blue
4524881120,4,5,3,1,1,0,0,15158,7,17680,219,52,-1529,-1177,21.9,1515.8,5,4,7,0,0,0,0,16687,7.2,18857,213,59,1529,1177,21.3,1668.7,red,1.4,3,16,53,red
4458570430,4,5,5,1,1,0,0,16086,6.8,17616,222,56,842,-663,22.2,1608.6,5,4,5,0,0,0,0,15244,7,18279,201,44,-842,663,20.1,1524.4,blue,1.8,2.5,20,17,blue
4478759244,9,6,7,0,0,0,0,18626,7.2,18656,226,54,2318,339,22.6,1862.6,6,9,4,1,0,1,0,16308,7.2,18317,239,40,-2318,-339,23.9,1630.8,red,2.67,1.11,20,82,blue
4521034143,8,10,13,1,1,0,0,17048,6.8,17097,193,52,-1773,-1963,19.3,1704.8,10,8,13,0,0,0,0,18821,7.2,19060,215,51,1773,1963,21.5,1882.1,red,2.1,2.88,21,18,red
4521437370,2,5,1,0,0,0,0,14819,7,17986,223,63,-930,-594,22.3,1481.9,5,2,3,2,1,1,0,15749,6.8,18580,210,52,930,594,21,1574.9,red,0.6,4,17,20,blue
4480431090,5,5,7,0,0,0,0,15082,6.8,16399,199,40,-1851,-2039,19.9,1508.2,5,5,4,1,0,1,0,16933,7,18438,258,52,1851,2039,25.8,1693.3,red,2.4,1.8,17,18,red
4486764809,1,3,1,1,0,1,0,14605,7,17830,244,48,-280,903,24.4,1460.5,3,1,3,1,1,0,0,14885,6.6,16927,217,60,280,-903,21.7,1488.5,red,0.67,6,20,17,red
4521838243,9,10,12,1,1,0,0,17063,7.2,18195,200,44,-1220,-203,20,1706.3,10,9,13,0,0,0,0,18283,7.2,18398,217,43,1220,203,21.7,1828.3,red,2.1,2.56,20,21,red
4462640479,1,9,0,0,0,0,0,13881,6.8,16482,225,56,-4851,-3577,22.5,1388.1,9,1,12,1,1,0,0,18732,7.4,20059,243,70,4851,3577,24.3,1873.2,red,0.11,21,18,40,red
4519429379,6,4,5,0,0,0,0,17180,7,19599,258,64,1748,1496,25.8,1718,4,6,1,1,1,0,0,15432,7,18103,236,50,-1748,-1496,23.6,1543.2,blue,2.75,0.83,40,13,blue
4525188485,6,9,4,0,0,0,0,16978,6.8,17957,229,60,-1589,-2907,22.9,1697.8,9,6,11,1,0,1,0,18567,7.8,20864,193,75,1589,2907,19.3,1856.7,blue,1.11,3.33,16,35,blue
4511423675,12,5,10,0,0,0,0,17827,6.8,18481,208,35,1756,1128,20.8,1782.7,5,12,6,1,1,0,0,16071,6.8,17353,188,61,-1756,-1128,18.8,1607.1,blue,4.4,0.92,21,34,red
4488518196,6,5,8,1,1,0,0,16168,6.8,17052,176,60,-1149,-1327,17.6,1616.8,5,6,9,1,0,1,0,17317,7,18379,263,60,1149,1327,26.3,1731.7,blue,2.8,2.33,19,19,blue
4519566772,3,5,5,0,0,0,0,15544,7,18015,238,48,-961,-1410,23.8,1554.4,5,3,4,1,1,0,0,16505,7.2,19425,239,76,961,1410,23.9,1650.5,red,1.6,3,23,24,blue
4523435488,10,10,9,1,0,1,0,17566,7.2,18896,183,48,-528,-296,18.3,1756.6,10,10,5,1,1,0,0,18094,7.2,19192,228,60,528,296,22.8,1809.4,blue,1.9,1.5,13,14,red
4452004237,5,7,7,1,1,0,0,15293,6.4,16208,202,50,-1555,-1234,20.2,1529.3,7,5,11,0,0,0,0,16848,6.8,17442,210,51,1555,1234,21,1684.8,blue,1.71,3.6,18,18,red
4508612227,9,2,8,2,1,1,0,17303,7,18705,219,49,2871,2154,21.9,1730.3,2,9,3,0,0,0,0,14432,6.8,16551,217,52,-2871,-2154,21.7,1443.2,blue,8.5,0.56,19,18,blue
4488632154,4,4,5,1,1,0,1,17201,7.2,18839,234,56,1070,1159,23.4,1720.1,4,4,2,1,0,1,1,16131,6.8,17680,215,62,-1070,-1159,21.5,1613.1,blue,2.25,1.5,25,23,blue
4514505161,6,3,3,2,1,1,2,18742,7.4,20148,252,68,3725,2903,25.2,1874.2,3,6,5,0,0,0,0,15017,6.8,17245,208,52,-3725,-2903,20.8,1501.7,blue,3,1.33,38,26,blue
4519264088,5,8,7,0,0,0,0,16519,7.2,19018,210,76,-180,2299,21,1651.9,8,5,7,2,1,1,0,16699,6.6,16719,192,48,180,-2299,19.2,1669.9,blue,1.5,3,17,18,red
4484558599,1,9,1,1,1,0,0,13727,6.6,16509,207,62,-5000,-4822,20.7,1372.7,9,1,6,0,0,0,0,18727,7.6,21331,254,77,5000,4822,25.4,1872.7,red,0.22,15,12,29,red
4521828179,8,9,10,1,1,0,0,17617,7,18094,217,50,685,1449,21.7,1761.7,9,8,12,0,0,0,0,16932,6.6,16645,180,56,-685,-1449,18,1693.2,red,2,2.62,17,14,red
4519842459,11,4,15,0,0,0,0,19432,7.2,19227,228,43,3857,2660,22.8,1943.2,4,11,6,1,1,0,0,15575,6.6,16567,210,53,-3857,-2660,21,1557.5,blue,6.5,0.91,18,21,blue
4519582751,4,7,4,0,0,0,0,15280,6.6,16650,202,47,-770,-1875,20.2,1528,7,4,4,1,1,0,0,16050,7.2,18525,217,51,770,1875,21.7,1605,red,1.14,2.75,44,33,blue
4508460252,3,4,3,0,0,0,0,15496,7,17876,214,52,-1406,-1328,21.4,1549.6,4,3,5,2,1,1,0,16902,7.2,19204,234,68,1406,1328,23.4,1690.2,blue,1.5,3,19,58,red
4507609718,4,12,4,0,0,0,0,15263,6.6,15892,176,47,-2711,-282,17.6,1526.3,12,4,21,1,1,0,0,17974,6.6,16174,186,28,2711,282,18.6,1797.4,red,0.67,8.25,21,16,blue
4511453042,6,4,5,0,0,0,0,17012,7.2,19091,225,52,324,106,22.5,1701.2,4,6,5,1,1,0,0,16688,7.2,18985,229,71,-324,-106,22.9,1668.8,blue,2.75,1.5,48,21,blue
4508099028,1,6,2,0,0,0,0,14168,6.6,16884,217,56,-3344,-2671,21.7,1416.8,6,1,7,2,1,1,0,17512,7.6,19555,225,77,3344,2671,22.5,1751.2,blue,0.5,13,15,21,red
4520943763,9,8,13,1,1,0,0,17060,6.8,17673,207,64,143,845,20.7,1706,8,9,7,0,0,0,0,16917,6.6,16828,212,48,-143,-845,21.2,1691.7,blue,2.75,1.67,29,42,blue
4456337531,7,4,10,0,0,0,0,17053,7,17515,219,50,1126,71,21.9,1705.3,4,7,5,2,1,1,0,15927,6.8,17444,217,49,-1126,-71,21.7,1592.7,blue,4.25,1.29,42,18,blue
4502905880,7,12,9,0,0,0,0,17185,6.6,16416,200,32,-2557,-2229,20,1718.5,12,7,19,2,1,1,0,19742,7.2,18645,210,37,2557,2229,21,1974.2,blue,1.33,4.43,31,20,blue
4482208801,3,5,6,0,0,0,1,16690,6.8,17992,248,48,-1060,-586,24.8,1669,5,3,7,2,1,1,1,17750,7,18578,214,75,1060,586,21.4,1775,red,1.8,4,18,44,red
4524102551,10,4,12,1,1,0,0,18246,7,18509,229,45,2914,2052,22.9,1824.6,4,10,3,0,0,0,0,15332,6.4,16457,209,40,-2914,-2052,20.9,1533.2,blue,5.5,0.7,17,20,blue
4494295244,7,7,8,0,0,0,0,16310,6.8,17712,219,44,464,426,21.9,1631,7,7,4,1,1,0,0,15846,6.8,17286,212,48,-464,-426,21.2,1584.6,blue,2.14,1.57,22,18,red
4518749206,5,3,5,1,1,0,0,16766,7.2,18841,232,68,1399,554,23.2,1676.6,3,5,5,0,0,0,0,15367,7,18287,240,36,-1399,-554,24,1536.7,blue,3.33,1.6,20,40,blue
4481573191,12,11,12,0,0,0,0,19460,7.4,19643,223,43,778,1443,22.3,1946,11,12,14,0,0,0,0,18682,7,18200,234,32,-778,-1443,23.4,1868.2,red,2.18,2.08,19,14,blue
4471725979,5,6,4,1,0,1,0,15307,6.8,16772,205,47,-1618,-1224,20.5,1530.7,6,5,9,0,0,0,0,16925,7,17996,243,36,1618,1224,24.3,1692.5,blue,1.5,3,15,15,blue
4486617771,4,6,5,0,0,0,0,15908,7,18133,218,68,-1345,169,21.8,1590.8,6,4,9,1,1,0,0,17253,6.8,17964,220,68,1345,-169,22,1725.3,red,1.5,3.75,14,49,red
4522887845,6,5,5,1,1,0,0,16966,7.6,19311,231,58,138,1085,23.1,1696.6,5,6,6,1,0,1,0,16828,7,18226,214,58,-138,-1085,21.4,1682.8,blue,2.2,1.83,19,13,blue
4484098460,6,6,2,1,1,0,0,16995,7.6,19978,241,64,-418,185,24.1,1699.5,6,6,8,0,0,0,0,17413,7.4,19793,237,73,418,-185,23.7,1741.3,blue,1.33,2.33,86,15,red
4520969352,12,7,17,2,1,1,0,18292,7,18884,216,48,789,1319,21.6,1829.2,7,12,6,0,0,0,0,17503,6.8,17565,220,56,-789,-1319,22,1750.3,red,4.14,1.08,15,14,blue
4507890297,6,3,8,1,0,1,0,16481,7,18642,229,47,760,45,22.9,1648.1,3,6,3,1,1,0,0,15721,7,18597,232,65,-760,-45,23.2,1572.1,blue,4.67,1,20,18,blue
4513593085,3,6,4,0,0,0,0,14907,6.6,17149,226,32,-2342,-1982,22.6,1490.7,6,3,5,0,0,0,0,17249,7.2,19131,262,51,2342,1982,26.2,1724.9,red,1.17,3.67,14,17,red
4521828781,6,8,7,1,1,0,0,15108,6.4,16485,191,36,-2302,-2232,19.1,1510.8,8,6,7,0,0,0,0,17410,7,18717,246,39,2302,2232,24.6,1741,blue,1.62,2.5,11,17,blue
4492250541,6,8,7,1,1,0,0,14779,6.2,15595,137,44,-2932,-2570,13.7,1477.9,8,6,5,1,0,1,0,17711,7.2,18165,219,52,2932,2570,21.9,1771.1,red,1.62,2.17,12,15,blue
4524906792,6,5,2,0,0,0,0,15739,7.2,18231,193,54,154,159,19.3,1573.9,5,6,5,1,1,0,0,15585,7,18072,211,50,-154,-159,21.1,1558.5,red,1.6,1.67,51,14,red
4452966828,6,7,9,0,0,0,0,16660,6.8,17061,210,56,99,-1609,21,1666,7,6,3,1,1,0,0,16561,7,18670,214,38,-99,1609,21.4,1656.1,red,2.14,1.67,29,20,blue
4510930492,0,5,0,0,0,0,0,13561,6.6,16632,222,56,-2876,-2098,22.2,1356.1,5,0,8,1,1,0,0,16437,7,18730,233,59,2876,2098,23.3,1643.7,red,0,12.65,13,19,red
4522518201,8,1,5,0,0,0,0,17761,7.4,20143,247,48,2501,2298,24.7,1776.1,1,8,1,0,0,0,0,15260,6.6,17845,251,56,-2501,-2298,25.1,1526,red,13,0.25,14,20,blue
4478381770,1,6,1,0,0,0,0,14910,6.8,17888,245,56,-1557,-1039,24.5,1491,6,1,7,1,1,0,0,16467,7.2,18927,225,56,1557,1039,22.5,1646.7,red,0.33,13,26,23,red
4472618887,9,6,8,1,1,0,0,17410,7,18627,190,60,1578,495,19,1741,6,9,6,0,0,0,0,15832,7,18132,195,52,-1578,-495,19.5,1583.2,blue,2.83,1.33,20,17,blue
4466944349,4,6,3,0,0,0,0,15518,6.8,18114,241,44,-1630,-531,24.1,1551.8,6,4,8,1,1,0,0,17148,7.2,18645,243,64,1630,531,24.3,1714.8,red,1.17,3.5,22,19,red
4522465523,8,7,10,1,1,0,0,18261,7.4,18602,248,65,1753,935,24.8,1826.1,7,8,8,0,0,0,0,16508,7,17667,218,41,-1753,-935,21.8,1650.8,blue,2.57,1.88,16,19,red
4421752887,4,5,7,0,0,0,0,15574,6.8,17216,236,47,14,-309,23.6,1557.4,5,4,6,2,1,1,0,15560,6.8,17525,224,44,-14,309,22.4,1556,red,2.2,2.75,20,38,blue
4518426899,5,7,5,0,0,0,0,16565,7,17659,220,48,-245,-1208,22,1656.5,7,5,3,0,0,0,0,16810,7,18867,244,51,245,1208,24.4,1681,red,1.43,2,16,16,red
4470395952,5,4,8,0,0,0,0,16163,7,18437,242,41,1074,542,24.2,1616.3,4,5,8,1,0,1,0,15089,7,17895,224,39,-1074,-542,22.4,1508.9,red,3.25,2.4,20,45,blue
4473146660,3,9,5,0,0,0,0,14724,6.4,16015,218,42,-3541,-2434,21.8,1472.4,9,3,13,1,1,0,0,18265,6.8,18449,244,56,3541,2434,24.4,1826.5,red,0.89,7.33,22,45,red
4524682251,10,3,8,1,1,0,0,17953,7.2,18275,213,35,2915,2085,21.3,1795.3,3,10,6,0,0,0,0,15038,6.4,16190,200,48,-2915,-2085,20,1503.8,blue,6,0.9,21,21,blue
4525381159,5,12,5,1,1,0,0,14819,6.8,16721,164,47,-4413,-3537,16.4,1481.9,12,5,8,0,0,0,0,19232,7.4,20258,242,42,4413,3537,24.2,1923.2,red,0.83,4,21,46,red
4472839071,4,7,4,0,0,0,0,15025,6.6,16369,212,32,-1517,-1487,21.2,1502.5,7,4,5,0,0,0,0,16542,7,17856,221,29,1517,1487,22.1,1654.2,red,1.14,3,21,37,blue
4501115839,11,8,14,0,0,0,0,18302,6.8,17304,235,36,2178,31,23.5,1830.2,8,11,5,0,0,0,0,16124,6.8,17273,192,44,-2178,-31,19.2,1612.4,blue,3.12,1.18,37,34,blue
4519382005,11,7,7,0,0,0,0,18197,7,18621,205,46,1470,1240,20.5,1819.7,7,11,7,1,1,0,0,16727,6.8,17381,206,58,-1470,-1240,20.6,1672.7,red,2.57,1.27,19,13,blue
4496140999,8,3,7,1,1,0,0,18363,7.2,20337,233,68,4507,4079,23.3,1836.3,3,8,2,0,0,0,0,13856,6.6,16258,194,44,-4507,-4079,19.4,1385.6,blue,5,0.62,18,18,blue
4518844953,8,2,7,1,1,0,0,17543,7.2,19535,254,32,4387,3411,25.4,1754.3,2,8,0,0,0,0,0,13156,6.6,16124,188,44,-4387,-3411,18.8,1315.6,blue,7.5,0.25,32,45,blue
4453662166,8,7,9,0,0,0,0,16973,7,18421,204,46,929,1800,20.4,1697.3,7,8,4,0,0,0,0,16044,6.8,16621,203,48,-929,-1800,20.3,1604.4,red,2.43,1.38,16,21,red
4516254148,7,8,8,1,1,0,0,16586,6.8,17047,226,50,-787,-1921,22.6,1658.6,8,7,7,0,0,0,0,17373,7.2,18968,207,56,787,1921,20.7,1737.3,red,1.88,2.14,17,46,red
4480995779,11,5,15,0,0,0,0,18106,7,17783,191,44,2695,1787,19.1,1810.6,5,11,6,1,1,0,0,15411,6.4,15996,187,52,-2695,-1787,18.7,1541.1,blue,5.2,1,19,21,blue
4525291177,9,13,15,0,0,0,0,16300,5.8,13423,141,29,-3173,-4350,14.1,1630,13,9,18,1,1,0,0,19473,7,17773,207,46,3173,4350,20.7,1947.3,red,1.85,3.44,76,16,blue
4499631955,8,9,7,0,0,0,0,16397,7,18004,183,45,-1253,933,18.3,1639.7,9,8,9,0,0,0,0,17650,6.6,17071,199,47,1253,-933,19.9,1765,red,1.67,2.25,18,22,red
4475587548,6,2,5,1,1,0,0,16948,6.8,18641,241,52,2711,1821,24.1,1694.8,2,6,0,0,0,0,0,14237,6.4,16820,223,52,-2711,-1821,22.3,1423.7,blue,5.5,0.33,22,26,blue
4513910209,4,3,6,1,1,0,0,14992,7,17756,213,48,-471,-1021,21.3,1499.2,3,4,1,0,0,0,0,15463,7.2,18777,240,52,471,1021,24,1546.3,red,3.33,1,21,16,blue
4512489523,5,4,8,1,1,0,0,16560,6.8,18049,220,49,1319,111,22,1656,4,5,5,1,0,1,0,15241,7,17938,190,51,-1319,-111,19,1524.1,red,3.25,1.8,54,39,red
4523452477,5,3,6,1,0,1,0,15759,6.8,17563,219,46,338,-1062,21.9,1575.9,3,5,4,0,0,0,0,15421,7,18625,220,56,-338,1062,22,1542.1,red,3.67,1.4,25,40,blue
4524015856,6,10,9,0,0,0,0,14711,6.4,15177,154,45,-2263,-2155,15.4,1471.1,10,6,11,1,1,0,0,16974,6.8,17332,196,40,2263,2155,19.6,1697.4,blue,1.5,3.5,18,19,red
4523933812,6,4,7,1,0,1,0,16940,7,17896,244,49,2038,357,24.4,1694,4,6,6,0,0,0,0,14902,6.8,17539,198,48,-2038,-357,19.8,1490.2,blue,3.25,1.67,21,14,blue
4441849412,4,5,4,0,0,0,0,15218,7,19074,203,52,-1911,-1211,20.3,1521.8,5,4,7,2,1,1,0,17129,7.4,20285,250,68,1911,1211,25,1712.9,red,1.6,3,18,16,red
4453444549,4,5,6,1,1,0,0,15466,6.8,17220,228,48,488,473,22.8,1546.6,5,4,8,0,0,0,0,14978,6.8,16747,182,48,-488,-473,18.2,1497.8,red,2,3.25,20,20,blue
4515261143,4,3,2,1,1,0,0,15278,7,18693,227,49,734,355,22.7,1527.8,3,4,3,0,0,0,0,14544,7.2,18338,203,50,-734,-355,20.3,1454.4,blue,2,1.5,8,14,blue
4378269284,16,4,17,1,1,0,1,19651,7,18318,200,36,5195,2289,20,1965.1,4,16,3,0,0,0,0,14456,6.4,16029,179,52,-5195,-2289,17.9,1445.6,blue,8.25,0.44,15,12,blue
4456349492,9,4,6,2,1,1,0,18233,7.6,21650,244,58,3319,5284,24.4,1823.3,4,9,7,0,0,0,0,14914,6.6,16366,177,53,-3319,-5284,17.7,1491.4,red,3.75,1.22,47,27,blue
4482236619,7,4,13,1,1,0,0,17470,7,18062,206,64,2335,979,20.6,1747,4,7,4,0,0,0,0,15135,6.8,17083,215,48,-2335,-979,21.5,1513.5,blue,5,1.14,40,14,blue
4518215400,7,8,5,0,0,0,0,16768,7.2,19368,225,58,-268,-155,22.5,1676.8,8,7,9,1,1,0,0,17036,7.2,19523,221,65,268,155,22.1,1703.6,red,1.5,2.43,19,17,red
4477066537,3,4,3,0,0,0,0,14509,6.8,17194,201,50,-1110,-1148,20.1,1450.9,4,3,4,0,0,0,0,15619,6.8,18342,241,44,1110,1148,24.1,1561.9,red,1.5,2.67,25,22,blue
4501002561,7,3,5,1,0,1,0,16178,7.2,18656,216,47,381,203,21.6,1617.8,3,7,3,1,1,0,0,15797,7,18453,253,52,-381,-203,25.3,1579.7,blue,4,0.86,17,17,blue
4523920430,2,6,0,0,0,0,0,14333,6.8,16812,223,56,-1636,-1396,22.3,1433.3,6,2,5,1,1,0,0,15969,6.8,18208,223,52,1636,1396,22.3,1596.9,red,0.33,5.5,16,20,blue
4469595642,9,9,12,2,1,1,0,17732,7.2,19451,194,70,-532,298,19.4,1773.2,9,9,8,0,0,0,0,18264,7.2,19153,208,72,532,-298,20.8,1826.4,blue,2.33,1.89,22,26,red
4525089240,4,9,3,0,0,0,0,14695,6.8,18090,207,36,-2467,80,20.7,1469.5,9,4,10,1,1,0,0,17162,7.2,18010,187,56,2467,-80,18.7,1716.2,red,0.78,4.75,21,83,red
4479922611,7,3,13,0,0,0,0,17800,7,19085,223,52,2460,1934,22.3,1780,3,7,5,1,1,0,0,15340,6.6,17151,205,60,-2460,-1934,20.5,1534,blue,6.67,1.14,15,14,red
4522626494,4,3,3,0,0,0,0,16048,7.2,19032,255,64,1454,1411,25.5,1604.8,3,4,3,0,0,0,0,14594,7,17621,234,34,-1454,-1411,23.4,1459.4,blue,2.33,1.5,17,14,blue
4472897611,1,1,0,0,0,0,0,14163,6.8,17413,246,42,450,924,24.6,1416.3,1,1,2,1,1,0,0,13713,6.6,16489,211,52,-450,-924,21.1,1371.3,blue,1,3,18,19,blue
4519145907,4,6,3,2,1,1,0,15695,7.2,18493,238,44,-300,451,23.8,1569.5,6,4,5,0,0,0,0,15995,7.2,18042,203,51,300,-451,20.3,1599.5,blue,1.17,2.75,16,13,red
4480114135,3,6,6,1,1,0,0,14844,6.8,17179,218,48,-2343,-2188,21.8,1484.4,6,3,3,0,0,0,0,17187,7.2,19367,256,76,2343,2188,25.6,1718.7,red,1.5,3,43,19,red
4415361150,9,10,3,0,0,0,0,15974,6.6,16903,175,36,-1008,-1516,17.5,1597.4,10,9,9,1,1,0,0,16982,7,18419,184,56,1008,1516,18.4,1698.2,red,1.2,2.11,13,18,blue
4506869531,3,7,5,0,0,0,0,14995,7,17661,240,50,-2442,-1250,24,1499.5,7,3,11,1,1,0,0,17437,7.2,18911,264,38,2442,1250,26.4,1743.7,blue,1.14,6,18,26,blue
4511071650,4,12,5,0,0,0,0,14799,6.6,15917,218,35,-4740,-3081,21.8,1479.9,12,4,8,2,1,1,0,19539,7,18998,231,69,4740,3081,23.1,1953.9,red,0.75,5,15,18,red
4478442838,10,11,14,0,0,0,0,17056,6.6,17190,167,39,-1603,-1406,16.7,1705.6,11,10,11,2,1,1,0,18659,7,18596,229,49,1603,1406,22.9,1865.9,red,2.18,2.2,21,21,red
4525113077,7,6,10,1,1,0,0,16243,6.8,17548,192,47,-555,-1462,19.2,1624.3,6,7,6,1,0,1,0,16798,7.2,19010,232,64,555,1462,23.2,1679.8,red,2.83,1.71,16,42,red
4477629107,11,10,14,1,1,0,0,17892,6.8,16641,157,41,-1361,-1031,15.7,1789.2,10,11,10,1,0,1,0,19253,6.8,17672,239,52,1361,1031,23.9,1925.3,red,2.5,1.82,18,27,red
4518167002,6,3,4,1,1,0,0,16508,6.6,17714,243,45,2024,1979,24.3,1650.8,3,6,4,1,0,1,0,14484,6.4,15735,213,40,-2024,-1979,21.3,1448.4,blue,3.33,1.17,19,16,blue
4524704735,4,2,4,0,0,0,0,16568,6.8,18658,242,56,1840,1870,24.2,1656.8,2,4,2,0,0,0,0,14728,6.6,16788,240,43,-1840,-1870,24,1472.8,blue,4,1,23,18,red
4494200479,5,5,6,0,0,0,0,16503,7.2,18765,231,59,690,365,23.1,1650.3,5,5,3,1,1,0,0,15813,7.2,18400,232,52,-690,-365,23.2,1581.3,blue,2.2,1.6,17,14,red
4479962485,9,9,7,1,1,0,0,17459,7,18018,185,50,-98,-1136,18.5,1745.9,9,9,6,0,0,0,0,17557,7.2,19154,219,57,98,1136,21.9,1755.7,red,1.78,1.67,62,18,blue
4508197919,7,7,5,0,0,0,0,17024,7.2,19375,222,68,197,1883,22.2,1702.4,7,7,7,2,1,1,0,16827,7,17492,198,63,-197,-1883,19.8,1682.7,blue,1.71,2,12,93,blue
4505413315,5,4,3,0,0,0,0,16660,6.8,18272,252,48,1574,1067,25.2,1666,4,5,6,0,0,0,0,15086,6.8,17205,197,45,-1574,-1067,19.7,1508.6,blue,2,2,24,16,blue
4478101809,2,9,0,0,0,0,0,14244,6.6,16850,207,48,-3553,-1730,20.7,1424.4,9,2,9,1,1,0,0,17797,7,18580,220,48,3553,1730,22,1779.7,red,0.22,9,15,14,red
4479618265,1,10,1,0,0,0,0,14041,6.4,15172,226,48,-5162,-3610,22.6,1404.1,10,1,19,0,0,0,1,19203,7.2,18782,196,46,5162,3610,19.6,1920.3,red,0.2,29,18,22,blue
4497718869,4,2,1,1,1,0,0,16752,7.4,19777,232,85,2210,2411,23.2,1675.2,2,4,0,0,0,0,0,14542,6.6,17366,214,53,-2210,-2411,21.4,1454.2,blue,2.5,0.5,41,24,blue
4498652179,8,2,13,1,0,1,0,17563,7.2,18032,203,64,3410,2058,20.3,1756.3,2,8,2,1,1,0,0,14153,6.4,15974,213,48,-3410,-2058,21.3,1415.3,blue,10.5,0.5,19,21,blue
4473231539,6,6,4,1,1,0,0,17262,7,19094,231,65,251,-74,23.1,1726.2,6,6,5,0,0,0,0,17011,7.2,19168,236,64,-251,74,23.6,1701.1,blue,1.67,1.83,25,26,blue
4518711982,9,3,9,0,0,0,0,17438,7,18257,186,48,3018,1995,18.6,1743.8,3,9,3,0,0,0,0,14420,6.6,16262,222,39,-3018,-1995,22.2,1442,blue,6,0.67,17,20,blue
4520305649,3,8,3,0,0,0,0,14275,6.4,15474,180,56,-3414,-3747,18,1427.5,8,3,4,2,1,1,0,17689,7.2,19221,228,60,3414,3747,22.8,1768.9,red,0.75,4,16,16,red
4522486224,7,4,10,1,1,0,0,16753,6.8,17461,220,39,2015,857,22,1675.3,4,7,2,1,0,1,0,14738,6.4,16604,171,60,-2015,-857,17.1,1473.8,blue,4.25,0.86,21,22,blue
4496840019,8,4,9,1,1,0,0,17163,7.2,19382,224,52,1422,775,22.4,1716.3,4,8,2,0,0,0,0,15741,7.2,18607,218,59,-1422,-775,21.8,1574.1,blue,4.25,0.75,17,19,blue
4524777842,5,6,8,0,0,0,0,15750,7,17334,214,43,-1727,-619,21.4,1575,6,5,8,0,0,0,0,17477,6.8,17953,223,56,1727,619,22.3,1747.7,red,2.17,2.8,49,18,red
4522301091,7,6,6,0,0,0,0,15954,6.8,16128,211,27,654,823,21.1,1595.4,6,7,6,1,0,1,0,15300,6.2,15305,190,40,-654,-823,19,1530,blue,2.17,1.71,23,21,blue
4515437338,9,3,10,2,1,1,0,18293,7.2,19981,240,59,3691,2805,24,1829.3,3,9,3,0,0,0,0,14602,7,17176,186,51,-3691,-2805,18.6,1460.2,blue,6.33,0.67,21,14,blue
4519053131,13,5,16,0,0,0,0,19336,7.2,19116,212,30,4627,4784,21.2,1933.6,5,13,6,0,0,0,0,14709,6,14332,175,29,-4627,-4784,17.5,1470.9,red,5.8,0.85,19,17,blue
4511951461,2,8,1,1,0,1,0,14014,6.6,16219,205,48,-3443,-2284,20.5,1401.4,8,2,8,0,0,0,0,17457,7.2,18503,230,52,3443,2284,23,1745.7,red,0.38,8,18,20,blue
4468611805,6,6,8,2,1,1,0,16207,7,17381,211,50,-819,-1829,21.1,1620.7,6,6,3,0,0,0,0,17026,7,19210,223,56,819,1829,22.3,1702.6,red,2.33,1.5,18,15,red
4522528063,4,1,4,0,0,0,0,16654,7.2,19392,255,59,1856,1530,25.5,1665.4,1,4,1,2,1,1,0,14798,6.8,17862,244,48,-1856,-1530,24.4,1479.8,blue,8,0.5,19,17,red
4483149221,4,4,6,0,0,0,0,16711,7.4,19807,233,72,1759,2524,23.3,1671.1,4,4,9,1,1,0,0,14952,6.8,17283,203,47,-1759,-2524,20.3,1495.2,blue,2.5,3.25,20,25,red
4523902957,7,3,10,1,1,0,0,16578,7,18139,200,62,1159,1510,20,1657.8,3,7,3,0,0,0,0,15419,6.6,16629,250,41,-1159,-1510,25,1541.9,red,5.67,0.86,18,16,blue
4483768812,4,8,7,1,1,0,0,16220,6.8,17447,227,60,-444,-184,22.7,1622,8,4,12,0,0,0,0,16664,7,17631,212,46,444,184,21.2,1666.4,blue,1.38,5,46,66,red
4522510473,6,4,8,0,0,0,0,15096,6.2,15415,199,32,-120,-1620,19.9,1509.6,4,6,2,1,1,0,0,15216,6.4,17035,193,67,120,1620,19.3,1521.6,red,3.5,1,142,18,red
4522805623,10,8,13,1,0,1,0,18426,7.2,18454,192,46,1493,202,19.2,1842.6,8,10,7,0,0,0,0,16933,7,18252,185,53,-1493,-202,18.5,1693.3,blue,2.88,1.5,20,35,blue
4523463632,11,3,14,1,1,0,0,18758,7,18710,212,49,4335,2324,21.2,1875.8,3,11,3,0,0,0,0,14423,6.6,16386,215,43,-4335,-2324,21.5,1442.3,blue,8.33,0.55,16,16,blue
4464643416,4,7,3,0,0,0,0,15928,7.2,18170,204,64,-935,-4,20.4,1592.8,7,4,5,1,1,0,0,16863,6.8,18174,233,52,935,4,23.3,1686.3,red,1,3,20,19,blue
4495318581,6,3,9,1,1,0,0,16233,7,18524,215,60,1081,199,21.5,1623.3,3,6,1,0,0,0,0,15152,7.2,18325,220,60,-1081,-199,22,1515.2,blue,5,0.67,18,16,blue
4510707082,8,8,7,1,1,0,0,16493,7,17450,175,44,-862,-1734,17.5,1649.3,8,8,5,1,0,1,0,17355,7.2,19184,223,55,862,1734,22.3,1735.5,blue,1.88,1.62,14,34,blue
4470854318,6,10,8,1,0,1,0,15633,6.8,17605,210,36,-2770,-2347,21,1563.3,10,6,13,1,1,0,0,18403,7.2,19952,218,52,2770,2347,21.8,1840.3,red,1.4,3.83,57,16,red
4519865094,7,2,8,2,1,1,0,17750,7.4,20138,237,56,3673,2756,23.7,1775,2,7,1,0,0,0,0,14077,6.8,17382,204,56,-3673,-2756,20.4,1407.7,blue,7.5,0.43,61,16,red
4487198223,5,14,6,0,0,0,0,16251,6.8,16548,213,46,-4859,-2956,21.3,1625.1,14,5,14,1,0,1,2,21110,7.2,19504,226,44,4859,2956,22.6,2111,red,0.79,5.6,23,21,red
4489399864,7,7,6,0,0,0,0,17627,7,18282,244,51,428,35,24.4,1762.7,7,7,11,1,1,0,0,17199,7,18247,247,51,-428,-35,24.7,1719.9,blue,1.86,2.57,16,14,blue
4447279447,5,10,4,1,1,0,0,17315,7.4,19378,253,66,-733,-1569,25.3,1731.5,10,5,7,0,0,0,0,18048,7.6,20947,216,54,733,1569,21.6,1804.8,red,0.9,3.4,23,27,blue
4511092295,4,5,4,0,0,0,0,15663,7,18122,237,44,936,1377,23.7,1566.3,5,4,2,1,1,0,0,14727,6.6,16745,191,52,-936,-1377,19.1,1472.7,red,1.6,1.75,21,23,red
4494532333,2,4,1,0,0,0,0,14865,7,18385,233,60,-1179,646,23.3,1486.5,4,2,4,2,1,1,0,16044,6.8,17739,226,56,1179,-646,22.6,1604.4,red,0.75,4,18,19,red
4477734915,5,2,4,0,0,0,0,16230,7,18489,235,61,932,542,23.5,1623,2,5,4,0,0,0,0,15298,7.2,17947,247,56,-932,-542,24.7,1529.8,blue,4.5,1.2,23,20,blue
4521252780,5,5,1,0,0,0,0,16065,7.4,20238,247,74,544,2063,24.7,1606.5,5,5,3,0,0,0,0,15521,6.8,18175,222,48,-544,-2063,22.2,1552.1,blue,1.2,1.6,13,50,red
4487946743,7,5,8,1,1,0,0,17049,7.4,20151,223,68,-105,1881,22.3,1704.9,5,7,7,0,0,0,0,17154,7.2,18270,231,41,105,-1881,23.1,1715.4,red,3,1.71,17,17,red
4505359485,4,3,5,1,1,0,0,15412,7,18001,212,56,-287,-1045,21.2,1541.2,3,4,3,0,0,0,0,15699,7,19046,243,56,287,1045,24.3,1569.9,red,3,1.5,16,15,red
4438236114,10,8,10,0,0,0,0,17949,7,19069,200,47,1052,340,20,1794.9,8,10,6,1,1,0,0,16897,7,18729,223,60,-1052,-340,22.3,1689.7,blue,2.5,1.4,15,30,blue
4522457944,6,4,5,0,0,0,0,16938,7,17614,220,48,2145,-316,22,1693.8,4,6,5,0,0,0,0,14793,6.8,17930,197,44,-2145,316,19.7,1479.3,blue,2.75,1.5,18,39,blue
4517522957,4,8,7,0,0,0,0,14627,6.6,16086,193,47,-3960,-4005,19.3,1462.7,8,4,9,1,1,0,0,18587,7.6,20091,247,68,3960,4005,24.7,1858.7,red,1.38,4.25,28,24,blue
4513824717,6,3,7,0,0,0,0,16485,7,18759,222,44,1097,711,22.2,1648.5,3,6,1,1,1,0,0,15388,7,18048,240,63,-1097,-711,24,1538.8,red,4.33,0.67,23,15,red
4523838951,4,5,2,0,0,0,0,15246,7,17687,217,47,-671,-738,21.7,1524.6,5,4,2,1,1,0,0,15917,7,18425,227,56,671,738,22.7,1591.7,red,1.2,1.75,91,22,blue
4502908431,10,9,19,1,1,0,0,17583,7,17639,201,48,-236,-1078,20.1,1758.3,9,10,13,0,0,0,0,17819,7.2,18717,225,60,236,1078,22.5,1781.9,red,3.22,2.2,60,25,red
4510619110,10,6,9,1,1,0,0,18655,7.6,19797,254,44,3212,3245,25.4,1865.5,6,10,8,0,0,0,0,15443,6.8,16552,170,52,-3212,-3245,17,1544.3,blue,3.17,1.4,16,14,blue
4521709624,7,7,5,1,1,0,0,16875,6.8,18112,219,48,-795,236,21.9,1687.5,7,7,9,0,0,0,0,17670,6.8,17876,221,44,795,-236,22.1,1767,blue,1.71,2.29,44,22,blue
4478061745,6,1,4,1,0,1,1,17872,7.2,19324,247,50,3544,2083,24.7,1787.2,1,6,1,1,1,0,0,14328,6.8,17241,219,48,-3544,-2083,21.9,1432.8,blue,10,0.33,19,18,blue
4498673478,7,6,9,2,1,1,0,16574,6.8,17377,197,42,969,-42,19.7,1657.4,6,7,8,0,0,0,0,15605,6.6,17419,194,37,-969,42,19.4,1560.5,blue,2.67,2,15,15,blue
4519028145,9,5,7,0,0,0,0,17651,7,18199,222,51,2348,1133,22.2,1765.1,5,9,4,1,1,0,0,15303,6.8,17066,195,43,-2348,-1133,19.5,1530.3,red,3.2,1,19,17,blue
4523264320,4,10,7,0,0,0,0,15035,6.4,16650,183,60,-3584,-3248,18.3,1503.5,10,4,10,1,1,0,0,18619,7.6,19898,238,59,3584,3248,23.8,1861.9,red,1.1,5,79,15,blue
4511502390,5,5,3,2,1,1,0,16399,7,17698,236,57,330,-475,23.6,1639.9,5,5,6,0,0,0,0,16069,6.8,18173,235,46,-330,475,23.5,1606.9,blue,1.6,2.2,22,23,blue
4455506797,8,8,13,1,0,1,0,18236,7,18690,221,48,1112,203,22.1,1823.6,8,8,12,0,0,0,0,17124,7,18487,198,44,-1112,-203,19.8,1712.4,red,2.62,2.5,14,43,red
4480574928,5,3,6,0,0,0,0,15782,7,18450,219,40,279,392,21.9,1578.2,3,5,4,1,1,0,0,15503,7,18058,246,63,-279,-392,24.6,1550.3,blue,3.67,1.4,17,18,blue
4461353444,7,3,9,1,1,0,0,16938,7,18699,226,56,1516,426,22.6,1693.8,3,7,4,0,0,0,0,15422,7,18273,210,60,-1516,-426,21,1542.2,red,5.33,1,64,22,blue
4520789246,5,10,5,0,0,0,0,14740,6.4,15556,156,49,-4229,-4184,15.6,1474,10,5,12,1,1,0,0,18969,7.4,19740,220,64,4229,4184,22,1896.9,red,1,4.4,11,19,red
4522794397,5,12,6,0,0,0,0,15299,7,17019,169,58,-3111,-2286,16.9,1529.9,12,5,10,0,0,0,0,18410,7,19305,178,56,3111,2286,17.8,1841,red,0.92,4.4,11,17,red
4499246696,8,5,8,0,0,0,0,17615,7,18307,206,46,3686,1471,20.6,1761.5,5,8,4,0,0,0,0,13929,6.6,16836,153,46,-3686,-1471,15.3,1392.9,blue,3.2,1.12,12,17,blue
4505683852,13,3,14,1,1,0,1,20955,7.2,19806,225,64,5136,2785,22.5,2095.5,3,13,3,0,0,0,0,15819,6.8,17021,213,60,-5136,-2785,21.3,1581.9,blue,9,0.46,20,15,blue
4423902202,6,2,8,0,0,0,0,16636,7.4,19834,245,56,1394,1368,24.5,1663.6,2,6,3,0,0,0,0,15242,7,18466,225,68,-1394,-1368,22.5,1524.2,blue,7,0.83,18,26,blue
4519998999,0,4,0,1,0,1,0,13805,6.8,17253,221,52,-2009,-2396,22.1,1380.5,4,0,5,1,1,0,0,15814,7.2,19649,243,59,2009,2396,24.3,1581.4,red,0,12.65,16,60,red
4518305583,11,10,16,0,0,0,0,18453,7,18299,204,34,466,-316,20.4,1845.3,10,11,14,0,0,0,0,17987,7.4,18615,186,46,-466,316,18.6,1798.7,red,2.7,2.18,22,18,blue
4477478034,5,13,5,0,0,0,0,14642,6.2,15033,171,41,-4958,-2388,17.1,1464.2,13,5,14,1,1,0,0,19600,7,17421,231,24,4958,2388,23.1,1960,red,0.77,5.4,18,33,red
4522529196,3,7,4,0,0,0,0,14503,6.8,16807,207,47,-2825,-2497,20.7,1450.3,7,3,9,2,1,1,0,17328,7.2,19304,221,68,2825,2497,22.1,1732.8,red,1,5.33,40,48,red
4520010999,3,7,3,1,1,0,0,15335,6.6,17368,234,60,-1716,-1601,23.4,1533.5,7,3,5,0,0,0,0,17051,7.2,18969,262,36,1716,1601,26.2,1705.1,red,0.86,4,21,22,red
4521093374,6,8,10,0,0,0,0,15629,6.8,16806,176,52,-1537,-926,17.6,1562.9,8,6,9,0,0,0,0,17166,7,17732,186,36,1537,926,18.6,1716.6,red,2,2.83,44,19,blue
4484490025,5,12,6,0,0,0,0,15782,6.4,16172,195,44,-2707,-2136,19.5,1578.2,12,5,10,1,1,0,0,18489,7,18308,233,40,2707,2136,23.3,1848.9,red,0.92,4.4,17,22,red
4516451603,12,5,17,1,1,0,0,18685,6.8,18421,234,44,2857,1406,23.4,1868.5,5,12,4,0,0,0,0,15828,6.8,17015,214,48,-2857,-1406,21.4,1582.8,blue,5.8,0.75,19,16,blue
4472368505,2,9,3,1,1,0,0,14901,6.8,16696,214,72,-3206,-2169,21.4,1490.1,9,2,10,0,0,0,0,18107,7.2,18865,238,58,3206,2169,23.8,1810.7,blue,0.56,9.5,18,17,red
4501802834,1,6,1,0,0,0,0,14012,6.8,17304,230,45,-2670,-1395,23,1401.2,6,1,6,1,1,0,0,16682,7,18699,218,59,2670,1395,21.8,1668.2,red,0.33,12,12,17,red
4521735411,4,8,5,0,0,0,0,15913,6.4,16454,193,48,-960,-2502,19.3,1591.3,8,4,9,0,0,0,0,16873,7.4,18956,190,54,960,2502,19,1687.3,red,1.12,4.25,15,13,blue
4477642564,5,6,2,1,1,0,0,14969,6.6,16860,200,60,-1579,-1179,20,1496.9,6,5,1,0,0,0,0,16548,7.2,18039,226,56,1579,1179,22.6,1654.8,red,1.17,1.4,25,29,red
4459421997,3,2,2,0,0,0,0,14863,7,18643,230,53,321,-260,23,1486.3,2,3,2,0,0,0,0,14542,7,18903,230,50,-321,260,23,1454.2,red,2.5,1.33,63,18,blue
4496972532,5,8,6,0,0,0,0,15985,7,18011,214,52,-12,-1161,21.4,1598.5,8,5,4,0,0,0,0,15997,7.2,19172,194,45,12,1161,19.4,1599.7,red,1.38,2.4,18,14,blue
4451716191,9,10,7,0,0,0,0,17407,7.2,18451,214,44,222,1716,21.4,1740.7,10,9,13,0,0,0,0,17185,6.6,16735,205,40,-222,-1716,20.5,1718.5,red,1.6,2.56,22,21,red
4489579352,5,3,5,0,0,0,0,15829,6.8,17771,237,45,968,715,23.7,1582.9,3,5,2,1,1,0,0,14861,6.8,17056,224,44,-968,-715,22.4,1486.1,red,3.33,1,18,20,blue
4486229170,5,9,3,0,0,0,0,14953,6.6,17141,183,60,-3042,-3641,18.3,1495.3,9,5,5,1,1,0,0,17995,7.6,20782,224,75,3042,3641,22.4,1799.5,red,0.89,2.8,18,18,blue
4446183119,13,3,8,1,1,0,0,20389,7.4,20574,235,52,6512,3981,23.5,2038.9,3,13,0,0,0,0,0,13877,6.8,16593,185,44,-6512,-3981,18.5,1387.7,blue,7,0.23,14,16,blue
4515415337,6,5,5,0,0,0,0,16789,7,18276,233,48,904,164,23.3,1678.9,5,6,4,1,1,0,0,15885,6.8,18112,234,56,-904,-164,23.4,1588.5,blue,2.2,1.5,50,20,red
4516176660,13,5,14,2,1,1,0,20403,7.4,20886,238,58,5365,4901,23.8,2040.3,5,13,5,0,0,0,0,15038,6.4,15985,178,44,-5365,-4901,17.8,1503.8,blue,5.4,0.77,19,12,blue
4518888602,2,5,2,0,0,0,0,15318,7,17867,219,50,-1145,-2100,21.9,1531.8,5,2,1,1,0,1,0,16463,7.4,19967,261,56,1145,2100,26.1,1646.3,blue,0.8,3,17,17,blue
4522580950,2,4,3,1,0,1,0,15180,7,18148,225,68,-986,-1508,22.5,1518,4,2,3,1,1,0,0,16166,7.6,19656,235,76,986,1508,23.5,1616.6,blue,1.25,3.5,54,41,blue
4522394082,8,3,11,1,1,0,0,18200,7.2,19337,218,67,3719,1813,21.8,1820,3,8,1,0,0,0,0,14481,6.8,17524,214,60,-3719,-1813,21.4,1448.1,blue,6.33,0.5,33,65,blue
4460033852,5,5,5,0,0,0,0,15646,6.6,16889,186,50,-201,-1702,18.6,1564.6,5,5,2,2,1,1,0,15847,7.2,18591,247,58,201,1702,24.7,1584.7,red,2,1.4,14,19,blue
4513054985,5,7,6,0,0,0,0,15747,6.8,17503,192,41,-1123,-1230,19.2,1574.7,7,5,6,1,1,0,0,16870,7,18733,227,59,1123,1230,22.7,1687,red,1.57,2.6,15,16,blue
4522366207,3,7,3,0,0,0,0,14668,6.6,16196,197,52,-2440,-2239,19.7,1466.8,7,3,6,1,1,0,0,17108,7.2,18435,230,55,2440,2239,23,1710.8,red,0.86,4.33,33,26,red
4516724538,8,3,7,1,0,1,0,19318,7.8,21508,257,71,4787,4701,25.7,1931.8,3,8,1,1,1,0,0,14531,6.6,16807,230,50,-4787,-4701,23,1453.1,blue,5,0.5,20,33,blue
4525110987,10,7,8,1,1,0,0,18302,7.2,19223,237,47,851,709,23.7,1830.2,7,10,8,0,0,0,0,17451,7,18514,251,51,-851,-709,25.1,1745.1,blue,2.57,1.5,19,19,blue
4515841164,5,6,6,1,1,0,0,15167,7,17584,200,52,-1315,-1049,20,1516.7,6,5,8,0,0,0,0,16482,7,18633,222,46,1315,1049,22.2,1648.2,red,1.83,2.8,20,49,red
4486836964,3,8,4,0,0,0,0,15330,6.4,16378,205,66,-3277,-1680,20.5,1533,8,3,12,2,1,1,1,18607,6.8,18058,220,56,3277,1680,22,1860.7,red,0.88,6.67,14,17,red
4524997224,2,5,1,1,1,0,0,14579,6.8,17772,218,67,-1684,-772,21.8,1457.9,5,2,3,0,0,0,0,16263,7.2,18544,226,64,1684,772,22.6,1626.3,red,0.6,4,21,18,red
4498675239,5,12,7,0,0,0,0,15828,6.6,16976,195,40,-2330,-1189,19.5,1582.8,12,5,12,1,1,0,0,18158,7,18165,215,40,2330,1189,21.5,1815.8,red,1,4.8,11,16,red
4471433408,10,6,11,1,1,0,0,18001,7,18571,216,50,1510,151,21.6,1800.1,6,10,6,0,0,0,0,16491,6.8,18420,231,45,-1510,-151,23.1,1649.1,red,3.5,1.2,20,16,blue
4523082627,5,4,4,0,0,0,1,17305,7.2,18581,246,40,2319,135,24.6,1730.5,4,5,2,1,1,0,0,14986,7,18446,217,59,-2319,-135,21.7,1498.6,red,2.25,1.2,19,17,blue
4508892173,11,4,10,1,0,1,0,18706,7.2,19465,243,55,3787,2856,24.3,1870.6,4,11,4,0,0,0,0,14919,6.8,16609,202,48,-3787,-2856,20.2,1491.9,blue,5.25,0.73,15,15,blue
4512953268,7,9,6,0,0,0,0,16939,6.8,17715,223,43,-398,-1977,22.3,1693.9,9,7,8,1,1,0,0,17337,7.2,19692,202,60,398,1977,20.2,1733.7,red,1.44,2.43,13,42,red
4517848263,5,3,5,2,1,1,2,17645,7,18081,224,52,2864,1182,22.4,1764.5,3,5,3,0,0,0,0,14781,6.6,16899,207,40,-2864,-1182,20.7,1478.1,blue,3.33,1.2,17,77,blue
4515599821,6,10,5,0,0,0,0,15985,7,17976,176,52,-2993,-2498,17.6,1598.5,10,6,7,2,1,1,0,18978,7.4,20474,218,58,2993,2498,21.8,1897.8,red,1.1,2.83,17,16,red
4520971034,12,9,11,1,0,1,0,18325,7.4,19498,190,55,793,1612,19,1832.5,9,12,7,1,1,0,0,17532,6.8,17886,208,40,-793,-1612,20.8,1753.2,red,2.56,1.33,18,10,red
4494500781,6,9,7,2,1,1,0,18050,7.2,18264,238,60,284,681,23.8,1805,9,6,15,0,0,0,0,17766,6.8,17583,207,52,-284,-681,20.7,1776.6,blue,1.44,4,23,63,red
4429490822,11,9,12,1,1,0,0,18585,7.2,19498,221,55,1139,1170,22.1,1858.5,9,11,9,0,0,0,0,17446,7,18328,218,54,-1139,-1170,21.8,1744.6,blue,2.56,1.64,21,14,red
4522631457,2,7,4,0,0,0,0,14367,6.4,16705,203,47,-2901,-2666,20.3,1436.7,7,2,8,1,0,1,0,17268,7.2,19371,229,60,2901,2666,22.9,1726.8,red,0.86,7.5,20,16,blue
4511303658,7,4,7,1,1,0,0,16743,7.2,18562,215,45,1323,457,21.5,1674.3,4,7,8,0,0,0,0,15420,7,18105,209,52,-1323,-457,20.9,1542,red,3.5,1.71,18,13,red
4506832120,13,10,7,0,0,0,0,18388,7,18350,185,36,535,776,18.5,1838.8,10,13,10,0,0,0,0,17853,7,17574,198,56,-535,-776,19.8,1785.3,blue,2,1.54,22,21,red
4474680131,4,5,3,0,0,0,0,15710,6.8,17789,242,48,-682,-323,24.2,1571,5,4,4,1,1,0,0,16392,6.8,18112,227,56,682,323,22.7,1639.2,red,1.4,2.25,46,17,blue
4461986866,6,4,10,0,0,0,0,17275,7.2,19289,241,44,1702,1352,24.1,1727.5,4,6,4,1,1,0,0,15573,6.8,17937,234,60,-1702,-1352,23.4,1557.3,red,4,1.33,89,15,blue
4521060051,7,8,9,1,0,1,0,16623,6.8,17503,206,59,-389,329,20.6,1662.3,8,7,10,1,1,0,0,17012,6.8,17174,225,43,389,-329,22.5,1701.2,red,2,2.57,39,17,red
4495265880,6,1,6,1,1,0,0,17402,7.2,19869,262,51,3250,3073,26.2,1740.2,1,6,1,0,0,0,0,14152,6.4,16796,232,52,-3250,-3073,23.2,1415.2,blue,12,0.33,15,16,red
4522148176,7,3,6,2,1,1,0,17555,7.8,20887,248,63,2678,3150,24.8,1755.5,3,7,3,0,0,0,0,14877,7,17737,200,58,-2678,-3150,20,1487.7,blue,4.33,0.86,36,16,red
4522804961,2,8,3,0,0,0,0,14952,6.8,17963,264,43,-2262,-668,26.4,1495.2,8,2,4,0,0,0,0,17214,7.4,18631,244,49,2262,668,24.4,1721.4,blue,0.62,6,43,23,blue
4499628579,6,9,6,0,0,0,0,15487,6,14798,187,36,-1796,-2222,18.7,1548.7,9,6,7,0,0,0,0,17283,6.8,17020,213,40,1796,2222,21.3,1728.3,red,1.33,2.67,21,21,blue
4524391418,7,3,6,0,0,0,0,18351,7.4,19217,222,72,3827,3161,22.2,1835.1,3,7,3,1,1,0,0,14524,6.4,16056,201,53,-3827,-3161,20.1,1452.4,blue,4.33,0.86,13,16,blue
4525085113,1,9,1,0,0,0,0,13797,6.2,15622,173,60,-5533,-4951,17.3,1379.7,9,1,10,2,1,1,0,19330,7.4,20573,256,59,5533,4951,25.6,1933,red,0.22,19,17,37,red
4517762316,6,7,3,0,0,0,0,16241,7.2,18124,238,47,-602,-905,23.8,1624.1,7,6,5,0,0,0,0,16843,7.2,19029,232,68,602,905,23.2,1684.3,blue,1.29,2,19,19,blue
4517786816,6,5,5,0,0,0,0,17065,7.4,19124,257,47,1525,873,25.7,1706.5,5,6,5,2,1,1,0,15540,7,18251,189,51,-1525,-873,18.9,1554,blue,2.2,1.67,20,17,red
4497647589,8,0,6,0,0,0,0,18609,7.2,19904,244,64,5109,3009,24.4,1860.9,0,8,0,1,1,0,0,13500,6.6,16895,216,56,-5109,-3009,21.6,1350,blue,12.03,0,20,16,blue
4509888379,8,5,8,1,1,0,0,16259,6.8,16785,171,59,656,-718,17.1,1625.9,5,8,3,1,0,1,0,15603,6.8,17503,230,48,-656,718,23,1560.3,blue,3.2,1,24,21,red
4475558628,8,4,6,1,1,0,0,17858,7.2,18694,267,52,1886,460,26.7,1785.8,4,8,4,0,0,0,0,15972,7,18234,219,52,-1886,-460,21.9,1597.2,red,3.5,1,16,18,blue
4515748681,12,7,12,0,0,0,0,19055,7,18944,225,51,982,1653,22.5,1905.5,7,12,8,2,1,1,1,18073,6.6,17291,188,53,-982,-1653,18.8,1807.3,blue,3.43,1.25,18,40,blue
4506996952,8,7,10,2,1,1,0,17217,7.2,18214,185,60,-414,-47,18.5,1721.7,7,8,3,0,0,0,1,17631,7,18261,198,68,414,47,19.8,1763.1,blue,2.57,1.25,18,16,red
4494291164,6,4,7,0,0,0,0,16091,7,18518,238,38,356,122,23.8,1609.1,4,6,4,1,1,0,0,15735,7,18396,217,64,-356,-122,21.7,1573.5,red,3.25,1.33,18,18,red
4525153486,8,10,13,1,1,0,0,17174,6.8,17921,244,56,-516,-4,24.4,1717.4,10,8,13,0,0,0,0,17690,6.8,17925,183,40,516,4,18.3,1769,red,2.1,2.88,15,14,red
4525231253,3,7,2,1,1,0,0,14961,6.6,16723,220,55,-2212,-2725,22,1496.1,7,3,5,0,0,0,0,17173,7.4,19448,235,56,2212,2725,23.5,1717.3,red,0.71,4,19,45,blue
4484379764,7,9,8,0,0,0,0,16076,6.8,16620,187,37,-923,-803,18.7,1607.6,9,7,11,1,1,0,0,16999,6.8,17423,197,52,923,803,19.7,1699.9,blue,1.67,2.86,21,18,blue
4465418365,5,9,3,0,0,0,0,15905,6.8,17772,203,43,-1798,-1804,20.3,1590.5,9,5,5,1,1,0,0,17703,7,19576,218,58,1798,1804,21.8,1770.3,red,0.89,2.8,14,18,red
4521120327,6,10,7,1,0,1,0,15075,6.4,16260,179,32,-3996,-3131,17.9,1507.5,10,6,11,1,1,0,0,19071,7.4,19391,210,78,3996,3131,21,1907.1,red,1.3,3.5,46,33,blue
4525139082,7,6,9,0,0,0,0,16711,6.6,17570,207,48,259,-527,20.7,1671.1,6,7,3,0,0,0,0,16452,6.8,18097,221,51,-259,527,22.1,1645.2,blue,2.67,1.29,21,17,red
4495141032,7,2,11,0,0,0,0,17371,6.6,17488,209,47,3058,1096,20.9,1737.1,2,7,2,0,0,0,0,14313,6.6,16392,230,35,-3058,-1096,23,1431.3,red,9,0.57,41,19,blue
4500708488,3,4,5,0,0,0,0,15537,7,18851,231,64,-937,-89,23.1,1553.7,4,3,5,1,1,0,0,16474,7.2,18940,251,68,937,89,25.1,1647.4,red,2,3,15,21,red
4517895727,2,12,2,0,0,0,0,13751,6.2,15189,183,40,-5551,-2712,18.3,1375.1,12,2,15,1,1,0,1,19302,6.8,17901,201,40,5551,2712,20.1,1930.2,red,0.33,13.5,15,17,blue
4510089098,8,1,10,0,0,0,0,18888,7.2,18408,232,42,4662,2019,23.2,1888.8,1,8,1,0,0,0,0,14226,6.6,16389,207,64,-4662,-2019,20.7,1422.6,blue,18,0.25,17,13,blue
4499694291,3,11,2,0,0,0,0,13962,6.4,15298,192,27,-5812,-5009,19.2,1396.2,11,3,7,2,1,1,1,19774,7.4,20307,225,44,5812,5009,22.5,1977.4,red,0.45,6,13,14,red
4511051805,5,8,4,0,0,0,0,16697,7,18216,214,62,-63,-779,21.4,1669.7,8,5,4,1,1,0,0,16760,7.2,18995,219,58,63,779,21.9,1676,blue,1.12,2.4,17,40,red
4448321721,4,8,3,2,1,1,0,15815,7.2,18069,245,41,-1110,-391,24.5,1581.5,8,4,10,0,0,0,0,16925,7,18460,229,45,1110,391,22.9,1692.5,red,0.88,4.5,21,21,blue
4489906217,6,4,5,0,0,0,0,17047,7.2,19108,260,52,1604,1599,26,1704.7,4,6,5,1,1,0,0,15443,6.8,17509,209,44,-1604,-1599,20.9,1544.3,blue,2.75,1.5,16,14,red
4515460466,5,13,2,0,0,0,0,15118,6.6,16774,214,39,-3673,-3603,21.4,1511.8,13,5,11,2,1,1,0,18791,7.4,20377,206,50,3673,3603,20.6,1879.1,red,0.54,4.8,16,13,red
4450464581,6,9,7,0,0,0,0,16035,6.6,17041,196,52,-2257,-2894,19.6,1603.5,9,6,5,1,1,0,0,18292,7.4,19935,230,52,2257,2894,23,1829.2,red,1.44,2.33,24,43,blue
4494451002,8,3,7,1,1,0,0,16225,6.8,17748,179,44,195,428,17.9,1622.5,3,8,4,0,0,0,0,16030,6.6,17320,239,39,-195,-428,23.9,1603,blue,5,0.88,20,17,blue
4517987406,3,2,4,1,1,0,0,15033,6.8,18279,211,59,6,205,21.1,1503.3,2,3,2,0,0,0,0,15027,7.2,18074,221,57,-6,-205,22.1,1502.7,red,3.5,1.33,123,109,red
4439137888,8,10,11,1,0,1,0,17064,6.6,16813,185,41,-574,-1413,18.5,1706.4,10,8,14,1,1,0,0,17638,6.8,18226,217,55,574,1413,21.7,1763.8,red,1.9,3,20,28,blue
4524185792,13,8,12,1,1,0,0,18043,6.8,17743,186,48,468,302,18.6,1804.3,8,13,9,0,0,0,0,17575,6.8,17441,219,60,-468,-302,21.9,1757.5,red,3.12,1.31,16,16,red
4522188300,5,4,7,1,0,1,0,15710,7.2,18847,239,43,-152,713,23.9,1571,4,5,5,1,1,0,0,15862,7,18134,218,74,152,-713,21.8,1586.2,red,3,1.8,22,20,red
4510352485,6,0,7,0,0,0,0,17476,7.2,19471,226,68,3460,2275,22.6,1747.6,0,6,0,1,1,0,0,14016,6.8,17196,242,64,-3460,-2275,24.2,1401.6,red,12.03,0,16,19,blue
4524177357,1,7,1,0,0,0,0,14745,6.8,17469,236,60,-2556,-325,23.6,1474.5,7,1,9,0,0,0,0,17301,7,17794,238,44,2556,325,23.8,1730.1,blue,0.29,16,39,26,blue
4474002258,6,9,8,1,1,0,0,16052,7,17653,221,45,-1558,-500,22.1,1605.2,9,6,9,0,0,0,0,17610,7,18153,212,40,1558,500,21.2,1761,red,1.56,3,19,19,blue
4513458480,10,2,14,1,1,0,0,18888,7.2,18447,242,43,4780,2748,24.2,1888.8,2,10,2,0,0,0,0,14108,6.4,15699,203,46,-4780,-2748,20.3,1410.8,blue,12,0.4,17,16,blue
4469857979,3,7,5,0,0,0,0,15423,7.2,18610,241,52,-2523,-732,24.1,1542.3,7,3,7,1,1,0,0,17946,7.4,19342,248,48,2523,732,24.8,1794.6,red,1.14,4.67,15,17,red
4519801984,7,7,6,1,1,0,0,15927,6.6,15756,192,44,-2390,-2971,19.2,1592.7,7,7,13,0,0,0,0,18317,7.2,18727,219,70,2390,2971,21.9,1831.7,red,1.86,2.86,19,15,blue
4495729689,5,8,3,0,0,0,0,15967,6.4,16964,223,44,-1578,-598,22.3,1596.7,8,5,10,2,1,1,0,17545,7,17562,206,40,1578,598,20.6,1754.5,red,1,3.6,19,277,red
4450110737,13,9,13,1,1,0,0,19929,7.6,20672,224,67,2558,2349,22.4,1992.9,9,13,14,0,0,0,0,17371,7.2,18323,208,38,-2558,-2349,20.8,1737.1,blue,2.89,1.77,151,39,blue
4442215686,5,5,7,0,0,0,0,16110,7,18673,222,53,-146,557,22.2,1611,5,5,7,0,0,0,0,16256,7,18116,217,64,146,-557,21.7,1625.6,red,2.4,2.4,22,19,blue
4523641483,9,8,9,0,0,0,0,17631,7,18106,214,41,1564,86,21.4,1763.1,8,9,7,0,0,0,0,16067,7,18020,193,47,-1564,-86,19.3,1606.7,blue,2.25,1.67,20,18,red
4521949489,4,4,4,2,1,1,0,16337,7,18992,251,67,1260,1487,25.1,1633.7,4,4,2,0,0,0,0,15077,6.8,17505,204,48,-1260,-1487,20.4,1507.7,blue,2,1.5,16,36,red
4511388378,6,5,8,1,1,0,0,16693,7,18416,240,67,1722,1857,24,1669.3,5,6,2,0,0,0,0,14971,6.6,16559,193,52,-1722,-1857,19.3,1497.1,blue,2.8,1.17,15,15,blue
4486323074,5,7,7,2,1,1,1,18334,7.4,19247,231,70,1111,26,23.1,1833.4,7,5,7,0,0,0,0,17223,7.4,19221,240,56,-1111,-26,24,1722.3,blue,1.71,2.8,19,22,blue
4500096958,4,9,7,1,0,1,0,14641,6.6,16376,171,60,-3174,-1926,17.1,1464.1,9,4,14,1,1,0,0,17815,7,18302,194,56,3174,1926,19.4,1781.5,blue,1.22,5.75,18,23,red
4517909755,2,4,2,0,0,0,0,14524,6.8,17686,214,50,-1333,-1832,21.4,1452.4,4,2,2,0,0,0,0,15857,7,19518,260,49,1333,1832,26,1585.7,red,1,3,13,17,blue
4482205629,6,5,10,0,0,0,0,16111,6.4,16723,219,44,1039,-79,21.9,1611.1,5,6,3,1,1,0,0,15072,6.8,16802,213,48,-1039,79,21.3,1507.2,red,3.2,1.33,20,17,red
4467051072,3,9,4,1,0,1,0,15284,7,17637,207,72,-3712,-3375,20.7,1528.4,9,3,6,1,1,0,0,18996,7.6,21012,246,61,3712,3375,24.6,1899.6,red,0.78,5,20,41,red
4434732074,2,6,1,1,1,0,0,14107,6.6,17015,180,72,-1699,-364,18,1410.7,6,2,10,0,0,0,0,15806,6.8,17379,220,40,1699,364,22,1580.6,blue,0.5,8,22,23,red
4523659113,7,7,7,0,0,0,0,17152,6.8,18219,223,48,629,753,22.3,1715.2,7,7,9,1,1,0,0,16523,6.8,17466,212,44,-629,-753,21.2,1652.3,blue,2,2.29,13,17,red
4522228780,7,9,8,0,0,0,0,16025,6.4,16142,197,42,-2344,-1592,19.7,1602.5,9,7,7,1,0,1,1,18369,6.8,17734,211,40,2344,1592,21.1,1836.9,blue,1.67,2.29,17,19,blue
4513254369,2,3,2,2,1,1,0,15130,7.2,18930,234,50,-27,281,23.4,1513,3,2,3,0,0,0,0,15157,7.4,18649,250,53,27,-281,25,1515.7,blue,1.33,3,18,14,blue
4472723293,7,5,11,0,0,0,0,16230,6.6,16813,181,52,-30,-965,18.1,1623,5,7,5,0,0,0,0,16260,6.8,17778,231,51,30,965,23.1,1626,red,3.6,1.43,17,16,red
4515299589,7,7,4,0,0,0,0,16113,6.8,17158,205,47,-211,320,20.5,1611.3,7,7,9,1,1,0,0,16324,6.6,16838,191,40,211,-320,19.1,1632.4,red,1.57,2.29,18,44,red
4517515942,10,9,8,1,1,0,0,17394,7,18046,195,28,-614,-846,19.5,1739.4,9,10,8,0,0,0,0,18008,7,18892,187,92,614,846,18.7,1800.8,red,2,1.7,26,17,blue
4516851869,2,9,0,1,1,0,0,13803,6.6,16366,203,55,-4410,-4163,20.3,1380.3,9,2,3,1,0,1,0,18213,7.4,20529,236,72,4410,4163,23.6,1821.3,red,0.22,6,16,13,blue
4499865404,3,9,2,0,0,0,0,13893,6.4,15277,171,40,-4054,-3806,17.1,1389.3,9,3,11,2,1,1,0,17947,7,19083,218,80,4054,3806,21.8,1794.7,red,0.56,6.67,18,21,blue
4510664685,5,6,5,0,0,0,0,16312,7,18684,239,41,-77,260,23.9,1631.2,6,5,11,1,1,0,0,16389,7,18424,230,42,77,-260,23,1638.9,red,1.67,3.4,18,99,blue
4523529962,11,6,15,1,1,0,0,18205,7,18119,207,38,2002,1791,20.7,1820.5,6,11,9,0,0,0,0,16203,6.4,16328,208,36,-2002,-1791,20.8,1620.3,blue,4.33,1.36,41,44,blue
4519711392,5,7,6,1,1,0,0,16484,6.6,17799,242,44,-94,-844,24.2,1648.4,7,5,7,0,0,0,0,16578,7,18643,201,48,94,844,20.1,1657.8,blue,1.57,2.8,14,17,red
4511865034,6,8,10,0,0,0,0,16661,7,18206,233,44,171,807,23.3,1666.1,8,6,10,0,0,0,0,16490,7,17399,229,29,-171,-807,22.9,1649,red,2,3,18,21,blue
4511790029,5,10,7,0,0,0,0,15381,6.4,16749,202,51,-2099,-1505,20.2,1538.1,10,5,15,1,1,0,0,17480,7,18254,206,52,2099,1505,20.6,1748,red,1.2,5,19,23,red
4520745759,13,6,14,2,1,1,0,19234,6.8,17699,179,48,3274,1603,17.9,1923.4,6,13,6,0,0,0,0,15960,6.4,16096,206,40,-3274,-1603,20.6,1596,red,4.5,0.92,13,20,blue
4523930264,11,4,14,0,0,0,1,19350,7.4,19830,234,39,4553,3000,23.4,1935,4,11,2,0,0,0,0,14797,6.4,16830,208,52,-4553,-3000,20.8,1479.7,blue,6.25,0.55,23,16,red
4439674846,5,6,3,1,0,1,1,17389,7.4,19074,224,53,760,120,22.4,1738.9,6,5,6,1,1,0,0,16629,7.2,18954,235,57,-760,-120,23.5,1662.9,red,1.33,2.4,43,16,blue
4492247014,8,6,9,1,1,0,0,16138,6.6,16973,195,40,611,-139,19.5,1613.8,6,8,5,0,0,0,0,15527,6.8,17112,215,43,-611,139,21.5,1552.7,red,2.83,1.38,15,13,blue
4490117676,3,2,2,0,0,0,0,15271,7,18182,199,59,356,58,19.9,1527.1,2,3,2,0,0,0,0,14915,7,18124,232,39,-356,-58,23.2,1491.5,blue,2.5,1.33,64,16,blue
4475660855,10,9,7,0,0,0,0,17584,6.4,16118,159,47,316,-1561,15.9,1758.4,9,10,8,0,0,0,0,17268,6.6,17679,202,47,-316,1561,20.2,1726.8,blue,1.89,1.7,36,41,blue
4508130317,8,4,10,0,0,0,0,17297,7,18369,211,50,1961,564,21.1,1729.7,4,8,5,1,1,0,0,15336,6.8,17805,211,46,-1961,-564,21.1,1533.6,red,4.5,1.12,23,39,blue
4518558277,9,3,14,1,1,0,0,17693,6.8,17892,201,36,4282,1993,20.1,1769.3,3,9,1,0,0,0,0,13411,6.6,15899,149,47,-4282,-1993,14.9,1341.1,blue,7.67,0.44,18,18,red
4496024408,4,7,5,0,0,0,0,14703,6.6,16749,232,33,-1323,-591,23.2,1470.3,7,4,15,0,0,0,0,16026,6.8,17340,191,39,1323,591,19.1,1602.6,blue,1.29,5.5,19,43,blue
4436014488,6,6,12,0,0,0,0,17394,7,18668,233,55,285,-352,23.3,1739.4,6,6,9,0,0,0,0,17109,7,19020,228,61,-285,352,22.8,1710.9,blue,3,2.5,18,17,blue
4524495637,9,5,14,0,0,0,0,16563,6.8,17202,182,56,-1292,-1426,18.2,1656.3,5,9,3,2,1,1,1,17855,7,18628,237,57,1292,1426,23.7,1785.5,red,4.6,0.89,38,14,red
4521484039,4,2,3,0,0,0,0,15270,6.8,17913,225,44,-375,-1283,22.5,1527,2,4,1,1,1,0,0,15645,7.4,19196,207,88,375,1283,20.7,1564.5,red,3.5,0.75,12,10,blue
4463389960,3,6,3,0,0,0,0,14906,6.6,16779,195,56,-1198,-599,19.5,1490.6,6,3,1,0,0,0,0,16104,6.8,17378,250,44,1198,599,25,1610.4,red,1,2.33,19,20,red
4520667949,14,3,8,1,1,0,0,19085,7.2,19432,226,40,4784,3335,22.6,1908.5,3,14,2,0,0,0,0,14301,6.2,16097,178,47,-4784,-3335,17.8,1430.1,blue,7.33,0.36,14,15,blue
4452787695,2,2,3,2,1,1,0,15290,7,17983,253,47,-9,-307,25.3,1529,2,2,2,0,0,0,0,15299,7,18290,243,58,9,307,24.3,1529.9,blue,2.5,2,21,20,blue
4486077838,4,8,7,0,0,0,0,15557,6.6,17145,212,50,-2101,-2009,21.2,1555.7,8,4,11,2,1,1,0,17658,7.2,19154,249,50,2101,2009,24.9,1765.8,red,1.38,4.75,21,21,blue
4501445520,8,3,7,1,1,0,0,17318,7.4,19714,244,54,2789,3223,24.4,1731.8,3,8,2,0,0,0,0,14529,6.4,16491,203,60,-2789,-3223,20.3,1452.9,blue,5,0.62,16,16,red
4506645494,7,6,5,0,0,0,0,16359,7,17684,219,40,117,-113,21.9,1635.9,6,7,7,1,1,0,0,16242,6.8,17797,229,44,-117,113,22.9,1624.2,red,2,1.86,17,15,blue
4518246546,3,8,4,0,0,0,0,14722,6.4,16433,218,48,-3784,-3051,21.8,1472.2,8,3,12,1,1,0,0,18506,7.2,19484,239,44,3784,3051,23.9,1850.6,red,0.88,6.67,15,21,red
4500529514,3,8,3,0,0,0,0,15035,6.4,15909,202,50,-2930,-2300,20.2,1503.5,8,3,9,1,1,0,0,17965,7,18209,238,48,2930,2300,23.8,1796.5,red,0.75,5.67,13,19,red
4491740882,2,9,2,0,0,0,0,14663,6.4,15958,228,44,-3148,-2856,22.8,1466.3,9,2,13,1,1,0,0,17811,7.2,18814,215,64,3148,2856,21.5,1781.1,red,0.44,11,16,19,red
4520700256,4,7,3,0,0,0,0,15504,7,17911,222,47,-1471,-1204,22.2,1550.4,7,4,10,1,1,0,0,16975,7,19115,214,50,1471,1204,21.4,1697.5,red,1,4.25,18,21,red
4481808559,4,6,2,0,0,0,0,16463,7.2,18904,247,71,801,1090,24.7,1646.3,6,4,7,1,1,0,0,15662,6.8,17814,197,60,-801,-1090,19.7,1566.2,red,1,3.25,17,10,blue
4515740615,7,8,6,0,0,0,0,17009,7.2,19047,241,43,45,1199,24.1,1700.9,8,7,9,0,0,0,0,16964,7,17848,211,36,-45,-1199,21.1,1696.4,blue,1.62,2.43,30,23,red
4464257134,6,6,6,1,0,1,0,16866,6.8,17542,218,47,69,-552,21.8,1686.6,6,6,9,1,1,0,0,16797,6.8,18094,247,40,-69,552,24.7,1679.7,blue,2,2.5,17,19,blue
4509934873,6,3,4,0,0,0,0,16982,7,18435,242,51,1277,297,24.2,1698.2,3,6,4,1,1,0,0,15705,6.8,18138,218,75,-1277,-297,21.8,1570.5,red,3.33,1.17,17,56,blue
4523337230,3,12,5,0,0,0,0,15051,6.8,17568,211,47,-4401,-3035,21.1,1505.1,12,3,12,0,0,0,0,19452,7.6,20603,239,48,4401,3035,23.9,1945.2,red,0.67,8,16,17,red
4522520315,10,3,11,0,0,0,0,18719,7.4,19257,236,52,3523,1757,23.6,1871.9,3,10,2,1,1,0,0,15196,6.6,17500,220,64,-3523,-1757,22,1519.6,red,7,0.5,19,14,blue
4519147034,7,13,11,0,0,0,0,15541,6.2,15120,180,45,-3711,-2987,18,1554.1,13,7,16,0,0,0,0,19252,7,18107,207,45,3711,2987,20.7,1925.2,red,1.38,4.14,19,16,red
4502928407,14,10,24,1,1,0,0,20114,7,19069,220,34,2397,3292,22,2011.4,10,14,9,0,0,0,0,17717,6.4,15777,144,60,-2397,-3292,14.4,1771.7,blue,3.8,1.36,20,21,red
4492674623,10,3,8,1,0,1,1,20173,7.4,20931,248,56,6281,4551,24.8,2017.3,3,10,0,1,1,0,0,13892,6.6,16380,204,40,-6281,-4551,20.4,1389.2,blue,6,0.3,15,16,blue
4510924170,9,9,14,0,0,0,0,17058,6.4,16359,174,40,-1004,-2008,17.4,1705.8,9,9,14,0,0,0,0,18062,7,18367,213,56,1004,2008,21.3,1806.2,red,2.56,2.56,12,17,blue
4513340432,11,6,17,1,1,0,1,19900,7,17323,200,41,4027,701,20,1990,6,11,9,0,0,0,0,15873,6.6,16622,197,58,-4027,-701,19.7,1587.3,red,4.67,1.36,17,22,blue
4522534575,5,6,5,1,1,0,0,15536,6.8,17751,179,52,-833,-1021,17.9,1553.6,6,5,6,1,0,1,0,16369,7.2,18772,240,60,833,1021,24,1636.9,blue,1.67,2.4,17,15,blue
4522447607,5,11,5,0,0,0,0,15946,6.8,16743,208,36,-2267,-2010,20.8,1594.6,11,5,14,1,1,0,0,18213,7,18753,227,48,2267,2010,22.7,1821.3,red,0.91,5,12,21,blue
4504495749,17,9,29,0,0,0,0,22449,7.4,19137,209,60,4624,2511,20.9,2244.9,9,17,17,0,0,0,0,17825,6.6,16626,180,40,-4624,-2511,18,1782.5,blue,5.11,1.53,25,88,blue
4510668822,6,9,8,0,0,0,0,15087,6.6,17017,177,43,-3782,-3060,17.7,1508.7,9,6,10,1,1,0,0,18869,7.4,20077,245,65,3782,3060,24.5,1886.9,red,1.56,3.17,14,15,red
4484301779,3,4,6,0,0,0,0,14632,6.4,16037,198,53,-1134,-906,19.8,1463.2,4,3,5,1,0,1,0,15766,6.8,16943,223,46,1134,906,22.3,1576.6,blue,2.25,3,22,19,blue
4523489626,8,6,4,1,1,0,0,16883,7.2,18957,215,52,955,642,21.5,1688.3,6,8,5,0,0,0,0,15928,7,18315,206,59,-955,-642,20.6,1592.8,blue,2,1.38,18,17,blue
4520050863,7,15,5,0,0,0,0,15463,6.4,16063,208,20,-3882,-2253,20.8,1546.3,15,7,15,2,1,1,0,19345,7,18316,213,40,3882,2253,21.3,1934.5,red,0.8,4.29,16,16,red
4522207978,5,4,6,0,0,0,0,16158,7.4,19418,175,83,-811,1024,17.5,1615.8,4,5,2,2,1,1,1,16969,7.2,18394,232,48,811,-1024,23.2,1696.9,red,2.75,1.2,21,19,blue
4514382046,4,7,6,0,0,0,0,15295,6.8,16951,225,45,-1755,-1014,22.5,1529.5,7,4,13,0,0,0,0,17050,7,17965,218,54,1755,1014,21.8,1705,blue,1.43,5,19,22,red
4518214462,8,6,5,1,0,1,0,17540,7.4,19850,232,56,1499,2433,23.2,1754,6,8,4,0,0,0,0,16041,7,17417,187,48,-1499,-2433,18.7,1604.1,blue,2.17,1.25,37,18,blue
4413595915,6,1,6,0,0,0,0,17066,7.6,20061,239,75,3215,2650,23.9,1706.6,1,6,0,1,0,1,0,13851,6.8,17411,220,56,-3215,-2650,22,1385.1,blue,12,0.17,17,12,blue
4459084553,5,5,6,0,0,0,0,16110,6.8,17732,245,38,-1519,-1488,24.5,1611,5,5,10,1,1,0,0,17629,7.2,19220,228,76,1519,1488,22.8,1762.9,red,2.2,3,28,25,red
4500461426,9,5,6,0,0,0,0,17707,7.2,18993,205,46,2488,2913,20.5,1770.7,5,9,5,0,0,0,0,15219,6.4,16080,190,44,-2488,-2913,19,1521.9,blue,3,1.11,19,17,red
4522255964,6,7,5,1,0,1,0,16461,7,18295,173,64,-667,1243,17.3,1646.1,7,6,9,0,0,0,0,17128,6.6,17052,224,39,667,-1243,22.4,1712.8,blue,1.57,2.67,16,20,red
4507827537,5,4,4,0,0,0,0,16429,7,18899,242,54,-172,1254,24.2,1642.9,4,5,5,0,0,0,0,16601,6.8,17645,219,47,172,-1254,21.9,1660.1,red,2.25,1.8,18,19,red
4513668536,3,7,3,1,1,0,0,15495,7,17827,226,60,-1972,-1613,22.6,1549.5,7,3,9,0,0,0,0,17467,7.2,19440,233,62,1972,1613,23.3,1746.7,red,0.86,5.33,17,32,blue
4519489484,4,5,4,1,1,0,0,15875,7,17873,235,51,-396,-1091,23.5,1587.5,5,4,6,0,0,0,0,16271,7.2,18964,210,58,396,1091,21,1627.1,red,1.6,2.75,10,32,blue
4496732986,7,5,10,0,0,0,0,16521,7,17150,223,35,413,-857,22.3,1652.1,5,7,5,0,0,0,0,16108,7,18007,197,56,-413,857,19.7,1610.8,red,3.4,1.43,18,44,blue
4524361217,7,6,10,0,0,0,0,16781,7,18289,195,55,439,751,19.5,1678.1,6,7,6,2,1,1,0,16342,7,17538,203,59,-439,-751,20.3,1634.2,blue,2.83,1.71,43,17,blue
4447165019,10,4,12,0,0,0,0,17748,7.2,19278,175,41,2329,2416,17.5,1774.8,4,10,4,1,0,1,0,15419,6.6,16862,218,55,-2329,-2416,21.8,1541.9,red,5.5,0.8,20,18,red
4524674585,5,13,2,0,0,0,0,16145,7,17749,221,40,-2746,-1939,22.1,1614.5,13,5,14,1,1,0,0,18891,7.2,19688,229,58,2746,1939,22.9,1889.1,red,0.54,5.4,34,14,red
4514246517,3,6,3,0,0,0,0,15049,6.8,17845,200,47,-964,-271,20,1504.9,6,3,4,2,1,1,0,16013,7,18116,196,46,964,271,19.6,1601.3,red,1,3.33,16,19,red
4511485561,8,4,13,1,1,0,0,16712,6.8,17797,194,48,2357,1436,19.4,1671.2,4,8,3,0,0,0,0,14355,6.4,16361,162,52,-2357,-1436,16.2,1435.5,blue,5.25,0.88,23,57,blue
4459961867,8,6,11,1,0,1,0,17662,7.2,19112,219,60,1016,310,21.9,1766.2,6,8,8,1,1,0,0,16646,7.2,18802,231,60,-1016,-310,23.1,1664.6,red,3.17,1.75,19,23,blue
4458615425,3,12,2,0,0,0,0,15197,6.8,17692,223,60,-3960,-1446,22.3,1519.7,12,3,15,2,1,1,0,19157,7,19138,216,52,3960,1446,21.6,1915.7,red,0.42,9,26,97,red
4519670667,6,3,6,1,1,0,0,17604,7.4,20758,248,67,2547,2796,24.8,1760.4,3,6,2,0,0,0,0,15057,6.6,17962,195,60,-2547,-2796,19.5,1505.7,blue,4,0.83,59,36,blue
4513442197,10,12,7,0,0,0,0,17431,6.8,17722,202,48,-1294,-267,20.2,1743.1,12,10,20,0,0,0,0,18725,6.8,17989,195,65,1294,267,19.5,1872.5,red,1.42,3.2,17,19,red
4501021398,2,11,2,0,0,0,0,14346,6.4,15676,200,49,-3886,-3453,20,1434.6,11,2,10,1,1,0,0,18232,7.2,19129,220,53,3886,3453,22,1823.2,red,0.36,10.5,13,18,red
4477390538,8,3,8,1,1,0,0,17623,7,17787,229,48,3100,1006,22.9,1762.3,3,8,2,0,0,0,0,14523,6.8,16781,209,47,-3100,-1006,20.9,1452.3,red,5.33,0.62,17,28,blue
4483736284,8,8,8,1,0,1,0,18683,7.2,19031,218,52,1874,1408,21.8,1868.3,8,8,8,1,1,0,0,16809,6.8,17623,215,44,-1874,-1408,21.5,1680.9,red,2,2,97,20,red
4517000510,4,4,5,1,1,0,0,15561,6.8,17448,226,47,246,-549,22.6,1556.1,4,4,1,0,0,0,0,15315,7,17997,228,51,-246,549,22.8,1531.5,blue,2.25,1.25,19,17,red
4422211651,10,10,11,1,1,0,0,18172,7.2,18893,218,48,-347,393,21.8,1817.2,10,10,10,0,0,0,0,18519,7,18500,219,48,347,-393,21.9,1851.9,red,2.1,2,18,18,blue
4524077612,6,6,2,1,0,1,1,16753,6.8,17350,190,61,1936,1799,19,1675.3,6,6,3,1,1,0,0,14817,6,15551,190,57,-1936,-1799,19,1481.7,blue,1.33,1.5,13,10,red
4477758358,6,6,7,0,0,0,0,15800,6.8,17954,203,48,-966,111,20.3,1580,6,6,7,0,0,0,0,16766,7,17843,220,47,966,-111,22,1676.6,red,2.17,2.17,20,22,red
4496960681,1,12,1,0,0,0,0,13525,6.4,15625,210,46,-5423,-4119,21,1352.5,12,1,14,1,1,0,0,18948,7.4,19744,206,46,5423,4119,20.6,1894.8,red,0.17,26,29,45,red
4520639999,5,3,5,0,0,0,0,16418,7.2,19182,242,60,1234,962,24.2,1641.8,3,5,3,2,1,1,0,15184,6.8,18220,215,56,-1234,-962,21.5,1518.4,blue,3.33,1.2,41,32,red
4517667629,3,4,2,0,0,0,0,14867,6.8,18057,222,47,-822,-592,22.2,1486.7,4,3,4,0,0,0,0,15689,7,18649,209,57,822,592,20.9,1568.9,red,1.25,2.67,18,40,red
4519541867,1,8,0,0,0,0,0,14288,6.4,15711,237,36,-3358,-2837,23.7,1428.8,8,1,6,1,1,0,0,17646,7.2,18548,240,52,3358,2837,24,1764.6,red,0.12,14,22,20,red
4511026023,6,5,7,1,0,1,0,16106,6.8,18229,216,47,-443,396,21.6,1610.6,5,6,6,1,1,0,0,16549,7,17833,240,59,443,-396,24,1654.9,blue,2.6,1.83,22,19,red
4508510246,7,7,4,0,0,0,0,16068,6.8,17309,193,42,-466,608,19.3,1606.8,7,7,9,0,0,0,0,16534,6.4,16701,224,29,466,-608,22.4,1653.4,red,1.57,2.29,16,22,blue
4505104327,6,7,6,0,0,0,0,16559,7,18024,208,54,-1192,-1896,20.8,1655.9,7,6,6,1,1,0,0,17751,7.4,19920,242,77,1192,1896,24.2,1775.1,blue,1.71,2.17,15,18,red
4520606377,5,5,5,1,1,0,0,16388,7,18495,256,32,178,882,25.6,1638.8,5,5,5,1,0,1,0,16210,6.8,17613,216,63,-178,-882,21.6,1621,blue,2,2,22,23,red
4496431819,4,8,6,1,1,0,0,15077,7,17523,208,42,-2035,-1237,20.8,1507.7,8,4,7,0,0,0,0,17112,7,18760,231,54,2035,1237,23.1,1711.2,blue,1.25,3.75,16,17,blue
4523410481,2,7,2,0,0,0,0,15106,6.8,17144,237,40,-4579,-3361,23.7,1510.6,7,2,7,2,1,1,2,19685,7.4,20505,246,62,4579,3361,24.6,1968.5,red,0.57,7,19,67,red
4515410950,4,5,6,0,0,0,0,16569,7,18534,228,52,77,-875,22.8,1656.9,5,4,6,1,1,0,0,16492,7.2,19409,246,60,-77,875,24.6,1649.2,red,2,2.75,14,14,red
4514826109,9,6,11,1,1,0,0,16863,7,18740,227,32,296,1370,22.7,1686.3,6,9,3,0,0,0,0,16567,7,17370,222,48,-296,-1370,22.2,1656.7,blue,3.33,1,18,14,red
4524113252,7,11,7,0,0,0,0,16171,6.4,16252,166,52,-2171,-2897,16.6,1617.1,11,7,13,1,1,0,0,18342,7,19149,220,43,2171,2897,22,1834.2,red,1.27,3.43,21,26,blue
4523523505,7,1,12,1,1,0,0,17149,7,19250,216,53,3370,2895,21.6,1714.9,1,7,0,0,0,0,0,13779,6.4,16355,209,52,-3370,-2895,20.9,1377.9,blue,19,0.14,14,15,blue
4520543348,5,2,4,2,1,1,0,16071,6.8,17618,224,44,1723,1090,22.4,1607.1,2,5,3,0,0,0,0,14348,6.6,16528,210,47,-1723,-1090,21,1434.8,blue,4.5,1,24,21,blue
4492065807,8,4,12,0,0,0,0,18498,7.2,18641,232,48,2759,980,23.2,1849.8,4,8,2,1,1,0,0,15739,7,17661,215,43,-2759,-980,21.5,1573.9,blue,5,0.75,19,18,blue
4518254989,3,7,3,0,0,0,0,14936,6.6,16574,225,30,-1703,-2550,22.5,1493.6,7,3,7,0,0,0,0,16639,7.2,19124,221,48,1703,2550,22.1,1663.9,red,0.86,4.67,16,21,blue
4520945917,12,6,17,1,1,0,0,18901,7,17651,210,40,2699,1015,21,1890.1,6,12,8,0,0,0,0,16202,6.6,16636,203,48,-2699,-1015,20.3,1620.2,blue,4.83,1.17,15,14,blue
4489542966,6,3,6,0,0,0,0,16372,6.8,17187,191,52,2201,374,19.1,1637.2,3,6,2,0,0,0,0,14171,6.8,16813,187,43,-2201,-374,18.7,1417.1,blue,4,0.83,19,14,blue
4446742734,10,3,11,1,1,0,0,17959,7.2,19184,222,44,3136,1557,22.2,1795.9,3,10,1,0,0,0,0,14823,6.8,17627,221,48,-3136,-1557,22.1,1482.3,blue,7,0.4,19,36,blue
4517558941,2,10,1,0,0,0,0,13550,6.8,16368,194,44,-4982,-3368,19.4,1355,10,2,5,2,1,1,0,18532,7.4,19736,258,48,4982,3368,25.8,1853.2,red,0.3,7.5,18,19,red
4488357361,4,8,4,1,0,1,0,15767,7,17903,233,52,-953,-677,23.3,1576.7,8,4,8,0,0,0,0,16720,7,18580,226,40,953,677,22.6,1672,blue,1,4,21,24,red
4452111743,10,5,6,2,1,1,0,17156,7.4,19115,235,32,777,977,23.5,1715.6,5,10,3,0,0,0,0,16379,7,18138,254,31,-777,-977,25.4,1637.9,blue,3.2,0.8,22,21,blue
4525163715,2,12,2,0,0,0,0,13802,6.8,17008,202,52,-5571,-2139,20.2,1380.2,12,2,16,2,1,1,0,19373,7.2,19147,247,48,5571,2139,24.7,1937.3,red,0.33,14,42,38,red
4511152514,5,9,5,0,0,0,0,15184,6.2,15748,199,35,-2098,-1464,19.9,1518.4,9,5,9,2,1,1,0,17282,6.8,17212,220,50,2098,1464,22,1728.2,red,1.11,3.6,44,25,blue
4461618866,3,3,3,1,1,0,0,15923,7,18062,248,50,1916,1404,24.8,1592.3,3,3,3,1,0,1,0,14007,6.8,16658,193,40,-1916,-1404,19.3,1400.7,blue,2,2,20,20,blue
4525028786,4,4,3,1,0,1,0,15222,7,18238,228,40,712,1633,22.8,1522.2,4,4,5,1,1,0,0,14510,6.8,16605,198,32,-712,-1633,19.8,1451,blue,1.75,2.25,19,16,blue
4517892829,2,4,1,0,0,0,0,14856,6.8,18155,240,51,-1129,-1348,24,1485.6,4,2,4,1,1,0,0,15985,7.4,19503,225,51,1129,1348,22.5,1598.5,red,0.75,4,11,34,red
4431359943,6,10,7,1,1,0,0,15336,6.6,16676,187,56,-2735,-2136,18.7,1533.6,10,6,9,1,0,1,0,18071,7,18812,226,46,2735,2136,22.6,1807.1,red,1.3,3.17,19,16,red
4524888423,10,3,15,1,1,0,0,18488,7.4,19504,224,49,3096,2404,22.4,1848.8,3,10,2,0,0,0,0,15392,6.8,17100,210,54,-3096,-2404,21,1539.2,blue,8.33,0.5,25,157,red
4521511498,5,7,4,1,1,0,0,15681,6.6,16896,205,50,-1058,-1404,20.5,1568.1,7,5,10,0,0,0,0,16739,7,18300,224,49,1058,1404,22.4,1673.9,blue,1.29,3.4,15,17,red
4492378749,3,5,3,1,0,1,1,17159,7,18318,250,56,1075,525,25,1715.9,5,3,7,1,1,0,0,16084,7,17793,225,48,-1075,-525,22.5,1608.4,red,1.2,4,91,23,blue
4455594728,3,5,2,0,0,0,0,15221,6.8,17841,218,60,-531,28,21.8,1522.1,5,3,6,1,1,0,0,15752,7,17813,240,44,531,-28,24,1575.2,blue,1,3.67,31,20,red
4521502172,8,7,10,0,0,0,0,16746,6.8,17772,188,48,409,-292,18.8,1674.6,7,8,8,1,1,0,0,16337,7,18064,216,52,-409,292,21.6,1633.7,red,2.57,1.88,22,22,blue
4495493566,6,8,8,0,0,0,1,18235,6.8,17856,229,52,517,-151,22.9,1823.5,8,6,11,1,0,1,0,17718,6.8,18007,213,41,-517,151,21.3,1771.8,red,1.75,3.17,18,21,blue
4503099396,5,7,5,0,0,0,0,16514,6.8,18012,244,48,-17,-514,24.4,1651.4,7,5,10,1,1,0,0,16531,7,18526,209,48,17,514,20.9,1653.1,blue,1.43,3.4,27,21,blue
4479510893,8,8,14,0,0,0,0,17346,6.8,16570,191,41,1399,1293,19.1,1734.6,8,8,14,0,0,0,0,15947,6.2,15277,193,34,-1399,-1293,19.3,1594.7,red,2.75,2.75,51,26,blue
4466524457,3,5,5,1,0,1,0,14838,6.8,16485,208,44,-1278,-1387,20.8,1483.8,5,3,9,0,0,0,0,16116,7,17872,221,39,1278,1387,22.1,1611.6,red,1.6,4.67,24,25,blue
4458264663,3,9,4,0,0,0,0,14471,7,17643,208,40,-3385,-2781,20.8,1447.1,9,3,8,1,1,0,0,17856,7.4,20424,223,44,3385,2781,22.3,1785.6,red,0.78,5.67,18,23,red
4484773926,5,2,5,1,1,0,0,16214,7.2,18849,225,52,136,365,22.5,1621.4,2,5,2,1,0,1,1,16078,7,18484,236,56,-136,-365,23.6,1607.8,blue,5,0.8,37,15,blue
4462810763,8,5,12,2,1,1,0,17839,7,18405,217,52,1339,1176,21.7,1783.9,5,8,5,0,0,0,0,16500,6.6,17229,212,44,-1339,-1176,21.2,1650,red,4,1.25,21,41,red
4483692276,6,5,7,1,0,1,0,17674,7.2,19752,225,80,2521,3096,22.5,1767.4,5,6,8,0,0,0,0,15153,6.6,16656,217,36,-2521,-3096,21.7,1515.3,blue,2.6,2.17,17,57,blue
4525214447,11,3,13,0,0,0,0,19008,7.4,18920,206,52,4255,2387,20.6,1900.8,3,11,1,0,0,0,0,14753,6.6,16533,202,63,-4255,-2387,20.2,1475.3,blue,8,0.36,18,97,blue
4519646184,4,4,6,0,0,0,0,15800,7.4,19395,231,72,-302,764,23.1,1580,4,4,4,0,0,0,0,16102,7.2,18631,236,49,302,-764,23.6,1610.2,blue,2.5,2,15,15,red
4478417424,6,11,3,0,0,0,0,16225,7,17831,203,49,-2741,-425,20.3,1622.5,11,6,16,1,1,0,1,18966,7,18256,220,34,2741,425,22,1896.6,red,0.82,4.5,18,24,red
4510949309,8,3,8,2,1,1,1,18237,7,18102,230,48,3675,2389,23,1823.7,3,8,4,0,0,0,0,14562,6,15713,170,62,-3675,-2389,17,1456.2,blue,5.33,0.88,48,12,blue
4502439636,6,6,5,1,1,0,0,16512,6.8,17751,225,56,46,-1299,22.5,1651.2,6,6,8,0,0,0,0,16466,7.2,19050,232,44,-46,1299,23.2,1646.6,red,1.83,2.33,17,20,red
4426241259,9,3,17,1,1,0,0,17478,7.2,18671,257,47,1071,107,25.7,1747.8,3,9,1,1,0,1,0,16407,7,18564,274,60,-1071,-107,27.4,1640.7,blue,8.67,0.44,19,17,blue
4496343427,3,6,2,2,1,1,0,15804,7.2,18768,222,75,-427,1475,22.2,1580.4,6,3,10,0,0,0,0,16231,6.6,17293,217,44,427,-1475,21.7,1623.1,blue,0.83,5.33,18,37,red
4482490476,7,5,6,2,1,1,0,16158,6.8,17789,224,46,1184,1807,22.4,1615.8,5,7,3,0,0,0,0,14974,6.6,15982,177,55,-1184,-1807,17.7,1497.4,red,2.6,1.14,22,52,red
4523058868,5,5,7,0,0,0,0,15799,7,17703,225,49,56,-694,22.5,1579.9,5,5,4,1,1,0,0,15743,7.2,18397,208,59,-56,694,20.8,1574.3,red,2.4,1.8,20,39,red
4519511299,9,5,12,0,0,0,0,18876,7,18843,235,50,2201,615,23.5,1887.6,5,9,7,1,1,0,0,16675,7,18228,196,66,-2201,-615,19.6,1667.5,blue,4.2,1.33,19,18,red
4497598810,2,4,1,0,0,0,0,15193,7,17619,252,48,-610,-1156,25.2,1519.3,4,2,6,1,1,0,0,15803,7.4,18775,215,60,610,1156,21.5,1580.3,red,0.75,5,16,40,blue
4479788915,8,4,8,2,1,1,1,19528,7.4,19755,257,56,3974,2785,25.7,1952.8,4,8,5,0,0,0,0,15554,6.8,16970,220,44,-3974,-2785,22,1555.4,blue,4,1.12,18,17,blue
4465024701,7,7,6,1,1,0,0,17597,7.2,18452,244,36,118,299,24.4,1759.7,7,7,7,0,0,0,0,17479,7,18153,224,62,-118,-299,22.4,1747.9,red,1.86,2,25,17,red
4521563183,5,6,3,0,0,0,0,16495,7,18518,230,46,955,748,23,1649.5,6,5,6,0,0,0,0,15540,6.8,17770,164,58,-955,-748,16.4,1554,red,1.33,2.4,17,39,red
4521141192,5,8,3,0,0,0,0,16042,7,18424,238,56,-686,-893,23.8,1604.2,8,5,4,2,1,1,0,16728,7.2,19317,216,71,686,893,21.6,1672.8,red,1,2.4,43,20,blue
4517904549,3,5,3,1,1,0,0,15636,6.8,17293,220,63,-1086,-637,22,1563.6,5,3,10,1,0,1,0,16722,7,17930,216,51,1086,637,21.6,1672.2,blue,1.2,5,20,44,red
4519777597,11,7,11,1,0,1,0,19063,7.2,19391,237,56,2411,875,23.7,1906.3,7,11,5,1,1,0,0,16652,7.2,18516,221,52,-2411,-875,22.1,1665.2,blue,3.14,1.09,36,17,blue
4495408942,11,2,20,0,0,0,0,18963,7.4,19079,239,40,5337,3334,23.9,1896.3,2,11,2,1,1,0,0,13626,6.6,15745,179,44,-5337,-3334,17.9,1362.6,blue,15.5,0.36,22,19,blue
4505797125,9,5,9,0,0,0,1,18391,6.6,17080,183,43,2040,725,18.3,1839.1,5,9,3,1,0,1,1,16351,6.6,16355,203,44,-2040,-725,20.3,1635.1,blue,3.6,0.89,16,16,blue
4421709133,3,9,5,1,0,1,0,15492,7,17768,245,55,-2139,868,24.5,1549.2,9,3,12,1,1,0,0,17631,6.6,16900,195,48,2139,-868,19.5,1763.1,red,0.89,7,20,40,red
4486082210,5,9,6,2,1,1,0,16142,6.8,16958,230,51,-1231,-888,23,1614.2,9,5,11,0,0,0,0,17373,6.8,17846,221,53,1231,888,22.1,1737.3,red,1.22,4,16,27,blue
4525312935,6,4,4,1,0,1,0,16926,7.2,19020,229,52,1947,1677,22.9,1692.6,4,6,1,1,1,0,0,14979,6.8,17343,230,44,-1947,-1677,23,1497.9,blue,2.5,0.83,23,20,red
4518737622,4,3,7,0,0,0,0,15517,6.6,16917,231,35,653,-556,23.1,1551.7,3,4,1,1,1,0,0,14864,6.6,17473,226,48,-653,556,22.6,1486.4,red,3.67,1,34,17,blue
4503476155,7,9,7,0,0,0,0,16929,7,17547,228,41,-1149,-1888,22.8,1692.9,9,7,7,0,0,0,0,18078,7.2,19435,232,50,1149,1888,23.2,1807.8,blue,1.56,2.29,29,18,blue
4519523296,3,6,3,1,1,0,0,15094,6.6,16864,237,48,-911,-870,23.7,1509.4,6,3,7,0,0,0,0,16005,6.8,17734,204,34,911,870,20.4,1600.5,red,1,4.33,71,35,red
4522209406,5,10,6,1,1,0,0,14604,6.2,15280,146,52,-4752,-2451,14.6,1460.4,10,5,11,0,0,0,1,19356,6.8,17731,210,47,4752,2451,21,1935.6,red,1.1,4.2,17,41,red
4520654397,1,0,1,1,0,1,0,15268,7.2,18685,269,56,296,440,26.9,1526.8,0,1,0,1,1,0,0,14972,7.2,18245,251,71,-296,-440,25.1,1497.2,blue,12.03,0,23,23,blue
4522317510,6,4,9,0,0,0,0,16317,6.8,16936,210,39,1163,-539,21,1631.7,4,6,1,1,1,0,0,15154,6.8,17475,241,32,-1163,539,24.1,1515.4,blue,3.75,0.83,23,23,red
4515973150,3,6,4,0,0,0,0,15426,7.2,18766,212,79,-1672,-470,21.2,1542.6,6,3,6,1,1,0,0,17098,7.2,19236,259,56,1672,470,25.9,1709.8,red,1.17,4,61,69,red
4518106435,0,4,0,0,0,0,0,14052,6.6,16542,229,48,-2502,-3183,22.9,1405.2,4,0,4,0,0,0,0,16554,7,19725,249,60,2502,3183,24.9,1655.4,red,0,12.65,17,42,red
4521157030,6,7,4,0,0,0,0,15369,6.8,17402,200,40,-1833,-917,20,1536.9,7,6,4,1,1,0,0,17202,7,18319,245,49,1833,917,24.5,1720.2,blue,1.43,1.83,19,15,red
4524068171,9,6,8,0,0,0,0,16961,6.6,17237,191,48,531,-881,19.1,1696.1,6,9,13,1,1,0,0,16430,7.2,18118,198,60,-531,881,19.8,1643,red,2.83,2.11,21,19,blue
4456927812,8,1,9,1,1,0,0,18177,7.4,19922,256,48,3710,2326,25.6,1817.7,1,8,2,0,0,0,0,14467,7,17596,226,58,-3710,-2326,22.6,1446.7,blue,17,0.38,18,18,blue
4463402176,9,7,10,0,0,0,0,17329,6.8,17577,223,48,675,691,22.3,1732.9,7,9,6,2,1,1,0,16654,6.8,16886,227,30,-675,-691,22.7,1665.4,blue,2.71,1.44,27,34,red
4477269261,13,7,13,1,1,0,0,19161,7,18599,232,40,2783,2368,23.2,1916.1,7,13,3,0,0,0,0,16378,6.8,16231,195,40,-2783,-2368,19.5,1637.8,blue,3.71,0.77,22,19,blue
4510792748,3,6,3,0,0,0,0,14649,6.6,15693,200,48,-1945,-2496,20,1464.9,6,3,7,1,1,0,0,16594,7,18189,216,61,1945,2496,21.6,1659.4,red,1,4.33,21,16,red
4454696616,2,2,2,0,0,0,0,15367,7,18723,238,72,183,-231,23.8,1536.7,2,2,2,2,1,1,0,15184,7.2,18954,233,67,-183,231,23.3,1518.4,blue,2,2,17,50,red
4439479847,4,5,4,1,1,0,0,16229,7.2,18834,247,48,960,813,24.7,1622.9,5,4,5,0,0,0,0,15269,6.8,18021,201,51,-960,-813,20.1,1526.9,red,1.6,2.5,15,19,blue
4518370041,6,6,8,2,1,1,0,17258,7,18225,239,58,1191,-311,23.9,1725.8,6,6,5,0,0,0,0,16067,6.8,18536,213,60,-1191,311,21.3,1606.7,red,2.33,1.83,23,17,blue
4460927725,13,1,15,1,1,0,2,22177,7.8,21202,230,58,8450,6098,23,2217.7,1,13,2,1,0,1,0,13727,6.2,15104,201,48,-8450,-6098,20.1,1372.7,blue,28,0.23,19,21,blue
4472381222,9,8,12,0,0,0,0,18004,7.4,20025,251,46,-305,685,25.1,1800.4,8,9,8,1,1,0,0,18309,7.2,19340,249,64,305,-685,24.9,1830.9,red,2.62,1.78,20,23,red
4462139744,15,3,14,2,1,1,1,20567,7.4,19536,221,42,6487,4018,22.1,2056.7,3,15,1,0,0,0,0,14080,6.2,15518,197,46,-6487,-4018,19.7,1408,blue,9.67,0.27,32,25,blue
4454995485,7,8,7,0,0,0,0,16650,7.2,17869,212,53,-1213,-1099,21.2,1665,8,7,6,1,1,0,0,17863,7.2,18968,229,59,1213,1099,22.9,1786.3,red,1.75,2,35,21,red
4524531081,2,6,2,0,0,0,0,14710,6.8,17302,231,44,-3673,-2499,23.1,1471,6,2,7,2,1,1,1,18383,7.4,19801,225,71,3673,2499,22.5,1838.3,red,0.67,6.5,19,59,red
4457658840,3,7,5,0,0,0,0,15442,6.6,17224,237,47,-2109,-1475,23.7,1544.2,7,3,10,1,1,0,0,17551,7.2,18699,233,50,2109,1475,23.3,1755.1,red,1.14,5.67,18,24,red
4519613119,10,7,7,0,0,0,0,18923,7.4,20387,241,59,1219,1356,24.1,1892.3,7,10,8,1,1,0,0,17704,7,19031,207,70,-1219,-1356,20.7,1770.4,red,2.43,1.5,15,16,red
4510955458,3,8,2,0,0,0,0,14783,6.2,15957,206,50,-1905,-2223,20.6,1478.3,8,3,5,1,1,0,0,16688,7,18180,224,60,1905,2223,22.4,1668.8,red,0.62,4.33,16,21,blue
4520973698,12,7,17,0,0,0,0,18074,6.8,16950,211,35,2170,1207,21.1,1807.4,7,12,11,1,1,0,0,15904,6.4,15743,188,34,-2170,-1207,18.8,1590.4,blue,4.14,1.5,17,50,red
4441700608,9,7,8,1,1,0,0,17684,7.4,19834,224,48,620,146,22.4,1768.4,7,9,5,1,0,1,0,17064,7.2,19688,197,68,-620,-146,19.7,1706.4,blue,2.43,1.33,15,32,red
4516597523,5,8,4,0,0,0,0,15476,6.8,16908,184,57,-1972,-1621,18.4,1547.6,8,5,10,2,1,1,0,17448,7.2,18529,213,48,1972,1621,21.3,1744.8,red,1.12,3.6,18,17,red
4523669745,8,5,6,2,1,1,0,17622,7.2,19988,252,72,1530,2220,25.2,1762.2,5,8,9,0,0,0,0,16092,7,17768,239,41,-1530,-2220,23.9,1609.2,red,2.8,1.75,40,57,blue
4520501584,6,4,6,1,1,0,0,16385,6.6,16580,208,45,1163,-1176,20.8,1638.5,4,6,4,1,0,1,0,15222,6.8,17756,194,52,-1163,1176,19.4,1522.2,blue,3,1.33,17,14,blue
4523629089,3,8,5,0,0,0,0,14425,6.6,16191,198,47,-2619,-1506,19.8,1442.5,8,3,9,1,1,0,0,17044,6.6,17697,212,49,2619,1506,21.2,1704.4,red,1,5.67,16,20,red
4456581816,6,5,3,0,0,0,0,16059,7.2,18356,212,59,584,1023,21.2,1605.9,5,6,8,0,0,0,0,15475,6.8,17333,207,36,-584,-1023,20.7,1547.5,blue,1.8,2.17,14,21,blue
4518889488,9,3,13,0,0,0,0,18633,7,18698,246,50,2910,856,24.6,1863.3,3,9,4,1,1,0,0,15723,6.8,17842,226,56,-2910,-856,22.6,1572.3,blue,7.33,0.78,16,15,blue
4520057356,3,6,2,0,0,0,0,15731,6.6,17150,251,42,-1057,-1798,25.1,1573.1,6,3,9,1,1,0,0,16788,7.2,18948,220,64,1057,1798,22,1678.8,red,0.83,5,19,21,red
4521257483,7,8,9,0,0,0,0,17371,7,18243,227,41,-50,563,22.7,1737.1,8,7,9,1,1,0,0,17421,6.8,17680,222,56,50,-563,22.2,1742.1,blue,2,2.43,12,21,blue
4462681802,5,12,9,0,0,0,0,15631,6.4,15075,199,36,-2084,-2025,19.9,1563.1,12,5,11,2,1,1,0,17715,7,17100,165,52,2084,2025,16.5,1771.5,red,1.17,4.6,15,20,blue
4515356970,8,7,4,0,0,0,0,16935,7,18740,210,60,469,1328,21,1693.5,7,8,12,0,0,0,0,16466,7,17412,212,32,-469,-1328,21.2,1646.6,blue,1.71,2.38,22,23,red
4523615323,7,7,6,0,0,0,0,16639,6.8,18068,214,48,-293,-818,21.4,1663.9,7,7,5,1,1,0,0,16932,7.2,18886,232,52,293,818,23.2,1693.2,blue,1.86,1.71,39,19,red
4495556599,7,3,6,0,0,0,0,16738,7.4,19318,219,61,1031,1909,21.9,1673.8,3,7,1,1,1,0,0,15707,7,17409,218,61,-1031,-1909,21.8,1570.7,blue,4.33,0.57,42,18,red
4525178929,3,4,4,0,0,0,0,15419,6.8,18138,251,52,-726,-1168,25.1,1541.9,4,3,4,2,1,1,0,16145,7.4,19306,236,64,726,1168,23.6,1614.5,red,1.75,2.67,21,26,blue
4514070207,4,8,2,2,1,1,0,14752,6.8,16831,209,44,-2511,-2094,20.9,1475.2,8,4,10,0,0,0,0,17263,7.4,18925,242,61,2511,2094,24.2,1726.3,blue,0.75,4.5,21,25,red
4524789573,6,4,7,0,0,0,0,16508,7,18227,204,47,489,-1163,20.4,1650.8,4,6,5,1,0,1,0,16019,7.2,19390,235,58,-489,1163,23.5,1601.9,red,3.25,1.5,15,36,blue
4524132104,6,10,8,0,0,0,0,16544,6.8,16885,223,56,-999,-955,22.3,1654.4,10,6,9,1,1,0,0,17543,6.8,17840,221,52,999,955,22.1,1754.3,red,1.4,3.17,23,24,red
4439587342,4,5,3,0,0,0,0,15597,7,18695,238,61,-1366,-242,23.8,1559.7,5,4,3,1,1,0,0,16963,7.2,18937,266,50,1366,242,26.6,1696.3,blue,1.4,2,32,33,red
4524687163,8,3,14,1,1,0,0,18022,7,18610,242,56,2958,983,24.2,1802.2,3,8,2,0,0,0,0,15064,7,17627,226,44,-2958,-983,22.6,1506.4,red,7.33,0.62,24,18,blue
4512949198,5,10,5,1,1,0,0,15714,6.8,17362,208,59,-3095,-2200,20.8,1571.4,10,5,12,0,0,0,0,18809,7.2,19562,244,40,3095,2200,24.4,1880.9,red,1,4.4,19,19,blue
4446037878,7,5,9,0,0,0,0,16219,7.2,17966,197,40,709,1449,19.7,1621.9,5,7,5,1,1,0,0,15510,6.4,16517,199,44,-709,-1449,19.9,1551,red,3.2,1.43,26,22,red
4478250976,9,8,8,0,0,0,0,16956,6.8,17632,219,39,-540,238,21.9,1695.6,8,9,8,0,0,0,0,17496,6.8,17394,205,44,540,-238,20.5,1749.6,red,2.12,1.78,20,16,red
4523300561,11,2,9,1,1,0,0,19280,7.6,20813,252,51,5041,3996,25.2,1928,2,11,3,0,0,0,0,14239,6.8,16817,215,59,-5041,-3996,21.5,1423.9,blue,10,0.45,13,23,blue
4505443622,10,8,22,0,0,0,0,19540,7.2,18969,247,60,1714,1487,24.7,1954,8,10,8,1,0,1,0,17826,7,17482,211,48,-1714,-1487,21.1,1782.6,blue,4,1.6,51,29,red
4477019326,5,5,7,0,0,0,0,16038,7.2,19227,228,54,-844,139,22.8,1603.8,5,5,5,1,1,0,0,16882,7.2,19088,226,68,844,-139,22.6,1688.2,blue,2.4,2,13,17,red
4525174684,5,2,5,1,1,0,0,16594,7.4,20008,227,76,1737,1565,22.7,1659.4,2,5,3,0,0,0,0,14857,7,18443,217,72,-1737,-1565,21.7,1485.7,blue,5,1,18,13,blue
4517959994,4,6,6,0,0,0,0,16040,7,17545,214,64,109,66,21.4,1604,6,4,6,1,1,0,0,15931,6.8,17479,221,40,-109,-66,22.1,1593.1,blue,1.67,3,17,19,red
4479856862,7,7,8,1,1,0,0,16282,6.8,16565,211,44,686,-89,21.1,1628.2,7,7,6,1,0,1,0,15596,6.6,16654,180,51,-686,89,18,1559.6,blue,2.14,1.86,24,58,blue
4517169842,4,6,7,0,0,0,0,15527,6.8,17554,202,44,-1537,93,20.2,1552.7,6,4,5,2,1,1,0,17064,6.8,17461,216,52,1537,-93,21.6,1706.4,red,1.83,2.75,19,27,red
4521354990,7,9,4,0,0,0,0,15933,6.8,16916,221,48,-1790,-1980,22.1,1593.3,9,7,10,1,1,0,0,17723,7.2,18896,223,64,1790,1980,22.3,1772.3,red,1.22,2.71,10,17,red
4524540652,6,6,9,0,0,0,0,17070,7,17907,208,60,1044,662,20.8,1707,6,6,8,0,0,0,0,16026,7,17245,208,32,-1044,-662,20.8,1602.6,red,2.5,2.33,110,16,red
4485481619,3,4,0,0,0,0,0,15084,7.2,19173,224,68,-1302,1008,22.4,1508.4,4,3,5,1,1,0,0,16386,7,18165,226,60,1302,-1008,22.6,1638.6,red,0.75,3,15,15,red
4490906138,8,4,10,0,0,0,0,16600,7.2,18932,192,52,1627,1723,19.2,1660,4,8,2,1,1,0,0,14973,6.6,17209,194,64,-1627,-1723,19.4,1497.3,red,4.5,0.75,151,18,red
4523332749,6,8,7,0,0,0,0,15982,6.6,18257,186,63,-2221,-365,18.6,1598.2,8,6,15,0,0,0,0,18203,7.2,18622,219,48,2221,365,21.9,1820.3,blue,1.62,3.83,13,17,red
4520703229,5,5,4,0,0,0,0,16355,6.6,17606,221,52,-1874,-1002,22.1,1635.5,5,5,5,1,0,1,2,18229,7.2,18608,205,60,1874,1002,20.5,1822.9,blue,1.8,2,61,18,red
4499786529,6,10,5,0,0,0,0,17040,7,17805,215,50,-545,-1102,21.5,1704,10,6,9,1,1,0,0,17585,7,18907,214,40,545,1102,21.4,1758.5,blue,1.1,3.17,89,23,blue
4520790076,6,2,9,1,1,0,0,16737,6.8,17593,243,44,2423,295,24.3,1673.7,2,6,2,1,0,1,0,14314,6.8,17298,232,52,-2423,-295,23.2,1431.4,blue,7.5,0.67,24,20,blue
4490677497,7,13,3,1,1,0,0,17090,7,18662,222,72,-2001,-1137,22.2,1709,13,7,20,0,0,0,0,19091,7.6,19799,217,24,2001,1137,21.7,1909.1,red,0.77,4.71,17,20,red
4499921176,5,15,5,0,0,0,0,14689,6,14871,168,36,-7206,-6046,16.8,1468.9,15,5,10,1,1,0,0,21895,7.4,20917,279,58,7206,6046,27.9,2189.5,red,0.67,5,11,17,blue
4516247062,7,6,8,0,0,0,0,16135,6.8,17313,196,48,494,-1338,19.6,1613.5,6,7,2,0,0,0,0,15641,7.2,18651,214,64,-494,1338,21.4,1564.1,blue,2.5,1.14,22,19,blue
4522539833,6,5,5,1,0,1,0,16500,6.8,18497,202,47,496,1530,20.2,1650,5,6,6,1,1,0,0,16004,6.8,16967,222,40,-496,-1530,22.2,1600.4,red,2.2,1.83,81,48,red
4523429650,6,7,8,0,0,0,0,17318,7,18742,237,72,568,-205,23.7,1731.8,7,6,8,2,1,1,0,16750,7.4,18947,202,60,-568,205,20.2,1675,red,2,2.5,16,19,blue
4458532783,9,2,14,0,0,0,0,18202,7,18332,232,58,3424,1624,23.2,1820.2,2,9,2,1,1,0,0,14778,6.4,16708,228,50,-3424,-1624,22.8,1477.8,blue,11.5,0.44,25,23,blue
4499647535,5,5,10,1,1,0,0,17208,7.2,19055,260,60,549,429,26,1720.8,5,5,6,0,0,0,0,16659,6.8,18626,258,60,-549,-429,25.8,1665.9,red,3,2.2,36,21,red
4492296802,5,2,8,1,1,0,0,16496,6.8,18200,251,64,1506,-169,25.1,1649.6,2,5,1,1,0,1,0,14990,7,18369,224,68,-1506,169,22.4,1499,red,6.5,0.6,17,48,red
4523485594,10,5,6,0,0,0,0,17915,7.4,19494,222,62,2833,3175,22.2,1791.5,5,10,6,0,0,0,0,15082,6.6,16319,206,25,-2833,-3175,20.6,1508.2,blue,3.2,1.1,28,18,blue
4513848861,10,8,16,0,0,0,0,18917,7.2,18476,210,49,773,1125,21,1891.7,8,10,11,1,1,0,0,18144,6.6,17351,207,65,-773,-1125,20.7,1814.4,red,3.25,1.9,19,17,red
4509159917,8,12,8,1,1,0,0,16484,6.4,16372,176,39,-2146,-3245,17.6,1648.4,12,8,7,0,0,0,0,18630,7.2,19617,204,55,2146,3245,20.4,1863,red,1.33,2.38,14,19,red
4518202397,13,7,10,1,1,0,0,19402,7,18727,213,51,2399,1719,21.3,1940.2,7,13,8,0,0,0,0,17003,6.6,17008,212,32,-2399,-1719,21.2,1700.3,red,3.29,1.15,25,20,blue
4515801443,4,1,5,2,1,1,0,15869,7.2,18711,249,64,453,76,24.9,1586.9,1,4,1,0,0,0,0,15416,7,18635,265,68,-453,-76,26.5,1541.6,red,9,0.5,14,24,blue
4523336843,6,2,5,1,0,1,0,17338,7.4,19907,256,63,2533,1568,25.6,1733.8,2,6,3,0,0,0,0,14805,7.2,18339,242,53,-2533,-1568,24.2,1480.5,blue,5.5,0.83,15,21,blue
4482626954,12,1,10,0,0,0,0,18849,7.4,19281,231,43,5077,3251,23.1,1884.9,1,12,0,0,0,0,0,13772,6.6,16030,224,41,-5077,-3251,22.4,1377.2,blue,22,0.08,19,20,blue
4458085215,6,11,8,0,0,0,0,15250,6.2,15780,183,50,-4699,-4580,18.3,1525,11,6,12,1,1,0,0,19949,7.4,20360,237,56,4699,4580,23.7,1994.9,red,1.27,3.83,19,19,red
4468973214,4,7,6,0,0,0,0,15210,6.6,16010,207,40,-2161,-3222,20.7,1521,7,4,8,2,1,1,0,17371,7.4,19232,214,72,2161,3222,21.4,1737.1,red,1.43,3.75,24,36,red
4496563536,8,8,9,0,0,0,0,16692,7,17643,181,68,-795,-117,18.1,1669.2,8,8,14,0,0,0,0,17487,7,17760,222,32,795,117,22.2,1748.7,blue,2.12,2.75,37,36,red
4503476670,4,4,3,0,0,0,0,16621,6.8,18305,255,50,875,-391,25.5,1662.1,4,4,7,0,0,0,0,15746,7,18696,238,65,-875,391,23.8,1574.6,blue,1.75,2.75,22,19,blue
4510723615,3,6,4,1,1,0,0,15698,7,18184,226,61,-1556,-887,22.6,1569.8,6,3,7,0,0,0,0,17254,7,19071,237,57,1556,887,23.7,1725.4,red,1.17,4.33,17,39,red
4524935844,2,10,3,1,0,1,0,14593,6.6,16673,199,53,-4019,-2008,19.9,1459.3,10,2,14,1,1,0,0,18612,7,18681,232,43,4019,2008,23.2,1861.2,red,0.5,12,21,20,red
4508455682,7,8,8,0,0,0,0,16712,6.8,16923,221,21,-609,-1114,22.1,1671.2,8,7,11,1,1,0,0,17321,6.8,18037,229,43,609,1114,22.9,1732.1,blue,1.88,2.71,18,27,blue
4518193450,6,10,8,0,0,0,0,16837,7.2,17911,191,59,-2152,-2041,19.1,1683.7,10,6,8,2,1,1,0,18989,7.4,19952,237,56,2152,2041,23.7,1898.9,red,1.4,3,19,20,red
4495688378,5,5,5,1,1,0,0,15514,7,18547,200,56,-1509,-358,20,1551.4,5,5,4,0,0,0,0,17023,7,18905,259,58,1509,358,25.9,1702.3,red,2,1.8,19,17,red
4519879315,8,8,4,0,0,0,0,17236,7.2,19937,235,64,-308,1739,23.5,1723.6,8,8,10,1,1,0,0,17544,6.8,18198,220,60,308,-1739,22,1754.4,blue,1.5,2.25,56,19,blue
4517167802,7,14,10,0,0,0,0,16204,7,17704,182,49,-4473,-3040,18.2,1620.4,14,7,19,1,1,0,0,20677,7.4,20744,237,80,4473,3040,23.7,2067.7,red,1.21,4.71,37,18,red
4508878155,9,6,10,0,0,0,0,18422,7,18184,219,49,2991,1357,21.9,1842.2,6,9,6,0,0,0,0,15431,6.6,16827,200,54,-2991,-1357,20,1543.1,blue,3.17,1.33,16,18,blue
4496026567,5,8,6,0,0,0,0,15356,6.8,16700,207,36,-2416,-3217,20.7,1535.6,8,5,8,0,0,0,0,17772,7.4,19917,239,62,2416,3217,23.9,1777.2,red,1.38,3.2,33,45,red
4456161907,2,4,1,0,0,0,0,14848,6.8,17467,205,65,-132,119,20.5,1484.8,4,2,3,1,1,0,0,14980,6.8,17348,213,44,132,-119,21.3,1498,red,0.75,3.5,149,17,blue
4522201700,4,4,3,0,0,0,0,15688,6.8,18341,237,51,91,591,23.7,1568.8,4,4,6,0,0,0,0,15597,6.8,17750,239,54,-91,-591,23.9,1559.7,blue,1.75,2.5,18,26,red
4518834172,4,4,2,0,0,0,0,14926,7,19450,203,59,-842,2032,20.3,1492.6,4,4,7,1,0,1,0,15768,7,17418,243,47,842,-2032,24.3,1576.8,blue,1.5,2.75,23,19,blue
4522617067,7,14,5,0,0,0,0,16190,6.6,16496,207,34,-2302,-997,20.7,1619,14,7,16,0,0,0,0,18492,6.6,17493,173,52,2302,997,17.3,1849.2,red,0.86,4.29,40,22,red
4513710414,6,2,8,1,1,0,0,16318,7,18426,226,59,2463,1390,22.6,1631.8,2,6,1,0,0,0,0,13855,6.8,17036,200,56,-2463,-1390,20,1385.5,blue,7,0.5,19,58,blue
4523752057,6,11,8,0,0,0,0,15376,6.6,16758,196,28,-4264,-3932,19.6,1537.6,11,6,6,2,1,1,0,19640,7.4,20690,262,72,4264,3932,26.2,1964,red,1.27,2.83,34,20,red
4486889900,1,10,1,0,0,0,0,14666,6.2,16186,233,49,-3480,-1368,23.3,1466.6,10,1,22,1,1,0,0,18146,7,17554,193,46,3480,1368,19.3,1814.6,red,0.2,32,21,47,red
4516724149,6,9,3,1,1,0,0,16301,7.2,18968,235,60,-1207,606,23.5,1630.1,9,6,10,0,0,0,0,17508,7,18362,230,45,1207,-606,23,1750.8,blue,1,3.17,23,31,red
4488915308,4,11,9,0,0,0,0,15124,6.8,17488,213,37,-4664,-2707,21.3,1512.4,11,4,7,2,1,1,0,19788,7.4,20195,249,66,4664,2707,24.9,1978.8,red,1.18,4.5,24,24,red
4467046961,10,2,13,2,1,1,0,19031,7.4,20293,212,71,4888,3753,21.2,1903.1,2,10,3,0,0,0,0,14143,6.8,16540,182,56,-4888,-3753,18.2,1414.3,blue,11.5,0.5,48,24,blue
4466166046,11,9,9,0,0,0,0,18581,7.2,19012,239,36,1433,508,23.9,1858.1,9,11,7,1,1,0,0,17148,7,18504,218,44,-1433,-508,21.8,1714.8,blue,2.22,1.45,29,35,blue
4520795867,7,3,9,2,1,1,0,17144,7,18638,230,56,1713,1673,23,1714.4,3,7,1,0,0,0,0,15431,6.6,16965,216,56,-1713,-1673,21.6,1543.1,red,5.33,0.57,15,16,red
4497099523,9,10,10,2,1,1,0,18368,7.2,19062,204,52,-328,137,20.4,1836.8,10,9,13,0,0,0,0,18696,7.2,18925,230,52,328,-137,23,1869.6,red,1.9,2.56,60,15,red
4501319055,6,2,6,1,1,0,0,16844,7,18805,243,45,2726,1990,24.3,1684.4,2,6,1,0,0,0,0,14118,6.8,16815,210,50,-2726,-1990,21,1411.8,blue,6,0.5,25,43,red
4491887077,8,10,13,0,0,0,0,16707,6.6,16612,204,43,-648,-1422,20.4,1670.7,10,8,12,1,1,0,0,17355,6.8,18034,193,52,648,1422,19.3,1735.5,red,2.1,2.75,20,21,red
4465693546,10,9,9,2,1,1,0,17868,7,17858,177,56,-286,-916,17.7,1786.8,9,10,11,0,0,0,0,18154,7,18774,247,56,286,916,24.7,1815.4,blue,2.11,2,18,25,red
4495791670,13,2,9,0,0,0,0,20043,7.8,21800,264,64,5300,4813,26.4,2004.3,2,13,0,1,0,1,0,14743,6.6,16987,230,52,-5300,-4813,23,1474.3,blue,11,0.15,41,46,blue
4519530388,3,11,3,0,0,0,0,14852,6.6,16246,194,66,-4835,-3655,19.4,1485.2,11,3,11,1,1,0,1,19687,7.2,19901,195,57,4835,3655,19.5,1968.7,red,0.55,7.33,11,10,blue
4487193298,7,8,8,0,0,0,0,16302,6.2,15434,183,37,-592,-2438,18.3,1630.2,8,7,10,0,0,0,0,16894,6.8,17872,216,50,592,2438,21.6,1689.4,red,1.88,2.57,22,22,blue
4462313921,17,5,25,0,0,0,2,23359,7.4,20348,237,56,7776,6703,23.7,2335.9,5,17,7,0,0,0,0,15583,5.8,13645,134,41,-7776,-6703,13.4,1558.3,blue,8.4,0.71,61,19,blue
4477337521,8,6,12,1,1,0,0,18352,7.2,18953,242,42,1909,1099,24.2,1835.2,6,8,5,0,0,0,0,16443,7,17854,225,40,-1909,-1099,22.5,1644.3,blue,3.33,1.38,25,19,red
4518328574,3,6,1,1,0,1,1,16873,6.8,17662,240,53,1942,450,24,1687.3,6,3,4,0,0,0,0,14931,6.8,17212,168,42,-1942,-450,16.8,1493.1,blue,0.67,3.33,48,43,blue
4518075871,7,6,6,0,0,0,0,16949,7,18440,236,61,16,560,23.6,1694.9,6,7,7,2,1,1,0,16933,7.2,17880,232,40,-16,-560,23.2,1693.3,red,2.17,1.86,30,29,red
4524546018,5,8,3,0,0,0,0,16344,7.4,19207,230,64,-860,949,23,1634.4,8,5,6,1,1,0,0,17204,7.2,18258,202,52,860,-949,20.2,1720.4,blue,1,2.8,46,21,red
4508930231,5,6,6,0,0,0,0,15268,6.6,17072,211,49,-2308,-1946,21.1,1526.8,6,5,8,1,1,0,0,17576,7.2,19018,263,56,2308,1946,26.3,1757.6,red,1.83,2.8,19,14,red
4494055420,8,7,8,1,0,1,0,16463,6.4,16544,186,40,-460,-1189,18.6,1646.3,7,8,4,0,0,0,0,16923,6.8,17733,238,48,460,1189,23.8,1692.3,blue,2.29,1.38,20,21,red
4482404724,7,4,6,0,0,0,0,17049,6.8,17357,221,36,799,440,22.1,1704.9,4,7,3,1,0,1,0,16250,6.6,16917,215,48,-799,-440,21.5,1625,blue,3.25,1,19,22,red
4500830976,4,2,3,1,1,0,0,15811,7.2,18673,242,52,886,355,24.2,1581.1,2,4,1,0,0,0,0,14925,7.2,18318,236,55,-886,-355,23.6,1492.5,blue,3.5,0.75,33,44,blue
4481881840,1,9,1,0,0,0,0,14109,6.4,16353,205,52,-3300,-3318,20.5,1410.9,9,1,7,0,0,0,0,17409,7.2,19671,231,39,3300,3318,23.1,1740.9,red,0.22,16,17,12,red
4513544189,2,8,2,0,0,0,0,12292,5.8,13648,152,36,-9341,-6317,15.2,1229.2,8,2,11,1,0,1,2,21633,7.4,19965,239,84,9341,6317,23.9,2163.3,red,0.5,9.5,15,16,red
4524277533,10,3,16,1,1,0,0,18487,7.2,18183,211,49,3851,1574,21.1,1848.7,3,10,3,0,0,0,0,14636,6.4,16609,211,52,-3851,-1574,21.1,1463.6,blue,8.67,0.6,93,18,blue
4499668279,8,5,7,1,1,0,0,16860,7.2,18713,198,71,-147,21,19.8,1686,5,8,5,0,0,0,0,17007,7.2,18692,257,56,147,-21,25.7,1700.7,red,3,1.25,19,15,red
4522637955,7,5,14,1,0,1,0,17798,7,19047,222,64,1698,1171,22.2,1779.8,5,7,7,0,0,0,0,16100,6.8,17876,241,46,-1698,-1171,24.1,1610,blue,4.2,1.71,17,25,blue
4500208615,6,6,4,0,0,0,0,15789,6.6,17312,230,35,-966,-901,23,1578.9,6,6,5,1,1,0,0,16755,7,18213,231,48,966,901,23.1,1675.5,red,1.67,1.83,21,18,red
4520915828,13,7,19,1,1,0,0,19609,7,17551,207,32,3454,175,20.7,1960.9,7,13,6,0,0,0,0,16155,6.8,17376,201,45,-3454,-175,20.1,1615.5,red,4.57,1,16,15,red
4518182783,5,6,6,1,0,1,0,14853,6.4,16170,174,48,-2673,-1867,17.4,1485.3,6,5,8,1,1,0,0,17526,7,18037,246,56,2673,1867,24.6,1752.6,red,1.83,2.8,17,61,red
4491522681,3,4,2,0,0,0,0,15369,7,17785,221,57,-482,-349,22.1,1536.9,4,3,5,1,1,0,0,15851,7,18134,257,56,482,349,25.7,1585.1,red,1.25,3,16,25,red
4523403818,6,8,7,0,0,0,0,17053,7,18362,219,46,-298,0,21.9,1705.3,8,6,7,1,1,0,0,17351,7.2,18362,213,45,298,0,21.3,1735.1,blue,1.62,2.5,26,22,blue
4510862255,11,9,10,1,1,0,0,17307,6.6,16527,161,42,-224,-765,16.1,1730.7,9,11,9,0,0,0,0,17531,6.8,17292,210,30,224,765,21,1753.1,blue,2.33,1.64,21,110,blue
4518730282,3,9,3,0,0,0,0,14881,6.4,15603,195,64,-1683,-377,19.5,1488.1,9,3,17,1,1,0,0,16564,6.4,15980,185,55,1683,377,18.5,1656.4,red,0.67,8.67,16,19,blue
4522585401,9,4,7,0,0,0,0,17928,7.4,20419,250,60,2514,2924,25,1792.8,4,9,5,0,0,0,0,15414,7,17495,180,61,-2514,-2924,18,1541.4,blue,4,1,20,37,red
4511779453,3,3,2,1,1,0,0,14876,7,17630,221,51,81,450,22.1,1487.6,3,3,6,1,0,1,0,14795,7,17180,218,52,-81,-450,21.8,1479.5,red,1.67,3,19,43,red
4525174199,3,2,3,1,1,0,0,15356,7,18787,212,64,420,521,21.2,1535.6,2,3,1,0,0,0,0,14936,7,18266,230,57,-420,-521,23,1493.6,blue,3,1,18,24,red
4523289245,7,7,7,1,0,1,0,16122,6.8,18226,168,57,-1167,259,16.8,1612.2,7,7,3,0,0,0,0,17289,7,17967,210,47,1167,-259,21,1728.9,blue,2,1.43,16,16,red
4431352906,4,4,4,1,0,1,0,15426,7,17981,211,54,-99,151,21.1,1542.6,4,4,2,1,1,0,0,15525,6.8,17830,230,56,99,-151,23,1552.5,blue,2,1.5,45,17,red
4514421047,7,7,5,0,0,0,0,16448,7.2,19097,216,52,387,1781,21.6,1644.8,7,7,2,0,0,0,0,16061,6.8,17316,210,48,-387,-1781,21,1606.1,blue,1.71,1.29,19,16,blue
4525208534,2,5,1,0,0,0,0,14182,6.8,16753,220,52,-1700,-1053,22,1418.2,5,2,3,0,0,0,0,15882,6.8,17806,223,43,1700,1053,22.3,1588.2,red,0.6,4,18,14,red
4509344771,4,7,4,1,0,1,0,15891,7.2,19024,200,59,-820,-298,20,1589.1,7,4,7,1,1,0,0,16711,7.4,19322,214,48,820,298,21.4,1671.1,blue,1.14,3.5,13,36,red
4475349750,5,13,5,1,0,1,0,15858,6.4,16120,219,29,-3945,-1758,21.9,1585.8,13,5,19,1,1,0,1,19803,7.2,17878,196,47,3945,1758,19.6,1980.3,blue,0.77,6.4,17,18,red
4519852110,4,8,5,1,0,1,0,14949,6.4,16818,180,44,-3238,-1130,18,1494.9,8,4,9,1,1,0,0,18187,7,17948,259,40,3238,1130,25.9,1818.7,red,1.12,4.25,15,22,red
4523427539,2,6,3,1,1,0,0,14377,7,17055,210,48,-2511,-2347,21,1437.7,6,2,8,0,0,0,0,16888,7.2,19402,249,60,2511,2347,24.9,1688.8,red,0.83,7,14,35,blue
4523806048,5,3,6,1,1,0,0,15946,7,18587,223,51,1433,1278,22.3,1594.6,3,5,2,0,0,0,0,14513,7,17309,183,54,-1433,-1278,18.3,1451.3,red,3.67,1,18,50,blue
4515248158,2,6,3,0,0,0,0,15584,6.8,17939,234,53,-1037,-1057,23.4,1558.4,6,2,13,0,0,0,0,16621,7.2,18996,222,56,1037,1057,22.2,1662.1,red,0.83,9.5,17,19,blue
4481449658,4,3,3,1,1,0,0,15800,7,18316,244,58,1344,1628,24.4,1580,3,4,1,0,0,0,0,14456,6.6,16688,210,37,-1344,-1628,21,1445.6,blue,2.33,1,18,18,red
4509723024,6,6,7,2,1,1,0,16210,7.2,18620,231,49,-245,330,23.1,1621,6,6,8,0,0,0,0,16455,7.2,18290,220,55,245,-330,22,1645.5,red,2.17,2.33,13,16,red
4522855501,13,4,7,1,1,0,1,20587,7.4,19713,229,48,5920,2703,22.9,2058.7,4,13,3,0,0,0,0,14667,6.8,17010,168,58,-5920,-2703,16.8,1466.7,blue,5,0.54,26,19,blue
4508742388,3,5,3,1,1,0,0,15735,7,18331,233,52,539,774,23.3,1573.5,5,3,4,0,0,0,0,15196,7,17557,220,40,-539,-774,22,1519.6,blue,1.2,3,18,21,blue
4480411096,8,7,7,0,0,0,0,17378,7.2,18525,242,39,708,302,24.2,1737.8,7,8,6,0,0,0,0,16670,7,18223,235,45,-708,-302,23.5,1667,red,2.14,1.62,17,14,blue
4522377959,10,5,14,0,0,0,0,17993,6.6,16834,222,36,2876,2805,22.2,1799.3,5,10,8,0,0,0,0,15117,6,14029,180,36,-2876,-2805,18,1511.7,red,4.8,1.3,15,17,red
4448358133,5,7,9,0,0,0,0,16072,6.8,16945,236,32,-184,408,23.6,1607.2,7,5,7,0,0,0,0,16256,6.8,16537,195,39,184,-408,19.5,1625.6,blue,2,2.8,20,17,blue
4509881889,3,5,4,1,1,0,0,15557,7,18380,251,56,-101,-380,25.1,1555.7,5,3,2,0,0,0,0,15658,7.2,18760,210,64,101,380,21,1565.8,red,1.4,2.33,24,15,red
4500724554,3,13,3,0,0,0,0,14467,6.6,16331,209,44,-5563,-4698,20.9,1446.7,13,3,8,2,1,1,0,20030,7.6,21029,235,70,5563,4698,23.5,2003,red,0.46,7,21,20,red
4494473176,8,9,12,1,1,0,0,16096,6.4,15907,197,48,-447,-2127,19.7,1609.6,9,8,7,0,0,0,0,16543,7,18034,193,36,447,2127,19.3,1654.3,blue,2.22,2,23,45,blue
4509854738,7,4,8,1,1,0,0,16351,6.8,17063,171,55,1487,1143,17.1,1635.1,4,7,2,0,0,0,0,14864,6.4,15920,224,28,-1487,-1143,22.4,1486.4,blue,3.75,0.86,17,15,blue
4524761713,6,4,5,1,1,0,0,16538,7,18735,227,44,1126,878,22.7,1653.8,4,6,2,1,0,1,0,15412,6.8,17857,225,45,-1126,-878,22.5,1541.2,blue,2.75,1,22,13,red
4442002416,5,2,3,0,0,0,0,16337,7.2,19371,259,48,1795,1933,25.9,1633.7,2,5,2,0,0,0,0,14542,6.8,17438,238,48,-1795,-1933,23.8,1454.2,blue,4,0.8,21,21,red
4505154902,10,2,13,1,1,0,0,17519,6.8,17753,209,37,4216,2141,20.9,1751.9,2,10,1,0,0,0,0,13303,6.4,15612,197,38,-4216,-2141,19.7,1330.3,blue,11.5,0.3,45,13,blue
4512160768,2,3,5,1,1,0,0,14305,6.8,17323,214,47,-1517,-972,21.4,1430.5,3,2,3,1,0,1,0,15822,7,18295,225,68,1517,972,22.5,1582.2,red,2.33,3,12,16,blue
4462777872,12,5,9,0,0,0,0,18279,7.4,18909,174,54,1236,149,17.4,1827.9,5,12,3,2,1,1,0,17043,7,18760,224,60,-1236,-149,22.4,1704.3,red,4.2,0.67,21,19,red
4523326284,8,6,9,2,1,1,0,17808,7,18545,246,44,2489,1473,24.6,1780.8,6,8,4,0,0,0,0,15319,6.6,17072,191,42,-2489,-1473,19.1,1531.9,blue,2.83,1.25,23,20,blue
4515648647,6,6,5,1,0,1,0,17360,7.4,19151,250,48,1259,1281,25,1736,6,6,8,1,1,0,0,16101,7,17870,201,60,-1259,-1281,20.1,1610.1,red,1.83,2.33,19,21,blue
4525030965,11,6,10,1,0,1,0,18849,7.2,19086,220,65,3281,1747,22,1884.9,6,11,3,1,1,0,0,15568,6.8,17339,202,56,-3281,-1747,20.2,1556.8,blue,3.5,0.82,37,13,blue
4513670045,4,4,6,0,0,0,0,15641,7.2,17857,244,40,-1136,-1235,24.4,1564.1,4,4,3,1,1,0,0,16777,7.2,19092,234,71,1136,1235,23.4,1677.7,red,2.5,1.75,19,63,red
4521995809,2,6,2,0,0,0,0,13408,6.6,15571,185,43,-5838,-4101,18.5,1340.8,6,2,4,1,1,0,0,19246,7.2,19672,255,72,5838,4101,25.5,1924.6,red,0.67,5,19,17,red
4482423857,13,10,15,0,0,0,0,19366,7,18628,229,56,1973,1461,22.9,1936.6,10,13,13,1,1,0,0,17393,6.8,17167,164,43,-1973,-1461,16.4,1739.3,blue,2.8,1.77,14,13,blue
4519722602,7,6,8,1,1,0,0,16646,6.6,16213,204,44,592,-875,20.4,1664.6,6,7,8,0,0,0,0,16054,6.6,17088,204,56,-592,875,20.4,1605.4,red,2.5,2,19,33,blue
4470192893,3,9,4,1,1,0,0,15009,6.8,17067,207,56,-2492,-1526,20.7,1500.9,9,3,13,0,0,0,0,17501,7.4,18593,204,50,2492,1526,20.4,1750.1,red,0.78,7.33,14,17,blue
4438165073,5,9,5,1,1,0,0,15921,6.8,17353,210,68,-1490,-1624,21,1592.1,9,5,14,0,0,0,0,17411,7.2,18977,215,52,1490,1624,21.5,1741.1,red,1.11,4.6,20,20,blue
4525371439,8,6,12,1,1,0,0,18012,6.6,16748,210,53,2957,2549,21,1801.2,6,8,5,0,0,0,0,15055,6,14199,177,41,-2957,-2549,17.7,1505.5,blue,3.33,1.38,18,49,blue
4498101728,5,12,5,1,1,0,0,15224,6.6,16423,203,45,-4927,-5216,20.3,1522.4,12,5,11,0,0,0,0,20151,7.8,21639,231,63,4927,5216,23.1,2015.1,red,0.83,4.6,14,42,red
4524538444,6,15,7,0,0,0,0,15484,6.6,16418,165,46,-4879,-3465,16.5,1548.4,15,6,16,1,1,0,0,20363,7.4,19883,250,39,4879,3465,25,2036.3,red,0.87,5.17,20,49,red
4457541720,3,3,2,2,1,1,0,15550,7.2,18425,249,56,-424,-1075,24.9,1555,3,3,5,0,0,0,0,15974,7.2,19500,245,68,424,1075,24.5,1597.4,blue,1.67,2.67,14,19,blue
4515730845,6,4,5,0,0,0,0,15895,6.8,17705,225,48,-1018,-1531,22.5,1589.5,4,6,6,1,1,0,0,16913,7.4,19236,232,80,1018,1531,23.2,1691.3,red,2.75,1.67,20,18,blue
4490954687,8,5,7,1,0,1,0,16776,7,18113,207,64,907,-86,20.7,1677.6,5,8,8,1,1,0,0,15869,7,18199,228,42,-907,86,22.8,1586.9,blue,3,1.62,59,20,blue
4500224763,1,5,2,0,0,0,0,13444,6.4,16544,197,52,-3445,-2015,19.7,1344.4,5,1,5,0,0,0,0,16889,7,18559,246,53,3445,2015,24.6,1688.9,red,0.6,10,9,14,red
4515924024,11,9,11,0,0,0,0,17971,7.2,18271,162,71,152,-486,16.2,1797.1,9,11,9,0,0,0,0,17819,7.2,18757,192,48,-152,486,19.2,1781.9,blue,2.44,1.64,38,16,red
4523053745,1,7,3,0,0,0,0,12959,6.4,15381,172,43,-4456,-2336,17.2,1295.9,7,1,17,0,0,0,0,17415,6.8,17717,196,51,4456,2336,19.6,1741.5,red,0.57,24,15,55,red
4523968738,9,9,7,0,0,0,0,17225,7,17613,217,38,69,-232,21.7,1722.5,9,9,12,0,0,0,0,17156,7,17845,210,32,-69,232,21,1715.6,blue,1.78,2.33,20,17,blue
4511923610,9,6,8,0,0,0,0,17848,7.4,19890,212,67,868,1728,21.2,1784.8,6,9,8,1,1,0,0,16980,7.2,18162,216,56,-868,-1728,21.6,1698,red,2.83,1.56,17,19,blue
4522069049,2,4,1,1,0,1,0,15448,7,18033,215,63,209,1023,21.5,1544.8,4,2,4,0,0,0,0,15239,6.8,17010,224,43,-209,-1023,22.4,1523.9,red,0.75,4,13,52,red
4506343146,5,6,7,1,1,0,0,15425,7,17540,208,51,-1611,-1931,20.8,1542.5,6,5,6,0,0,0,0,17036,7.4,19471,246,56,1611,1931,24.6,1703.6,red,2,2.4,21,22,blue
4524784453,5,3,10,1,1,0,0,15717,7,17819,211,59,385,-71,21.1,1571.7,3,5,3,0,0,0,0,15332,7,17890,231,61,-385,71,23.1,1533.2,blue,5,1.2,21,22,blue
4515728718,5,8,1,0,0,0,0,14589,6,15373,195,48,-3750,-4961,19.5,1458.9,8,5,14,1,1,0,0,18339,7.4,20334,229,59,3750,4961,22.9,1833.9,red,0.75,4.4,11,68,red
4522867814,4,5,5,0,0,0,0,15463,7.2,18378,215,60,25,327,21.5,1546.3,5,4,5,0,0,0,0,15438,7,18051,215,44,-25,-327,21.5,1543.8,blue,1.8,2.5,32,57,blue
4520872847,7,8,7,1,1,0,0,16019,6.6,16667,174,50,-388,-619,17.4,1601.9,8,7,8,0,0,0,0,16407,6.8,17286,207,45,388,619,20.7,1640.7,red,1.75,2.29,20,21,red
4475474933,8,4,7,0,0,0,1,17634,6.8,17330,219,45,1930,425,21.9,1763.4,4,8,5,0,0,0,0,15704,6.4,16905,226,46,-1930,-425,22.6,1570.4,blue,3.75,1.12,18,18,blue
4461308775,8,8,12,0,0,0,0,16017,6.2,15395,157,40,517,-593,15.7,1601.7,8,8,7,0,0,0,0,15500,6.4,15988,170,44,-517,593,17,1550,red,2.5,1.88,54,20,blue
4523110333,6,7,10,2,1,1,0,17259,7,19074,236,67,-214,1004,23.6,1725.9,7,6,8,0,0,0,0,17473,7,18070,225,46,214,-1004,22.5,1747.3,blue,2.29,2.5,22,87,blue
4497616954,5,2,3,1,1,0,0,16226,7,18917,250,56,2229,2851,25,1622.6,2,5,2,0,0,0,0,13997,6.4,16066,197,40,-2229,-2851,19.7,1399.7,blue,4,0.8,17,18,red
4495106153,10,4,11,2,1,1,0,17816,6.8,18684,202,58,1953,1494,20.2,1781.6,4,10,6,0,0,0,0,15863,7,17190,224,41,-1953,-1494,22.4,1586.3,red,5.25,1,17,21,blue
4493209584,4,6,3,0,0,0,0,15532,6.8,18026,210,64,-781,-1296,21,1553.2,6,4,4,2,1,1,0,16313,7.2,19322,220,58,781,1296,22,1631.3,red,1.17,2.5,17,23,red
4451574648,7,7,9,0,0,0,0,16946,6.8,17971,217,55,380,1750,21.7,1694.6,7,7,10,2,1,1,0,16566,6.6,16221,230,36,-380,-1750,23,1656.6,blue,2.29,2.43,24,17,red
4458825692,5,6,4,0,0,0,0,16019,6.8,18530,222,48,-758,733,22.2,1601.9,6,5,7,0,0,0,0,16777,7,17797,215,56,758,-733,21.5,1677.7,red,1.5,2.6,46,25,red
4522541214,8,4,8,0,0,0,0,17938,7.2,18237,232,48,3072,1589,23.2,1793.8,4,8,4,1,1,0,0,14866,6.8,16648,207,42,-3072,-1589,20.7,1486.6,blue,4,1,17,17,red
4520755410,9,6,10,1,0,1,0,17512,7,18140,186,51,2549,1269,18.6,1751.2,6,9,6,1,1,0,0,14963,6.6,16871,174,41,-2549,-1269,17.4,1496.3,blue,3.17,1.33,19,17,red
4412400770,8,5,7,2,1,1,0,16712,6.8,17310,208,41,2427,2303,20.8,1671.2,5,8,7,0,0,0,0,14285,6.4,15007,172,33,-2427,-2303,17.2,1428.5,blue,3,1.5,39,14,blue
4515729442,5,6,7,1,0,1,0,15913,6.8,17592,202,41,-844,-689,20.2,1591.3,6,5,3,1,1,0,0,16757,7.2,18281,247,56,844,689,24.7,1675.7,red,2,1.8,20,19,red
4522847421,6,9,6,1,1,0,0,17108,6.8,17877,211,59,-1394,-2258,21.1,1710.8,9,6,10,0,0,0,0,18502,7.6,20135,210,67,1394,2258,21,1850.2,red,1.33,3.17,12,18,blue
4460552380,16,9,11,2,1,1,3,23349,7.6,21214,223,52,7128,6117,22.3,2334.9,9,16,13,0,0,0,0,16221,6.2,15097,140,40,-7128,-6117,14,1622.1,blue,3,1.38,10,11,blue
4523704801,5,5,3,2,1,1,0,15548,7.4,18820,229,56,-826,38,22.9,1554.8,5,5,6,0,0,0,0,16374,7.2,18782,225,66,826,-38,22.5,1637.4,red,1.6,2.2,38,30,blue
4503847672,5,2,5,1,1,0,0,15950,7,18633,247,44,1233,251,24.7,1595,2,5,2,0,0,0,0,14717,6.8,18382,204,60,-1233,-251,20.4,1471.7,red,5,0.8,19,16,red
4515347067,5,2,3,1,0,1,0,16014,7,18969,225,58,476,467,22.5,1601.4,2,5,1,0,0,0,0,15538,7.2,18502,257,53,-476,-467,25.7,1553.8,blue,4,0.6,60,27,blue
4524296354,9,15,8,1,1,0,0,17419,7,17316,178,46,-2587,-1470,17.8,1741.9,15,9,23,0,0,0,0,20006,7.2,18786,214,50,2587,1470,21.4,2000.6,red,1.13,4.22,14,18,red
4522594325,11,5,13,0,0,0,1,19979,7.2,18500,207,39,3763,874,20.7,1997.9,5,11,6,0,0,0,0,16216,7,17626,194,51,-3763,-874,19.4,1621.6,red,4.8,1,15,12,blue
4519482984,3,8,2,1,1,0,0,14122,6.6,15708,188,40,-2968,-2159,18.8,1412.2,8,3,7,0,0,0,0,17090,7,17867,182,47,2968,2159,18.2,1709,red,0.62,5,21,23,red
4419611773,10,11,13,0,0,0,0,17447,6.4,16191,173,38,-384,-1658,17.3,1744.7,11,10,9,0,0,0,0,17831,7,17849,208,40,384,1658,20.8,1783.1,blue,2.09,2,20,13,blue
4486088051,7,8,9,0,0,0,0,16122,6.8,17858,196,39,-1673,-327,19.6,1612.2,8,7,8,0,0,0,0,17795,7,18185,231,52,1673,327,23.1,1779.5,red,2,2.29,17,17,red
4520582438,12,11,12,0,0,0,0,18336,7,17626,179,55,-466,-26,17.9,1833.6,11,12,19,0,0,0,0,18802,6.6,17652,211,32,466,26,21.1,1880.2,red,2.18,2.5,29,17,blue
4460718392,0,12,0,0,0,0,0,12002,6,13961,151,44,-8461,-7340,15.1,1200.2,12,0,9,0,0,0,1,20463,7.8,21301,238,52,8461,7340,23.8,2046.3,red,0,12.65,14,61,red
4515532917,3,5,5,0,0,0,0,14378,6.4,16230,209,39,-3682,-3599,20.9,1437.8,5,3,2,2,1,1,1,18060,7.4,19829,245,66,3682,3599,24.5,1806,red,1.6,2.33,21,17,blue
4517065551,8,4,18,0,0,0,0,17691,7,18548,222,60,3544,2399,22.2,1769.1,4,8,4,0,0,0,0,14147,6.4,16149,184,44,-3544,-2399,18.4,1414.7,red,6.5,1,20,17,blue
4456760342,15,11,13,0,0,0,0,19402,7.2,18717,195,39,2008,2566,19.5,1940.2,11,15,12,0,0,0,0,17394,6.4,16151,180,44,-2008,-2566,18,1739.4,blue,2.55,1.53,17,17,blue
4509027219,3,1,3,0,0,0,0,16468,6.8,18574,249,54,3100,1653,24.9,1646.8,1,3,0,0,0,0,0,13368,6.6,16921,192,41,-3100,-1653,19.2,1336.8,blue,6,0.33,25,21,blue
4477292734,2,11,5,0,0,0,0,14486,6.4,15896,207,51,-3576,-3516,20.7,1448.6,11,2,11,1,0,1,0,18062,7.2,19412,205,56,3576,3516,20.5,1806.2,red,0.64,11,18,91,red
4524977658,9,8,9,0,0,0,0,17652,7.4,18869,225,50,775,1702,22.5,1765.2,8,9,3,1,0,1,0,16877,6.6,17167,210,44,-775,-1702,21,1687.7,blue,2.25,1.22,18,19,red
4517802077,7,3,12,1,1,0,0,15494,6.6,15724,165,38,1515,857,16.5,1549.4,3,7,2,0,0,0,0,13979,6.4,14867,186,49,-1515,-857,18.6,1397.9,blue,6.33,0.71,24,18,blue
4524921739,6,8,11,0,0,0,0,16270,6.8,17661,200,54,-82,117,20,1627,8,6,4,1,1,0,0,16352,6.8,17544,221,37,82,-117,22.1,1635.2,red,2.12,2,18,18,blue
4488211195,5,6,3,0,0,0,0,15899,6.8,17722,232,47,-903,-1584,23.2,1589.9,6,5,7,1,1,0,0,16802,7.2,19306,249,45,903,1584,24.9,1680.2,red,1.33,2.6,18,38,blue
4516790351,3,12,3,0,0,0,0,14277,7,17550,201,53,-5802,-3559,20.1,1427.7,12,3,9,1,1,0,0,20079,7.6,21109,240,58,5802,3559,24,2007.9,red,0.5,7,40,16,red
4480798079,5,6,4,0,0,0,1,17350,7.2,18857,202,72,1492,1607,20.2,1735,6,5,9,1,1,0,0,15858,7,17250,191,44,-1492,-1607,19.1,1585.8,blue,1.5,3,22,22,red
4501459269,8,9,15,0,0,0,0,18315,7,18534,209,51,246,1266,20.9,1831.5,9,8,8,1,1,0,0,18069,6.8,17268,208,46,-246,-1266,20.8,1806.9,blue,2.56,2.12,17,17,blue
4450382504,9,2,13,0,0,0,0,19570,7.8,21203,259,74,4826,4472,25.9,1957,2,9,4,1,1,0,0,14744,6.6,16731,229,52,-4826,-4472,22.9,1474.4,blue,11,0.67,39,20,blue
4513212030,6,5,5,0,0,0,1,16529,6.8,16649,198,52,1085,775,19.8,1652.9,5,6,8,1,1,0,0,15444,6.4,15874,179,55,-1085,-775,17.9,1544.4,blue,2.2,2.17,19,20,blue
4489614649,11,5,18,1,1,0,0,18324,7,18016,205,47,2158,640,20.5,1832.4,5,11,8,0,0,0,0,16166,7,17376,219,45,-2158,-640,21.9,1616.6,blue,5.8,1.18,16,17,blue
4521052403,8,3,6,0,0,0,0,17263,7.2,19913,234,65,3181,3298,23.4,1726.3,3,8,3,2,1,1,0,14082,6.8,16615,159,51,-3181,-3298,15.9,1408.2,blue,4.67,0.75,16,13,blue
4523640765,4,0,3,1,1,0,0,15282,6.8,17848,211,45,1629,677,21.1,1528.2,0,4,0,0,0,0,0,13653,6.8,17171,246,44,-1629,-677,24.6,1365.3,blue,12.03,0,17,38,blue
4513528910,5,4,4,0,0,0,0,15960,7.2,18478,232,64,782,1903,23.2,1596,4,5,5,1,1,0,0,15178,6.4,16575,211,43,-782,-1903,21.1,1517.8,red,2.25,1.8,25,20,red
4492726394,5,5,5,1,1,0,0,15103,6.6,17162,198,39,-1328,-317,19.8,1510.3,5,5,7,1,0,1,0,16431,7,17479,227,36,1328,317,22.7,1643.1,red,2,2.4,17,20,blue
4523578015,7,3,6,0,0,0,0,16060,7,18431,228,44,794,577,22.8,1606,3,7,4,0,0,0,0,15266,7,17854,213,44,-794,-577,21.3,1526.6,blue,4.33,1,15,17,red
4452428266,7,9,6,0,0,0,0,15463,6.8,17772,162,44,-2809,-1673,16.2,1546.3,9,7,7,1,1,0,0,18272,7.2,19445,219,68,2809,1673,21.9,1827.2,red,1.44,2.29,17,36,red
4463284489,6,10,7,0,0,0,1,17225,6.6,16572,210,44,-833,-1786,21,1722.5,10,6,10,1,0,1,0,18058,7,18358,220,53,833,1786,22,1805.8,red,1.3,3.33,27,64,red
4458619259,3,9,2,0,0,0,0,14861,6.8,16993,225,38,-3337,-1701,22.5,1486.1,9,3,10,0,0,0,0,18198,7.2,18694,223,51,3337,1701,22.3,1819.8,red,0.56,6.33,19,33,red
4515561021,4,1,10,1,1,0,0,15966,7.2,18955,229,59,1532,1453,22.9,1596.6,1,4,1,0,0,0,0,14434,7.2,17502,229,60,-1532,-1453,22.9,1443.4,blue,14,0.5,52,68,red
4495044262,4,6,2,0,0,0,0,15172,7,18276,205,55,-1066,10,20.5,1517.2,6,4,7,1,1,0,0,16238,6.8,18266,241,36,1066,-10,24.1,1623.8,red,1,3.25,17,17,blue
4519411213,4,7,4,0,0,0,0,15953,6.8,17960,260,44,-477,-513,26,1595.3,7,4,9,0,0,0,0,16430,7,18473,234,40,477,513,23.4,1643,blue,1.14,4,17,16,red
4497452633,9,5,7,0,0,0,0,17959,7.6,20494,239,56,1696,2266,23.9,1795.9,5,9,3,1,1,0,0,16263,6.8,18228,225,56,-1696,-2266,22.5,1626.3,blue,3.2,0.89,21,24,red
4494493149,7,2,11,2,1,1,0,17176,7,18575,200,62,2889,1215,20,1717.6,2,7,2,0,0,0,0,14287,6.8,17360,217,58,-2889,-1215,21.7,1428.7,blue,9,0.57,20,19,blue
4448082269,8,4,7,1,0,1,0,17328,7,18867,234,56,2156,3157,23.4,1732.8,4,8,8,0,0,0,0,15172,6.2,15710,225,35,-2156,-3157,22.5,1517.2,blue,3.75,1.5,22,23,blue
4463495962,2,6,3,0,0,0,0,15144,7.2,17995,236,52,-1281,-602,23.6,1514.4,6,2,10,0,0,0,0,16425,7.2,18597,219,44,1281,602,21.9,1642.5,red,0.83,8,18,17,red
4519833399,6,6,4,1,0,1,0,16533,7,18187,217,61,85,765,21.7,1653.3,6,6,9,0,0,0,0,16448,6.8,17422,214,46,-85,-765,21.4,1644.8,red,1.67,2.5,18,16,red
4524511499,11,8,9,0,0,0,0,18475,7.4,19732,196,47,1761,1895,19.6,1847.5,8,11,9,1,1,0,0,16714,6.8,17837,196,52,-1761,-1895,19.6,1671.4,red,2.5,1.55,25,22,blue
4521689217,3,7,2,1,1,0,0,15252,7,18024,224,56,-1293,-380,22.4,1525.2,7,3,8,0,0,0,0,16545,7,18404,219,48,1293,380,21.9,1654.5,red,0.71,5,18,41,red
4518710301,4,9,1,0,0,0,0,14621,7,17862,179,62,-3644,-1277,17.9,1462.1,9,4,12,1,1,0,0,18265,7,19139,243,44,3644,1277,24.3,1826.5,blue,0.56,5.25,39,15,red
4442576553,6,8,7,0,0,0,0,15953,6.6,17372,221,29,-1095,-249,22.1,1595.3,8,6,8,1,1,0,0,17048,6.8,17621,218,52,1095,249,21.8,1704.8,red,1.62,2.67,16,19,red
4511383179,5,2,5,2,1,1,0,16627,6.8,18676,223,50,2359,1681,22.3,1662.7,2,5,3,0,0,0,0,14268,6.6,16995,221,45,-2359,-1681,22.1,1426.8,blue,5,1,18,17,blue
4524666891,8,8,4,0,0,0,0,17240,7,18845,248,48,699,944,24.8,1724,8,8,6,1,1,0,0,16541,6.8,17901,179,57,-699,-944,17.9,1654.1,blue,1.5,1.75,19,20,blue
4468778049,5,2,4,0,0,0,0,15796,7,18152,221,58,453,1426,22.1,1579.6,2,5,4,1,1,0,0,15343,6.4,16726,256,55,-453,-1426,25.6,1534.3,red,4.5,1.2,27,19,red
4499825635,8,2,10,0,0,0,0,18330,7.4,19257,232,52,1769,319,23.2,1833,2,8,1,2,1,1,1,16561,7.2,18938,251,67,-1769,-319,25.1,1656.1,blue,9,0.38,16,39,blue
4506847154,6,7,8,1,1,0,0,15684,6.6,17219,202,39,-3240,-2396,20.2,1568.4,7,6,8,1,0,1,1,18924,7,19615,257,60,3240,2396,25.7,1892.4,red,2,2.5,11,17,blue
4523524261,7,4,3,1,1,0,0,17120,6.8,18300,233,59,1936,1098,23.3,1712,4,7,4,0,0,0,0,15184,6.8,17202,206,50,-1936,-1098,20.6,1518.4,blue,2.5,1.14,21,16,blue
4522806079,4,5,2,1,1,0,0,15261,6.6,17058,233,46,-393,-1504,23.3,1526.1,5,4,5,0,0,0,0,15654,7.2,18562,208,52,393,1504,20.8,1565.4,blue,1.2,2.5,22,22,blue
4519495727,11,8,17,1,0,1,0,18053,6.6,17357,189,47,620,339,18.9,1805.3,8,11,10,0,0,0,0,17433,6.4,17018,196,38,-620,-339,19.6,1743.3,red,3.5,1.64,20,20,red
4522215186,3,6,3,1,0,1,0,15417,6.8,16990,224,56,-691,-666,22.4,1541.7,6,3,11,1,1,0,0,16108,6.8,17656,213,48,691,666,21.3,1610.8,red,1,5.67,23,21,blue
4520027447,8,5,5,1,1,0,0,16523,7.2,18718,193,56,1357,614,19.3,1652.3,5,8,2,0,0,0,0,15166,6.8,18104,208,52,-1357,-614,20.8,1516.6,blue,2.6,0.88,17,19,blue
4522000980,8,8,6,1,1,0,0,16809,7,18470,210,44,-12,-151,21,1680.9,8,8,6,0,0,0,0,16821,7.2,18621,221,48,12,151,22.1,1682.1,red,1.75,1.75,14,15,blue
4492308589,5,8,6,0,0,0,0,15627,6.8,17457,199,56,-2690,-3245,19.9,1562.7,8,5,9,2,1,1,0,18317,7.6,20702,230,92,2690,3245,23,1831.7,red,1.38,3.4,20,59,blue
4496489619,0,3,0,1,0,1,0,13793,6.8,17022,223,58,-2240,-1623,22.3,1379.3,3,0,1,1,1,0,0,16033,7,18645,247,59,2240,1623,24.7,1603.3,red,0,12.65,42,16,red
4512335811,3,8,4,0,0,0,0,14481,6.4,15768,214,40,-2765,-2274,21.4,1448.1,8,3,16,2,1,1,0,17246,7.2,18042,226,51,2765,2274,22.6,1724.6,blue,0.88,8,18,19,blue
4510973023,8,4,11,1,1,0,0,16357,6.6,17543,196,48,-82,280,19.6,1635.7,4,8,4,0,0,0,0,16439,6.8,17263,241,45,82,-280,24.1,1643.9,red,4.75,1,18,13,blue
4524364516,10,6,11,0,0,0,0,18582,7.4,19549,222,51,2230,2112,22.2,1858.2,6,10,8,1,0,1,0,16352,6.8,17437,196,43,-2230,-2112,19.6,1635.2,blue,3.5,1.4,49,59,red
4519092330,1,3,1,0,0,0,0,13943,6.8,17418,235,37,-1661,-1064,23.5,1394.3,3,1,2,0,0,0,0,15604,7,18482,241,48,1661,1064,24.1,1560.4,red,0.67,5,16,14,red
4451399633,10,7,8,0,0,0,0,18410,7.2,19835,241,54,1720,1364,24.1,1841,7,10,6,0,0,0,0,16690,7.4,18471,212,46,-1720,-1364,21.2,1669,red,2.57,1.3,20,22,blue
4451665703,6,7,6,0,0,0,0,16689,7,18369,240,50,211,880,24,1668.9,7,6,7,0,0,0,0,16478,7,17489,214,41,-211,-880,21.4,1647.8,red,1.71,2.33,27,21,red
4524651202,6,7,4,0,0,0,0,16060,6.4,16764,200,60,-27,-1847,20,1606,7,6,7,1,1,0,0,16087,7,18611,194,53,27,1847,19.4,1608.7,red,1.43,2.33,17,90,blue
4522844464,3,12,4,0,0,0,0,14035,6.2,14801,185,32,-5142,-3023,18.5,1403.5,12,3,14,1,1,0,0,19177,7,17824,210,55,5142,3023,21,1917.7,red,0.58,8.67,19,23,red
4513558845,9,6,10,2,1,1,0,17757,7,18305,218,48,1818,1761,21.8,1775.7,6,9,7,0,0,0,0,15939,6.8,16544,204,50,-1818,-1761,20.4,1593.9,blue,3.17,1.44,19,22,blue
4515275420,2,9,3,0,0,0,0,14267,6.6,16538,204,43,-5571,-3921,20.4,1426.7,9,2,10,2,1,1,1,19838,7.6,20459,268,56,5571,3921,26.8,1983.8,red,0.56,9.5,21,20,red
4475523215,6,12,6,0,0,0,0,15951,6.6,16512,223,40,-1734,-3696,22.3,1595.1,12,6,5,2,1,1,0,17685,7.6,20208,221,44,1734,3696,22.1,1768.5,red,1,2.83,13,19,red
4521065168,8,8,4,0,0,0,0,16688,6.8,17926,216,44,704,-123,21.6,1668.8,8,8,4,1,1,0,0,15984,7.2,18049,190,56,-704,123,19,1598.4,red,1.5,1.5,16,16,blue
4470051820,3,5,2,2,1,1,0,14303,6.2,15787,187,58,-2657,-2095,18.7,1430.3,5,3,6,0,0,0,0,16960,7,17882,237,51,2657,2095,23.7,1696,red,1,3.67,24,23,red
4494489796,9,8,12,1,1,0,0,17396,7,17804,205,48,-377,842,20.5,1739.6,8,9,10,1,0,1,0,17773,6.6,16962,223,40,377,-842,22.3,1777.3,blue,2.62,2,44,23,blue
4486075079,9,3,9,1,0,1,0,18159,7.4,19769,245,52,3037,2677,24.5,1815.9,3,9,4,1,1,0,0,15122,6.6,17092,213,50,-3037,-2677,21.3,1512.2,blue,6,0.78,18,24,blue
4500599044,7,5,8,1,0,1,0,16269,7.2,18306,202,52,459,1388,20.2,1626.9,5,7,8,1,1,0,0,15810,6.6,16918,212,44,-459,-1388,21.2,1581,red,3,1.86,92,18,red
4513621339,4,9,5,1,1,0,0,15316,6.6,17118,198,52,-2986,-3369,19.8,1531.6,9,4,3,0,0,0,0,18302,7.4,20487,247,64,2986,3369,24.7,1830.2,blue,1,3,42,22,blue
4511067925,5,4,4,1,1,0,0,16498,6.8,17738,237,45,1699,638,23.7,1649.8,4,5,3,0,0,0,0,14799,6.8,17100,202,46,-1699,-638,20.2,1479.9,blue,2.25,1.4,22,18,blue
4518516978,16,0,17,1,1,0,0,20603,7.4,20443,245,44,7873,5225,24.5,2060.3,0,16,0,0,0,0,0,12730,6.6,15218,188,44,-7873,-5225,18.8,1273,blue,12.03,0,17,13,blue
4495223559,10,7,7,1,0,1,1,19606,7.2,18619,220,45,3534,2345,22,1960.6,7,10,8,1,1,0,0,16072,6.6,16274,170,60,-3534,-2345,17,1607.2,blue,2.43,1.5,20,18,red
4497502064,7,8,6,1,0,1,0,16940,6.8,17305,234,42,400,-213,23.4,1694,8,7,10,1,1,0,0,16540,6.8,17518,222,52,-400,213,22.2,1654,blue,1.62,2.57,16,17,blue
4525161056,6,4,11,0,0,0,0,16814,7,18612,238,56,2247,1262,23.8,1681.4,4,6,0,1,1,0,0,14567,6.8,17350,220,55,-2247,-1262,22,1456.7,blue,4.25,0.67,44,16,red
4440235143,9,8,13,1,0,1,0,18146,6.6,17263,199,40,383,-1655,19.9,1814.6,8,9,10,0,0,0,0,17763,7.4,18918,201,60,-383,1655,20.1,1776.3,blue,2.75,2,18,21,blue
4475781870,3,5,3,0,0,0,0,15242,7.2,17856,216,44,-774,334,21.6,1524.2,5,3,4,0,0,0,0,16016,6.8,17522,243,45,774,-334,24.3,1601.6,red,1.2,3,23,33,red
4522642562,10,7,5,1,1,0,0,17454,6.8,18029,204,58,617,128,20.4,1745.4,7,10,5,0,0,0,0,16837,6.8,17901,178,60,-617,-128,17.8,1683.7,red,2.14,1.2,19,13,blue
4522609707,5,3,6,1,1,0,0,16053,7,17817,227,52,1614,1179,22.7,1605.3,3,5,4,0,0,0,0,14439,6.6,16638,206,50,-1614,-1179,20.6,1443.9,red,3.67,1.4,21,57,blue
4472387660,2,9,1,0,0,0,0,14975,6.4,16649,222,67,-2206,-2548,22.2,1497.5,9,2,12,1,1,0,0,17181,7.4,19197,216,48,2206,2548,21.6,1718.1,blue,0.33,10.5,19,21,blue
4491631842,4,4,4,1,1,0,0,16095,7,18669,241,65,-262,-375,24.1,1609.5,4,4,2,0,0,0,0,16357,7.2,19044,257,55,262,375,25.7,1635.7,blue,2,1.5,36,27,blue
4519602935,8,5,11,0,0,0,0,17123,6.8,17944,223,52,1012,-620,22.3,1712.3,5,8,3,0,0,0,0,16111,7.4,18564,220,52,-1012,620,22,1611.1,blue,3.8,1,40,33,red
4519875448,6,5,14,1,1,0,0,16986,7,17323,231,55,313,-1776,23.1,1698.6,5,6,3,1,0,1,0,16673,7.2,19099,236,56,-313,1776,23.6,1667.3,red,4,1.33,26,24,blue
4524499414,3,3,3,0,0,0,0,14731,7,17886,204,52,-1148,708,20.4,1473.1,3,3,4,1,1,0,0,15879,6.8,17178,237,52,1148,-708,23.7,1587.9,red,2,2.33,19,22,red
4510716037,8,3,9,1,1,0,0,17316,7.2,18689,227,68,3172,2797,22.7,1731.6,3,8,4,0,0,0,0,14144,6.2,15892,200,40,-3172,-2797,20,1414.4,blue,5.67,0.88,45,15,blue
4520805255,1,3,2,0,0,0,0,14889,6.8,17345,256,48,-819,-1709,25.6,1488.9,3,1,4,0,0,0,0,15708,7,19054,246,62,819,1709,24.6,1570.8,blue,1,7,17,24,red
4457344340,5,6,4,1,0,1,0,16416,6.8,18647,253,44,-205,-41,25.3,1641.6,6,5,7,1,1,0,0,16621,7,18688,239,40,205,41,23.9,1662.1,red,1.5,2.6,21,16,red
4464852917,7,11,10,0,0,0,0,16943,6.8,17177,215,52,-1228,-1785,21.5,1694.3,11,7,11,1,1,0,0,18171,7.4,18962,217,56,1228,1785,21.7,1817.1,blue,1.55,3.14,19,45,red
4493888202,13,3,13,1,0,1,1,19940,7.4,20030,192,52,5521,4435,19.2,1994,3,13,2,0,0,0,0,14419,6.6,15595,212,31,-5521,-4435,21.2,1441.9,blue,8.67,0.38,14,19,blue
4523258909,8,7,5,0,0,0,0,16204,6.6,17473,184,47,-1016,-1306,18.4,1620.4,7,8,7,1,1,0,0,17220,7,18779,210,51,1016,1306,21,1722,red,1.86,1.75,60,21,blue
4474379367,7,10,7,1,1,0,0,17062,7.2,18221,220,50,-1246,150,22,1706.2,10,7,12,0,0,0,0,18308,6.8,18071,203,58,1246,-150,20.3,1830.8,blue,1.4,3.14,15,19,blue
4384388180,6,5,6,0,0,0,0,15691,7,17592,212,48,456,-69,21.2,1569.1,5,6,3,2,1,1,0,15235,6.8,17661,192,52,-456,69,19.2,1523.5,red,2.4,1.33,18,14,red
4420435152,1,11,0,0,0,0,0,13511,6.6,16013,200,46,-5087,-2795,20,1351.1,11,1,18,0,0,0,0,18598,7.2,18808,226,55,5087,2795,22.6,1859.8,red,0.09,29,14,117,red
4520494989,12,2,11,0,0,0,0,18927,7.4,19861,231,44,4006,3678,23.1,1892.7,2,12,2,0,0,0,0,14921,6.4,16183,176,60,-4006,-3678,17.6,1492.1,blue,11.5,0.33,19,18,blue
4502261943,7,6,10,1,1,0,0,16164,7,17989,196,48,-876,-1141,19.6,1616.4,6,7,4,0,0,0,0,17040,7,19130,239,60,876,1141,23.9,1704,blue,2.83,1.43,48,25,red
4482157138,4,4,8,0,0,0,0,15572,6.8,17404,221,48,-1216,-1810,22.1,1557.2,4,4,3,0,0,0,0,16788,7.4,19214,256,57,1216,1810,25.6,1678.8,blue,3,1.75,16,18,blue
4500380908,5,7,2,1,0,1,1,17469,6.6,17964,229,53,1432,-889,22.9,1746.9,7,5,6,1,1,0,0,16037,7.2,18853,203,64,-1432,889,20.3,1603.7,red,1,2.6,15,16,blue
4474827626,3,10,4,1,1,0,0,14686,7,17582,206,60,-3593,-3240,20.6,1468.6,10,3,5,0,0,0,0,18279,7.6,20822,226,68,3593,3240,22.6,1827.9,blue,0.7,5,19,27,red
4523279887,8,6,10,0,0,0,0,16325,6.8,17831,193,40,2,-345,19.3,1632.5,6,8,4,1,1,0,0,16323,7,18176,227,48,-2,345,22.7,1632.3,red,3,1.25,19,25,red
4512324600,9,4,12,1,1,0,0,17233,6.8,17651,202,48,2034,884,20.2,1723.3,4,9,4,0,0,0,0,15199,6.6,16767,200,48,-2034,-884,20,1519.9,blue,5.25,0.89,17,15,red
4497085879,3,8,4,0,0,0,0,16004,7.2,18128,241,64,-966,-455,24.1,1600.4,8,3,9,0,0,0,0,16970,7.2,18583,213,48,966,455,21.3,1697,red,0.88,5.67,19,16,red
4519793588,6,6,9,0,0,0,0,16651,6.6,16985,218,48,1167,-461,21.8,1665.1,6,6,4,1,1,0,0,15484,6.8,17446,207,48,-1167,461,20.7,1548.4,blue,2.5,1.67,17,20,blue
4524625875,2,6,2,0,0,0,0,14959,7,17503,229,48,-2128,-1289,22.9,1495.9,6,2,7,1,1,0,0,17087,7.2,18792,219,51,2128,1289,21.9,1708.7,blue,0.67,6.5,45,89,blue
4459239621,5,10,4,0,0,0,0,15917,6.8,17246,200,60,-1971,-2626,20,1591.7,10,5,13,2,1,1,0,17888,7.2,19872,200,56,1971,2626,20,1788.8,red,0.9,4.6,18,18,blue
4494773072,6,6,9,0,0,0,0,15754,6.6,16844,198,36,-708,-1311,19.8,1575.4,6,6,5,0,0,0,0,16462,7,18155,207,36,708,1311,20.7,1646.2,blue,2.5,1.83,52,107,red
4524193415,8,8,9,1,1,0,0,16891,7,17845,201,51,-1296,4,20.1,1689.1,8,8,9,0,0,0,0,18187,7,17841,217,48,1296,-4,21.7,1818.7,red,2.12,2.12,19,18,blue
4500741087,3,15,3,0,0,0,0,14878,6.6,16826,197,61,-5924,-3368,19.7,1487.8,15,3,20,2,1,1,0,20802,7.2,20194,226,64,5924,3368,22.6,2080.2,red,0.4,11.67,21,22,red
4496705148,7,3,7,0,0,0,0,17150,7.2,19389,225,60,1443,2143,22.5,1715,3,7,5,0,0,0,0,15707,6.8,17246,229,44,-1443,-2143,22.9,1570.7,blue,4.67,1.14,21,19,blue
4525183626,5,4,6,1,1,0,0,15941,7,17661,236,55,-2,-1484,23.6,1594.1,4,5,2,0,0,0,0,15943,7.2,19145,237,67,2,1484,23.7,1594.3,red,2.75,1.2,18,32,blue
4520035137,7,3,11,0,0,0,0,17802,7.4,19422,239,40,1070,1731,23.9,1780.2,3,7,3,1,0,1,1,16732,7,17691,211,64,-1070,-1731,21.1,1673.2,blue,6,0.86,17,16,blue
4521969261,5,6,4,1,1,0,0,15548,7,18653,181,68,-1238,-1708,18.1,1554.8,6,5,5,0,0,0,0,16786,7.4,20361,219,60,1238,1708,21.9,1678.6,blue,1.5,2.2,11,18,blue
4523582436,5,2,6,0,0,0,0,15556,7,17886,219,44,1300,1228,21.9,1555.6,2,5,3,0,0,0,0,14256,6.6,16658,218,44,-1300,-1228,21.8,1425.6,blue,5.5,1,17,19,red
4489642674,6,5,6,1,1,0,0,16098,6.8,18103,209,50,-282,-192,20.9,1609.8,5,6,5,1,0,1,0,16380,7,18295,224,62,282,192,22.4,1638,blue,2.4,1.67,42,20,blue
4513950311,6,5,6,1,0,1,0,16107,7,17538,213,56,-456,-1135,21.3,1610.7,5,6,5,1,1,0,0,16563,7,18673,203,56,456,1135,20.3,1656.3,blue,2.4,1.67,15,15,red
4500662035,7,2,6,0,0,0,0,16315,7,18067,201,60,1167,510,20.1,1631.5,2,7,2,0,0,0,0,15148,6.8,17557,240,59,-1167,-510,24,1514.8,red,6.5,0.57,18,19,blue
4495660541,6,7,13,1,0,1,0,16587,6.6,16824,199,47,457,-383,19.9,1658.7,7,6,13,1,1,0,0,16130,6.8,17207,194,40,-457,383,19.4,1613,red,2.71,3.33,15,17,blue
4518544844,8,6,9,0,0,0,0,16112,6.6,16844,201,32,276,377,20.1,1611.2,6,8,7,1,1,0,0,15836,6.6,16467,167,57,-276,-377,16.7,1583.6,red,2.83,1.62,16,32,red
4465742706,10,2,12,2,1,1,0,18212,7.2,18905,196,54,4429,3004,19.6,1821.2,2,10,1,0,0,0,0,13783,6.6,15901,180,48,-4429,-3004,18,1378.3,blue,11,0.3,22,18,blue
4508293000,3,5,2,0,0,0,0,14761,7,17479,204,64,-907,414,20.4,1476.1,5,3,6,1,1,0,0,15668,6.6,17065,225,46,907,-414,22.5,1566.8,red,1,3.67,18,18,red
4519894439,5,5,5,1,1,0,0,17613,7.2,19706,251,76,914,1227,25.1,1761.3,5,5,7,0,0,0,0,16699,7,18479,224,50,-914,-1227,22.4,1669.9,red,2,2.4,42,20,blue
4516578815,8,5,13,0,0,0,0,16384,6.8,16954,218,37,-232,-1633,21.8,1638.4,5,8,3,0,0,0,0,16616,7.2,18587,242,72,232,1633,24.2,1661.6,red,4.2,1,46,13,blue
4451379938,6,6,3,0,0,0,0,17001,7.2,19154,230,68,344,1270,23,1700.1,6,6,5,0,0,0,0,16657,7,17884,255,32,-344,-1270,25.5,1665.7,blue,1.5,1.83,40,19,red
4467014828,4,9,3,0,0,0,0,15084,6.6,16366,211,44,-2904,-2819,21.1,1508.4,9,4,8,1,0,1,0,17988,7.2,19185,237,47,2904,2819,23.7,1798.8,red,0.78,4.25,122,20,blue
4511803387,8,8,5,0,0,0,0,16918,6.8,18396,216,60,355,-336,21.6,1691.8,8,8,6,1,1,0,0,16563,6.8,18732,214,44,-355,336,21.4,1656.3,blue,1.62,1.75,19,20,red
4525196496,9,8,13,0,0,0,0,18562,7,18633,203,66,1911,1969,20.3,1856.2,8,9,12,1,1,0,0,16651,6.6,16664,206,48,-1911,-1969,20.6,1665.1,blue,2.75,2.22,17,17,red
4519438725,5,6,9,1,1,0,0,15822,7,17481,219,48,-1572,-2164,21.9,1582.2,6,5,3,1,0,1,0,17394,7.2,19645,248,56,1572,2164,24.8,1739.4,blue,2.33,1.8,11,25,blue
4455505854,9,4,10,1,1,0,0,17405,6.8,18506,187,46,1996,860,18.7,1740.5,4,9,3,0,0,0,0,15409,7,17646,236,40,-1996,-860,23.6,1540.9,red,4.75,0.78,47,25,blue
4517169026,11,5,12,2,1,1,1,19696,7.2,18881,222,48,3802,1762,22.2,1969.6,5,11,6,0,0,0,0,15894,6.8,17119,209,60,-3802,-1762,20.9,1589.4,blue,4.6,1,12,21,blue
4524820601,9,11,11,0,0,0,0,17322,6.4,16229,182,52,-956,-1451,18.2,1732.2,11,9,12,1,1,0,0,18278,6.8,17680,207,49,956,1451,20.7,1827.8,blue,1.82,2.56,12,15,blue
4521314116,4,2,4,0,0,0,0,15532,6.8,17669,227,47,240,131,22.7,1553.2,2,4,2,0,0,0,0,15292,6.8,17538,240,56,-240,-131,24,1529.2,blue,4,1,26,42,blue
4462579984,10,8,7,0,0,0,0,17823,6.6,17275,237,36,828,-79,23.7,1782.3,8,10,5,1,1,0,0,16995,6.8,17354,200,47,-828,79,20,1699.5,red,2.12,1.3,24,18,blue
4490139424,1,12,0,0,0,0,0,13291,6.4,15898,201,48,-5102,-3977,20.1,1329.1,12,1,18,2,1,1,0,18393,7.4,19875,227,52,5102,3977,22.7,1839.3,red,0.08,30,18,44,red
4486656023,7,11,7,0,0,0,0,16851,6.8,16674,216,42,-778,-752,21.6,1685.1,11,7,14,1,1,0,0,17629,6.8,17426,200,34,778,752,20,1762.9,blue,1.27,3.57,22,17,blue
4521058802,7,2,8,0,0,0,0,16830,7.2,18443,232,54,2431,1886,23.2,1683,2,7,2,0,0,0,0,14399,6.6,16557,209,48,-2431,-1886,20.9,1439.9,blue,7.5,0.57,21,32,blue
4521524486,5,5,7,0,0,0,0,16061,7,18238,210,60,530,1280,21,1606.1,5,5,5,0,0,0,0,15531,6.8,16958,204,44,-530,-1280,20.4,1553.1,blue,2.4,2,19,16,blue
4520613359,2,2,2,0,0,0,0,15608,6.8,17516,260,47,766,331,26,1560.8,2,2,2,0,0,0,0,14842,7,17185,229,52,-766,-331,22.9,1484.2,red,2,2,20,42,red
4515711372,5,9,3,0,0,0,0,15144,6.6,16696,205,36,-4172,-2185,20.5,1514.4,9,5,9,0,0,0,1,19316,7.2,18881,221,47,4172,2185,22.1,1931.6,red,0.89,3.6,15,19,blue
4524333896,7,6,7,0,0,0,0,15778,6.2,15796,213,19,-1578,-2563,21.3,1577.8,6,7,3,2,1,1,1,17356,7.2,18359,201,56,1578,2563,20.1,1735.6,red,2.33,1.29,17,14,red
4522651290,2,4,1,0,0,0,0,14721,7,18073,234,51,-964,72,23.4,1472.1,4,2,4,1,1,0,0,15685,7,18001,238,48,964,-72,23.8,1568.5,blue,0.75,4,18,19,red
4495074532,8,3,6,0,0,0,0,16154,7,18075,192,52,1764,1515,19.2,1615.4,3,8,2,2,1,1,0,14390,6.4,16560,210,44,-1764,-1515,21,1439,blue,4.67,0.62,35,39,red
4489770592,6,9,4,0,0,0,0,15136,7,18082,170,67,-3212,-786,17,1513.6,9,6,9,1,1,0,0,18348,7,18868,227,52,3212,786,22.7,1834.8,red,1.11,3,20,87,red
4506670762,2,4,3,0,0,0,0,14231,6.6,16339,201,56,-2259,-2256,20.1,1423.1,4,2,5,1,1,0,0,16490,7,18595,234,60,2259,2256,23.4,1649,red,1.25,4.5,11,17,blue
4525232628,4,2,4,1,0,1,0,16470,7.2,19232,232,59,1718,2947,23.2,1647,2,4,3,1,1,0,0,14752,6.6,16285,218,48,-1718,-2947,21.8,1475.2,blue,4,1.25,21,16,blue
4465441499,0,3,0,0,0,0,0,13674,6.8,17384,229,52,-1159,-157,22.9,1367.4,3,0,3,1,1,0,0,14833,6.8,17541,230,40,1159,157,23,1483.3,blue,0,12.65,23,20,red
4509106172,5,10,5,0,0,0,0,15251,6.4,16852,210,31,-3232,-2573,21,1525.1,10,5,13,2,1,1,0,18483,7.4,19425,215,80,3232,2573,21.5,1848.3,red,1,4.6,18,20,red
4423957236,11,5,14,1,0,1,0,18856,7.2,19227,231,51,3248,2152,23.1,1885.6,5,11,7,1,1,0,0,15608,6.6,17075,189,58,-3248,-2152,18.9,1560.8,blue,5,1.09,18,22,blue
4519008578,7,9,8,0,0,0,0,16274,6.8,17652,204,41,-1248,-843,20.4,1627.4,9,7,13,0,0,0,0,17522,7.2,18495,211,41,1248,843,21.1,1752.2,blue,1.67,3.14,70,15,blue
4500263204,7,8,5,1,0,1,0,17241,7,18072,242,48,-136,-583,24.2,1724.1,8,7,7,1,1,0,0,17377,7.4,18655,234,48,136,583,23.4,1737.7,red,1.5,2.14,19,20,red
4499779050,4,8,4,1,0,1,1,16201,6.4,15667,204,47,-468,-1886,20.4,1620.1,8,4,10,1,1,0,0,16669,6.8,17553,210,51,468,1886,21,1666.9,blue,1,4.5,19,22,blue
4496697436,5,10,6,0,0,0,0,15622,6.6,16556,200,43,-3909,-2136,20,1562.2,10,5,8,2,1,1,2,19531,7.2,18692,222,49,3909,2136,22.2,1953.1,red,1.1,3.6,16,20,red
4505788319,7,6,8,1,1,0,0,17575,6.4,17019,209,41,961,-973,20.9,1757.5,6,7,8,0,0,0,0,16614,7,17992,208,54,-961,973,20.8,1661.4,red,2.5,2,20,18,blue
4515397290,5,10,8,1,1,0,0,16408,7,18014,228,42,-2936,-1305,22.8,1640.8,10,5,17,0,0,0,0,19344,7,19319,232,68,2936,1305,23.2,1934.4,blue,1.3,5.4,22,20,red
4523083494,9,7,13,1,1,0,0,18073,7.4,19907,221,57,1766,1606,22.1,1807.3,7,9,11,1,0,1,0,16307,6.8,18301,198,48,-1766,-1606,19.8,1630.7,blue,3.14,2,18,41,blue
4512481936,4,9,4,0,0,0,0,15370,6.6,17168,200,72,-2929,-1515,20,1537,9,4,13,1,1,0,0,18299,7,18683,217,62,2929,1515,21.7,1829.9,blue,0.89,5.5,51,20,red
4511076108,2,4,1,0,0,0,0,14659,6.8,17566,235,45,-1944,-1062,23.5,1465.9,4,2,4,1,0,1,0,16603,7,18628,240,62,1944,1062,24,1660.3,red,0.75,4,22,17,blue
4516828940,11,5,10,0,0,0,1,18855,7,18139,180,44,3164,287,18,1885.5,5,11,1,1,1,0,0,15691,7,17852,206,64,-3164,-287,20.6,1569.1,red,4.2,0.55,19,18,red
4523465477,2,5,2,0,0,0,0,14695,6.8,16864,230,42,-1947,-2097,23,1469.5,5,2,6,1,1,0,0,16642,7.2,18961,255,54,1947,2097,25.5,1664.2,red,0.8,5.5,13,21,red
4494587066,6,7,7,1,0,1,1,17927,6.8,18100,213,45,396,-1813,21.3,1792.7,7,6,8,1,1,0,0,17531,7.4,19913,229,73,-396,1813,22.9,1753.1,red,1.86,2.5,15,38,red
4438792518,5,2,5,1,1,0,0,16326,7,18135,217,60,1697,293,21.7,1632.6,2,5,2,1,0,1,0,14629,6.6,17842,246,40,-1697,-293,24.6,1462.9,blue,5,0.8,19,12,blue
4512164291,12,4,13,1,1,0,0,18552,6.6,17072,207,44,4845,2789,20.7,1855.2,4,12,4,0,0,0,0,13707,6,14283,183,30,-4845,-2789,18.3,1370.7,blue,6.25,0.67,25,16,blue
4512772548,7,2,3,1,1,0,0,16669,7,18607,226,57,3370,4484,22.6,1666.9,2,7,2,0,0,0,0,13299,6,14123,194,28,-3370,-4484,19.4,1329.9,blue,5,0.57,44,17,red
4523386902,6,13,8,0,0,0,0,15304,6.4,15933,175,40,-5191,-3819,17.5,1530.4,13,6,15,0,0,0,0,20495,7.2,19752,229,49,5191,3819,22.9,2049.5,red,1.08,4.67,20,17,red
4524330916,5,6,6,0,0,0,0,15242,6.6,16792,198,45,-3024,-1285,19.8,1524.2,6,5,3,0,0,0,1,18266,7,18077,236,48,3024,1285,23.6,1826.6,red,1.83,1.8,24,43,red
4468287973,2,3,5,1,0,1,0,14237,6.6,17344,178,73,-2114,-1121,17.8,1423.7,3,2,5,1,1,0,0,16351,7,18465,248,64,2114,1121,24.8,1635.1,red,2.33,4,13,18,red
4516748968,3,9,4,0,0,0,0,14280,6.2,15054,190,45,-3555,-3207,19,1428,9,3,10,1,1,0,0,17835,7,18261,220,43,3555,3207,22,1783.5,red,0.78,6.33,29,16,blue
4523545639,9,8,15,0,0,0,0,18809,7,18415,225,39,2309,1211,22.5,1880.9,8,9,8,1,1,0,0,16500,7,17204,185,55,-2309,-1211,18.5,1650,blue,3,1.78,19,16,blue
4523121981,0,6,0,1,0,1,0,14238,6.8,16667,234,48,-2554,-2576,23.4,1423.8,6,0,11,0,0,0,0,16792,7,19243,225,52,2554,2576,22.5,1679.2,red,0,12.65,20,16,red
4517973662,4,5,5,1,1,0,0,15101,6.8,17275,205,53,-654,-97,20.5,1510.1,5,4,10,0,0,0,0,15755,7,17372,212,48,654,97,21.2,1575.5,red,1.8,3.75,21,18,blue
4519278767,8,1,11,1,0,1,0,18237,7.4,19105,221,57,4824,2940,22.1,1823.7,1,8,2,0,0,0,0,13413,6.4,16165,179,55,-4824,-2940,17.9,1341.3,blue,19,0.38,40,20,blue
4508876664,8,1,5,1,1,0,2,19820,7.2,19369,247,63,6883,5337,24.7,1982,1,8,1,1,0,1,0,12937,6,14032,179,37,-6883,-5337,17.9,1293.7,blue,13,0.25,19,14,blue
4494756316,9,8,9,1,1,0,0,16884,6.4,17197,193,55,-968,-3,19.3,1688.4,8,9,6,1,0,1,0,17852,6.8,17200,210,45,968,3,21,1785.2,red,2.25,1.56,17,20,red
4481806461,6,14,7,1,1,0,0,15880,6.6,16941,204,45,-4526,-2062,20.4,1588,14,6,23,0,0,0,0,20406,7,19003,201,49,4526,2062,20.1,2040.6,red,0.93,6.17,24,20,red
4510805663,4,9,3,0,0,0,0,15430,6.8,18275,240,53,-2850,-832,24,1543,9,4,7,1,1,0,0,18280,7.4,19107,235,48,2850,832,23.5,1828,red,0.78,4,49,23,red
4472660506,2,5,2,0,0,0,0,14258,7,17644,216,56,-2760,-1872,21.6,1425.8,5,2,6,2,1,1,0,17018,7.2,19516,248,57,2760,1872,24.8,1701.8,red,0.8,5.5,12,18,red
4523562611,0,5,0,0,0,0,0,14849,7,17923,249,68,-2145,-1335,24.9,1484.9,5,0,7,1,1,0,0,16994,7.4,19258,245,68,2145,1335,24.5,1699.4,blue,0,12.65,20,21,red
4487130661,7,7,6,0,0,0,0,17023,6.8,17502,198,37,1202,-535,19.8,1702.3,7,7,5,1,0,1,0,15821,7,18037,180,46,-1202,535,18,1582.1,blue,1.86,1.71,14,17,blue
4464799134,12,5,9,0,0,0,0,19143,7.4,20064,243,36,3469,3684,24.3,1914.3,5,12,8,1,1,0,0,15674,6.6,16380,199,47,-3469,-3684,19.9,1567.4,blue,4.2,1.08,23,21,blue
4521670146,5,6,4,0,0,0,0,15620,7,17968,214,63,-1083,-127,21.4,1562,6,5,10,1,1,0,0,16703,7,18095,218,40,1083,127,21.8,1670.3,red,1.5,3.2,51,28,red
4521295161,8,8,11,1,1,0,0,18623,7.2,17867,229,60,914,34,22.9,1862.3,8,8,9,0,0,0,0,17709,7,17833,237,42,-914,-34,23.7,1770.9,blue,2.38,2.12,21,15,blue
4521747245,5,3,5,0,0,0,0,16564,7,18605,222,63,1436,1597,22.2,1656.4,3,5,5,1,1,0,0,15128,6.8,17008,221,52,-1436,-1597,22.1,1512.8,blue,3.33,1.6,18,18,red
4460625430,11,7,16,1,1,0,0,18421,7.2,18519,232,44,2256,725,23.2,1842.1,7,11,7,0,0,0,0,16165,6.8,17794,222,35,-2256,-725,22.2,1616.5,blue,3.86,1.27,19,19,red
4476686875,7,5,8,1,0,1,0,17364,7,18990,215,68,1206,1055,21.5,1736.4,5,7,4,1,1,0,0,16158,7,17935,248,49,-1206,-1055,24.8,1615.8,red,3,1.29,35,16,blue
4521593829,8,7,14,1,1,0,0,16749,7,17759,174,56,243,-276,17.4,1674.9,7,8,1,0,0,0,0,16506,6.8,18035,227,51,-243,276,22.7,1650.6,blue,3.14,1,38,22,red
4496543857,9,10,9,0,0,0,0,17987,6.8,17683,209,41,-368,-612,20.9,1798.7,10,9,11,0,0,0,0,18355,7.2,18295,236,54,368,612,23.6,1835.5,red,1.8,2.33,20,19,red
4448406532,6,7,4,1,1,0,0,16103,6.8,18017,220,40,-90,-739,22,1610.3,7,6,5,0,0,0,0,16193,7.2,18756,205,37,90,739,20.5,1619.3,red,1.43,2,15,17,blue
4493188082,10,6,12,0,0,0,0,18384,7.2,18718,226,52,1717,1335,22.6,1838.4,6,10,10,0,0,0,0,16667,6.8,17383,229,43,-1717,-1335,22.9,1666.7,blue,3.67,1.6,22,19,blue
4524580424,9,7,14,1,0,1,0,17465,6.6,17463,211,40,875,276,21.1,1746.5,7,9,7,0,0,0,0,16590,6.6,17187,183,44,-875,-276,18.3,1659,blue,3.29,1.56,17,15,blue
4522582067,6,9,8,0,0,0,0,15591,6.6,16788,204,35,-2322,-2808,20.4,1559.1,9,6,7,1,1,0,0,17913,7.2,19596,216,60,2322,2808,21.6,1791.3,red,1.56,2.67,15,16,red
4484568700,3,2,2,0,0,0,0,15391,6.6,17387,232,41,1343,1089,23.2,1539.1,2,3,1,1,1,0,0,14048,6.4,16298,218,48,-1343,-1089,21.8,1404.8,blue,2.5,1,23,20,blue
4450359024,2,9,2,0,0,0,0,14953,6.8,17850,228,52,-3084,-1719,22.8,1495.3,9,2,9,1,1,0,0,18037,7.4,19569,258,56,3084,1719,25.8,1803.7,red,0.44,9,10,18,red
4515238176,5,2,11,1,1,0,0,16640,7,18989,247,63,1964,1416,24.7,1664,2,5,1,0,0,0,0,14676,7,17573,215,58,-1964,-1416,21.5,1467.6,blue,8,0.6,18,18,red
4519247405,3,5,4,1,1,0,0,15501,7,17414,245,40,-257,-180,24.5,1550.1,5,3,7,0,0,0,0,15758,6.8,17594,199,52,257,180,19.9,1575.8,blue,1.4,4,19,57,red
4518077809,11,6,12,1,1,0,0,18891,7.2,19302,235,50,3024,1980,23.5,1889.1,6,11,5,0,0,0,0,15867,7,17322,185,59,-3024,-1980,18.5,1586.7,red,3.83,1,21,43,blue
4455131016,6,8,4,1,1,0,0,16999,7.2,18661,232,66,-647,543,23.2,1699.9,8,6,11,0,0,0,0,17646,6.8,18118,226,46,647,-543,22.6,1764.6,blue,1.25,3.17,18,17,blue
4462622512,11,8,11,0,0,0,0,18291,7,18744,195,42,939,1327,19.5,1829.1,8,11,9,0,0,0,0,17352,7,17417,209,40,-939,-1327,20.9,1735.2,blue,2.75,1.55,36,17,red
4522846524,1,4,1,0,0,0,0,14588,7,18059,234,57,-1159,-73,23.4,1458.8,4,1,4,2,1,1,0,15747,7.2,18132,243,53,1159,73,24.3,1574.7,red,0.5,8,18,27,red
4524387614,6,2,4,1,1,0,0,16432,7.4,18849,208,59,2390,1778,20.8,1643.2,2,6,1,0,0,0,0,14042,6.6,17071,219,48,-2390,-1778,21.9,1404.2,blue,5,0.5,40,20,blue
4483835380,5,10,3,1,0,1,0,16199,6.8,17974,216,52,-2482,-2515,21.6,1619.9,10,5,13,1,1,0,0,18681,7.4,20489,219,60,2482,2515,21.9,1868.1,red,0.8,4.6,18,17,blue
4524576336,10,8,12,1,1,0,0,17342,7,17885,179,48,-447,-955,17.9,1734.2,8,10,5,0,0,0,0,17789,7.2,18840,206,44,447,955,20.6,1778.9,blue,2.75,1.3,50,13,red
4493201984,3,1,4,1,0,1,0,16247,7,19000,257,56,1351,940,25.7,1624.7,1,3,0,1,1,0,0,14896,7,18060,269,60,-1351,-940,26.9,1489.6,red,7,0.33,22,28,blue
4518396542,8,4,4,1,1,0,0,17038,7.2,18971,233,60,1530,334,23.3,1703.8,4,8,2,1,0,1,0,15508,6.8,18637,233,48,-1530,-334,23.3,1550.8,blue,3,0.75,34,39,blue
4494122162,3,6,2,0,0,0,0,14607,6.8,17527,204,56,-2968,-2262,20.4,1460.7,6,3,8,2,1,1,0,17575,7.6,19789,243,56,2968,2262,24.3,1757.5,red,0.83,4.67,13,42,blue
4521764642,5,10,8,0,0,0,0,14839,6.8,16702,208,32,-2574,-1057,20.8,1483.9,10,5,17,1,1,0,0,17413,7,17759,227,29,2574,1057,22.7,1741.3,red,1.3,5.4,21,24,blue
4521534899,3,7,5,0,0,0,0,15142,7,17554,235,40,-1851,-1813,23.5,1514.2,7,3,9,2,1,1,0,16993,7.2,19367,242,59,1851,1813,24.2,1699.3,blue,1.14,5.33,21,24,blue
4472468889,8,4,10,1,1,0,0,17836,7.4,19239,235,67,840,145,23.5,1783.6,4,8,3,0,0,0,0,16996,7,19094,263,68,-840,-145,26.3,1699.6,red,4.5,0.88,20,18,blue
4420650746,6,6,6,1,1,0,0,16538,7.4,18750,231,52,-626,239,23.1,1653.8,6,6,10,1,0,1,0,17164,6.8,18511,230,43,626,-239,23,1716.4,blue,2,2.67,28,46,red
4449194030,15,9,22,1,1,0,0,20558,7,18104,230,40,4230,1545,23,2055.8,9,15,5,0,0,0,0,16328,6.8,16559,167,36,-4230,-1545,16.7,1632.8,blue,4.11,0.93,25,16,blue
4519907649,13,5,18,1,1,0,0,19813,7,18543,236,32,4173,1912,23.6,1981.3,5,13,7,0,0,0,0,15640,6.6,16631,167,40,-4173,-1912,16.7,1564,blue,6.2,0.92,19,15,blue
4521233015,14,6,11,1,1,0,0,18537,7.2,19024,200,48,1809,1633,20,1853.7,6,14,5,0,0,0,0,16728,6.8,17391,193,64,-1809,-1633,19.3,1672.8,blue,4.17,0.79,18,16,blue
4474676809,5,0,5,2,1,1,1,17806,7,18750,244,48,6304,5904,24.4,1780.6,0,5,0,0,0,0,0,11502,5.4,12846,155,40,-6304,-5904,15.5,1150.2,blue,12.03,0,16,25,blue
4473800740,13,5,11,0,0,0,0,20853,7.6,20248,270,43,5501,3548,27,2085.3,5,13,7,0,0,0,0,15352,6.8,16700,188,48,-5501,-3548,18.8,1535.2,blue,4.8,0.92,35,43,blue
4525145363,5,2,5,0,0,0,0,16441,7.2,19798,243,50,1218,1167,24.3,1644.1,2,5,2,1,0,1,0,15223,7,18631,252,51,-1218,-1167,25.2,1522.3,red,5,0.8,24,38,red
4521186750,4,4,5,0,0,0,0,15801,7.2,18475,206,65,-187,-361,20.6,1580.1,4,4,3,1,1,0,0,15988,7.2,18836,251,66,187,361,25.1,1598.8,red,2.25,1.75,16,19,blue
4459950157,4,5,6,1,1,0,0,15871,6.8,17211,229,40,51,-1075,22.9,1587.1,5,4,2,0,0,0,0,15820,7,18286,216,52,-51,1075,21.6,1582,red,2,1.75,21,22,red
4489423422,7,8,6,0,0,0,0,16199,6.6,16645,206,48,-811,-798,20.6,1619.9,8,7,8,1,1,0,0,17010,6.8,17443,192,56,811,798,19.2,1701,red,1.62,2.29,21,19,blue
4469393783,5,9,7,0,0,0,0,15831,6.6,17389,208,59,-2241,-1888,20.8,1583.1,9,5,13,2,1,1,0,18072,7.2,19277,218,52,2241,1888,21.8,1807.2,red,1.33,4.4,32,17,red
4508091967,2,8,1,0,0,0,0,14467,6.6,16928,215,48,-3794,-1962,21.5,1446.7,8,2,11,1,1,0,0,18261,7.2,18890,234,76,3794,1962,23.4,1826.1,red,0.38,9.5,18,18,red
4523085074,6,10,12,1,1,0,0,17795,7,18362,228,63,426,917,22.8,1779.5,10,6,15,1,0,1,0,17369,6.8,17445,194,40,-426,-917,19.4,1736.9,red,1.8,4.17,19,20,blue
4523986345,5,7,4,1,1,0,0,15832,7,18359,236,44,-1741,-1348,23.6,1583.2,7,5,5,1,0,1,0,17573,7.4,19707,234,51,1741,1348,23.4,1757.3,blue,1.29,2.4,20,38,red
4523336586,13,5,9,2,1,1,0,18170,7,19022,191,49,3058,3283,19.1,1817,5,13,6,0,0,0,0,15112,6.4,15739,189,46,-3058,-3283,18.9,1511.2,blue,4.4,0.85,19,17,blue
4424011852,5,2,6,1,1,0,0,16196,7,18411,238,46,1106,1014,23.8,1619.6,2,5,3,0,0,0,0,15090,6.8,17397,216,55,-1106,-1014,21.6,1509,red,5.5,1,29,39,red
4524587916,2,3,4,0,0,0,0,14680,7,17465,207,56,-1602,-1412,20.7,1468,3,2,2,2,1,1,0,16282,7.2,18877,243,68,1602,1412,24.3,1628.2,red,2,2.5,29,20,red
4479120786,9,6,8,1,1,0,0,17029,6.8,17944,201,43,569,-1349,20.1,1702.9,6,9,3,0,0,0,0,16460,7,19293,204,60,-569,1349,20.4,1646,blue,2.83,1,15,18,blue
4521139386,3,3,4,0,0,0,0,14298,6.4,17567,228,40,-873,-736,22.8,1429.8,3,3,2,0,0,0,0,15171,7,18303,238,51,873,736,23.8,1517.1,red,2.33,1.67,17,19,red
4523383339,1,10,0,0,0,0,0,14058,6.6,16535,214,64,-5327,-4636,21.4,1405.8,10,1,10,2,1,1,1,19385,7.6,21171,234,57,5327,4636,23.4,1938.5,red,0.1,20,14,16,red
4519625285,8,4,11,2,1,1,0,17385,6.8,18040,221,56,2745,1478,22.1,1738.5,4,8,6,0,0,0,0,14640,6.6,16562,203,37,-2745,-1478,20.3,1464,blue,4.75,1.25,21,19,blue
4491633476,11,7,10,0,0,0,0,19008,7.6,19915,235,42,2763,2019,23.5,1900.8,7,11,6,1,1,0,0,16245,7,17896,216,43,-2763,-2019,21.6,1624.5,blue,3,1.18,21,16,blue
4509755539,8,9,13,0,0,0,0,18038,7,18690,236,42,-22,86,23.6,1803.8,9,8,8,1,1,0,0,18060,7,18604,214,60,22,-86,21.4,1806,red,2.33,2.12,22,19,blue
4521167934,6,3,3,0,0,0,0,16454,7,18902,228,63,1510,1545,22.8,1645.4,3,6,2,1,1,0,0,14944,7,17357,222,60,-1510,-1545,22.2,1494.4,blue,3,0.83,18,13,blue
4474730654,11,9,9,1,1,0,0,18313,7,17999,214,40,1099,-673,21.4,1831.3,9,11,6,0,0,0,0,17214,6.8,18672,178,60,-1099,673,17.8,1721.4,blue,2.22,1.36,20,17,blue
4472450080,6,3,7,0,0,0,0,17057,6.8,17917,243,50,2019,138,24.3,1705.7,3,6,6,0,0,0,0,15038,6.8,17779,209,61,-2019,-138,20.9,1503.8,blue,4.33,1.5,19,16,blue
4442356832,4,11,5,0,0,0,0,15046,6.8,17088,214,36,-4939,-3731,21.4,1504.6,11,4,16,1,0,1,0,19985,7.6,20819,251,69,4939,3731,25.1,1998.5,red,0.82,6.75,32,18,blue
4521447846,3,6,5,0,0,0,0,14455,6.6,16461,199,48,-2471,-2179,19.9,1445.5,6,3,4,1,1,0,0,16926,6.8,18640,249,48,2471,2179,24.9,1692.6,red,1.33,3.33,15,16,red
4519425704,11,5,12,0,0,0,0,18480,6.8,17912,201,42,2532,1229,20.1,1848,5,11,10,0,0,0,0,15948,6.6,16683,203,51,-2532,-1229,20.3,1594.8,blue,4.6,1.36,22,17,blue
4422228615,12,9,11,0,0,0,0,19153,7,18170,217,40,1249,1879,21.7,1915.3,9,12,12,0,0,0,1,17904,6.4,16291,177,44,-1249,-1879,17.7,1790.4,blue,2.56,1.75,18,133,red
4501834987,5,4,5,1,1,0,0,16688,7.2,18714,226,60,859,128,22.6,1668.8,4,5,5,0,0,0,0,15829,7,18586,242,36,-859,-128,24.2,1582.9,blue,2.5,1.8,22,17,blue
4523478644,6,8,6,0,0,0,0,15567,6.6,16972,167,47,-1737,-776,16.7,1556.7,8,6,6,1,1,0,0,17304,7,17748,245,52,1737,776,24.5,1730.4,red,1.5,2.33,35,27,red
4489726898,3,0,3,1,1,0,0,15429,6.8,18375,218,64,1453,1251,21.8,1542.9,0,3,0,0,0,0,0,13976,6.6,17124,231,64,-1453,-1251,23.1,1397.6,blue,12.03,0,16,13,blue
4511428769,9,6,10,1,0,1,0,17491,7,18181,194,74,616,43,19.4,1749.1,6,9,5,1,1,0,0,16875,6.8,18138,253,36,-616,-43,25.3,1687.5,blue,3.17,1.22,13,17,red
4490242391,9,6,15,1,1,0,0,17679,6.8,17322,222,32,363,-1888,22.2,1767.9,6,9,7,1,0,1,0,17316,7.2,19210,230,79,-363,1888,23,1731.6,red,4,1.44,22,36,blue
4464812857,8,4,9,1,1,0,0,17397,7.2,19011,244,52,2598,4512,24.4,1739.7,4,8,7,0,0,0,0,14799,5.8,14499,186,49,-2598,-4512,18.6,1479.9,blue,4.25,1.38,15,23,red
4518146165,7,14,11,0,0,0,0,14416,5.2,11286,90,30,-5253,-5281,9,1441.6,14,7,19,0,0,0,0,19669,6.6,16567,203,44,5253,5281,20.3,1966.9,red,1.29,4.71,15,17,red
4520041745,7,11,10,0,0,0,0,16820,6.8,16714,202,40,-2234,-3264,20.2,1682,11,7,15,1,1,0,0,19054,7.2,19978,209,63,2234,3264,20.9,1905.4,red,1.55,3.71,21,16,red
4501312404,6,4,5,0,0,0,0,15659,6.8,17407,211,47,-127,-445,21.1,1565.9,4,6,6,2,1,1,0,15786,6.8,17852,209,64,127,445,20.9,1578.6,blue,2.75,1.67,19,20,blue
4502754210,10,8,6,0,0,0,1,19353,6.8,18423,223,60,3458,3204,22.3,1935.3,8,10,13,0,0,0,0,15895,6.2,15219,163,48,-3458,-3204,16.3,1589.5,blue,2,2.1,19,17,blue
4479934659,11,9,13,0,0,0,0,17794,7.2,18646,211,39,337,-260,21.1,1779.4,9,11,7,1,1,0,0,17457,7,18906,218,56,-337,260,21.8,1745.7,red,2.67,1.45,20,17,blue
4478024561,7,8,2,1,1,0,0,16443,6.8,17912,228,48,-1041,-661,22.8,1644.3,8,7,9,0,0,0,0,17484,7,18573,216,47,1041,661,21.6,1748.4,blue,1.12,2.43,20,16,blue
4518123913,7,2,9,0,0,0,0,17773,7.6,20821,242,67,2421,3009,24.2,1777.3,2,7,2,0,0,0,0,15352,7,17812,221,64,-2421,-3009,22.1,1535.2,blue,8,0.57,17,40,blue
4480700431,6,13,5,1,1,0,0,14996,6.8,17677,181,60,-4822,-2537,18.1,1499.6,13,6,15,0,0,0,0,19818,7.4,20214,249,44,4822,2537,24.9,1981.8,blue,0.85,4.67,13,19,red
4477403514,5,9,3,1,1,0,0,15803,7,18061,217,73,-2994,-1007,21.7,1580.3,9,5,12,1,0,1,0,18797,7.2,19068,248,67,2994,1007,24.8,1879.7,red,0.89,4.2,18,14,red
4474804095,6,9,8,0,0,0,0,16241,7,18864,211,60,-1539,-601,21.1,1624.1,9,6,9,1,1,0,0,17780,7.2,19465,249,52,1539,601,24.9,1778,blue,1.56,3,49,25,red
4514051378,11,9,11,1,1,0,0,17774,7,18440,180,49,-76,1386,18,1777.4,9,11,9,0,0,0,0,17850,6.8,17054,190,60,76,-1386,19,1785,blue,2.44,1.64,16,19,red
4519902539,6,6,4,0,0,0,0,15823,7,18209,214,52,-1482,256,21.4,1582.3,6,6,8,1,1,0,0,17305,6.8,17953,247,62,1482,-256,24.7,1730.5,red,1.67,2.33,44,20,red
4510989189,10,0,7,0,0,0,0,17684,7.4,19113,224,35,3847,2027,22.4,1768.4,0,10,0,0,0,0,0,13837,6.8,17086,217,53,-3847,-2027,21.7,1383.7,blue,12.03,0,22,16,blue
4447078997,8,4,5,0,0,0,0,17898,7.2,18482,247,57,3044,1775,24.7,1789.8,4,8,2,0,0,0,0,14854,6.8,16707,213,36,-3044,-1775,21.3,1485.4,red,3.25,0.75,19,18,blue
4522475843,3,5,3,2,1,1,0,15562,6.8,16991,222,52,-1176,-1838,22.2,1556.2,5,3,9,0,0,0,0,16738,7,18829,201,68,1176,1838,20.1,1673.8,blue,1.2,4.67,11,18,blue
4503510396,3,4,4,0,0,0,0,14881,6.6,17401,196,48,-1659,-1134,19.6,1488.1,4,3,5,1,1,0,0,16540,7.2,18535,248,63,1659,1134,24.8,1654,red,1.75,3,39,15,red
4513963315,5,2,9,2,1,1,0,16636,7,19367,246,64,2547,1517,24.6,1663.6,2,5,0,0,0,0,0,14089,6.8,17850,215,56,-2547,-1517,21.5,1408.9,blue,7,0.4,18,16,red
4515839148,7,8,5,0,0,0,0,16396,7.2,18362,209,36,-389,-29,20.9,1639.6,8,7,10,1,1,0,0,16785,7,18391,213,51,389,29,21.3,1678.5,blue,1.5,2.57,23,15,blue
4518673555,3,7,4,0,0,0,0,15396,6.6,16586,218,36,-1193,-843,21.8,1539.6,7,3,7,1,0,1,0,16589,6.8,17429,238,36,1193,843,23.8,1658.9,red,1,4.67,21,24,red
4522387396,11,11,7,1,0,1,0,18164,7,18492,198,52,-640,403,19.8,1816.4,11,11,14,1,1,0,0,18804,7,18089,204,50,640,-403,20.4,1880.4,blue,1.64,2.27,19,13,blue
4518553982,11,9,17,0,0,0,0,17774,6.6,17519,193,42,74,-513,19.3,1777.4,9,11,10,0,0,0,0,17700,6.8,18032,221,52,-74,513,22.1,1770,blue,3.11,1.73,16,17,red
4508668617,6,4,8,0,0,0,0,16990,7,18051,244,50,1954,1045,24.4,1699,4,6,3,1,1,0,0,15036,6.8,17006,225,40,-1954,-1045,22.5,1503.6,red,3.5,1.17,20,18,red
4523348285,6,2,6,1,1,0,0,16508,7,18539,228,44,646,407,22.8,1650.8,2,6,2,0,0,0,0,15862,6.8,18132,238,57,-646,-407,23.8,1586.2,blue,6,0.67,18,17,blue
4500809848,3,6,1,0,0,0,0,15533,6.8,18287,244,66,-1585,-280,24.4,1553.3,6,3,10,1,1,0,0,17118,7,18567,256,60,1585,280,25.6,1711.8,red,0.67,5.33,19,21,red
4523898357,4,3,5,1,1,0,0,15391,7,17937,191,64,46,970,19.1,1539.1,3,4,2,0,0,0,0,15345,6.8,16967,236,52,-46,-970,23.6,1534.5,blue,3,1.25,19,21,blue
4518666221,2,3,3,0,0,0,0,15076,6.4,16299,196,51,-426,-2349,19.6,1507.6,3,2,3,1,0,1,0,15502,6.8,18648,218,64,426,2349,21.8,1550.2,blue,1.67,3,20,16,blue
4467234641,7,7,6,0,0,0,0,16119,6.6,16658,217,41,-524,-1029,21.7,1611.9,7,7,8,2,1,1,0,16643,6.8,17687,190,50,524,1029,19,1664.3,blue,1.86,2.14,23,28,blue
4524748805,2,7,2,0,0,0,0,14377,7,17408,194,55,-3773,-3783,19.4,1437.7,7,2,8,1,1,0,0,18150,7.8,21191,258,52,3773,3783,25.8,1815,red,0.57,7.5,15,15,blue
4479706373,3,7,0,0,0,0,0,13958,6.6,17193,176,62,-4738,-2857,17.6,1395.8,7,3,4,2,1,1,0,18696,7.4,20050,264,66,4738,2857,26.4,1869.6,blue,0.43,3.67,19,19,red
4469754326,13,11,8,1,1,0,0,18834,6.8,17602,203,56,1059,1185,20.3,1883.4,11,13,12,0,0,0,0,17775,6.4,16417,182,44,-1059,-1185,18.2,1777.5,blue,1.91,1.77,23,23,blue
4440251539,10,7,6,1,1,0,0,17895,7,18393,208,45,2330,1713,20.8,1789.5,7,10,7,0,0,0,0,15565,6.6,16680,204,31,-2330,-1713,20.4,1556.5,blue,2.29,1.4,19,17,blue
4521442807,6,7,4,0,0,0,0,16526,7,18436,215,60,434,740,21.5,1652.6,7,6,3,0,0,0,0,16092,7,17696,226,37,-434,-740,22.6,1609.2,blue,1.43,1.67,50,17,red
4462505118,8,9,9,0,0,0,0,16075,6.8,17316,200,45,-1778,-1128,20,1607.5,9,8,10,1,1,0,0,17853,7,18444,208,50,1778,1128,20.8,1785.3,red,1.89,2.38,18,24,red
4488677856,9,10,10,1,0,1,2,18947,6.8,17963,215,36,412,-655,21.5,1894.7,10,9,13,1,1,0,0,18535,7.2,18618,241,50,-412,655,24.1,1853.5,red,1.9,2.56,15,21,red
4512780010,3,10,2,0,0,0,0,15137,6.6,16725,214,56,-2645,-1869,21.4,1513.7,10,3,7,1,1,0,0,17782,7.2,18594,225,48,2645,1869,22.5,1778.2,red,0.5,5.67,20,61,red
4477975030,5,4,5,0,0,0,0,16157,6.8,17603,240,28,804,365,24,1615.7,4,5,4,0,0,0,0,15353,7,17238,206,52,-804,-365,20.6,1535.3,red,2.5,1.6,22,16,blue
4525058248,4,6,2,0,0,0,0,15152,6.8,17748,229,48,-619,190,22.9,1515.2,6,4,13,1,1,0,0,15771,6.6,17558,188,50,619,-190,18.8,1577.1,red,1,4.75,22,21,red
4518631058,8,4,8,0,0,0,0,17041,6.8,17082,227,47,2263,1326,22.7,1704.1,4,8,5,1,1,0,0,14778,6.4,15756,179,55,-2263,-1326,17.9,1477.8,blue,4,1.12,24,24,blue
4452942684,6,0,7,1,1,0,0,16742,7.4,19873,236,49,2805,2599,23.6,1674.2,0,6,0,0,0,0,0,13937,6.6,17274,254,56,-2805,-2599,25.4,1393.7,blue,12.03,0,21,17,blue
4492057587,4,6,3,1,1,0,0,15660,7,17755,246,52,-2392,-2503,24.6,1566,6,4,7,0,0,0,0,18052,7.4,20258,266,68,2392,2503,26.6,1805.2,red,1.17,3.25,16,22,blue
4520326314,6,3,5,0,0,0,0,16298,7,19052,229,56,823,1225,22.9,1629.8,3,6,3,1,1,0,0,15475,6.8,17827,235,52,-823,-1225,23.5,1547.5,blue,3.67,1,17,17,blue
4517636466,4,7,5,1,1,0,0,15860,7.2,18449,228,63,-1160,-12,22.8,1586,7,4,9,1,0,1,0,17020,7,18461,203,48,1160,12,20.3,1702,blue,1.29,4,33,147,blue
4497964264,6,8,3,1,1,0,0,15809,7.2,18321,239,53,-1065,502,23.9,1580.9,8,6,8,1,0,1,0,16874,7,17819,235,44,1065,-502,23.5,1687.4,blue,1.12,2.67,20,20,blue
4491707815,13,2,18,0,0,0,0,19470,7.4,20453,243,51,6297,5777,24.3,1947,2,13,1,1,1,0,0,13173,6,14676,189,42,-6297,-5777,18.9,1317.3,blue,15.5,0.23,22,20,red
4509839658,15,4,22,2,1,1,0,19660,7,17870,186,71,5255,2255,18.6,1966,4,15,4,0,0,0,0,14405,6.2,15615,183,36,-5255,-2255,18.3,1440.5,red,9.25,0.53,19,16,blue
4525005858,2,9,4,0,0,0,0,13631,6.6,15864,175,52,-5167,-3200,17.5,1363.1,9,2,7,0,0,0,0,18798,7.4,19064,234,44,5167,3200,23.4,1879.8,red,0.67,8,16,13,red
4523916920,8,5,11,0,0,0,0,16748,6.8,17343,209,41,873,215,20.9,1674.8,5,8,5,0,0,0,0,15875,7,17128,235,48,-873,-215,23.5,1587.5,blue,3.8,1.25,60,145,red
4517768764,1,3,0,0,0,0,0,14434,6.8,17904,221,67,-920,-451,22.1,1443.4,3,1,3,1,1,0,0,15354,6.8,18355,230,48,920,451,23,1535.4,red,0.33,6,35,26,red
4505905510,5,5,5,0,0,0,0,16287,7,16978,235,38,1099,-622,23.5,1628.7,5,5,4,0,0,0,0,15188,6.8,17600,183,51,-1099,622,18.3,1518.8,blue,2,1.8,15,13,blue
4503760931,4,8,3,1,1,0,0,15102,6.6,16371,201,59,-3465,-897,20.1,1510.2,8,4,11,1,0,1,1,18567,6.6,17268,253,28,3465,897,25.3,1856.7,red,0.88,4.75,21,26,red
4449478989,4,1,4,2,1,1,0,15492,7,18241,212,56,1412,737,21.2,1549.2,1,4,0,0,0,0,0,14080,6.8,17504,236,52,-1412,-737,23.6,1408,blue,8,0.25,22,17,blue
4524874155,4,6,3,1,1,0,0,14554,6.8,16715,198,44,-2814,-2772,19.8,1455.4,6,4,5,0,0,0,0,17368,7.4,19487,228,64,2814,2772,22.8,1736.8,blue,1.17,2.75,20,17,red
4470179488,4,6,5,0,0,0,0,15403,6.8,17661,216,43,-1636,-2200,21.6,1540.3,6,4,5,1,1,0,0,17039,7.2,19861,245,60,1636,2200,24.5,1703.9,blue,1.5,2.75,20,18,red
4453252980,0,9,0,0,0,0,0,13024,6.6,15869,192,48,-4912,-4457,19.2,1302.4,9,0,5,2,1,1,0,17936,7.4,20326,251,51,4912,4457,25.1,1793.6,red,0,12.65,47,27,red
4508978752,5,7,7,1,1,0,0,15799,6.8,17838,242,35,-1827,-1102,24.2,1579.9,7,5,10,1,0,1,0,17626,7,18940,243,48,1827,1102,24.3,1762.6,blue,1.71,3.4,24,23,red
4498735941,7,8,8,1,0,1,0,17127,7,17974,243,45,-373,-212,24.3,1712.7,8,7,10,1,1,0,0,17500,7,18186,229,47,373,212,22.9,1750,red,1.88,2.57,15,21,red
4519478233,9,7,10,2,1,1,0,17208,7.2,18913,201,53,423,1071,20.1,1720.8,7,9,7,0,0,0,0,16785,7,17842,222,46,-423,-1071,22.2,1678.5,blue,2.71,1.56,16,13,blue
4523347414,8,7,17,0,0,0,0,16860,6.2,15585,183,44,-91,-2362,18.3,1686,7,8,7,0,0,0,0,16951,6.8,17947,204,48,91,2362,20.4,1695.1,blue,3.57,1.75,18,20,red
4502140813,9,13,12,0,0,0,0,18082,6.8,17805,215,37,-1097,-674,21.5,1808.2,13,9,18,1,1,0,0,19179,7,18479,204,54,1097,674,20.4,1917.9,red,1.62,3.44,20,17,red
4473969390,4,16,5,0,0,0,0,14813,6,14354,198,20,-5062,-5699,19.8,1481.3,16,4,22,2,1,1,0,19875,7.4,20053,250,45,5062,5699,25,1987.5,red,0.56,9.5,22,28,blue
4480690705,8,7,14,0,0,0,0,17989,7,18476,254,48,267,427,25.4,1798.9,7,8,11,0,0,0,0,17722,7,18049,219,60,-267,-427,21.9,1772.2,blue,3.14,2.25,18,23,red
4523749489,6,7,9,0,0,0,0,15815,6.6,16506,206,40,-1053,-2759,20.6,1581.5,7,6,7,1,1,0,0,16868,7.4,19265,247,43,1053,2759,24.7,1686.8,blue,2.14,2.33,21,40,blue
4507333323,8,5,12,1,1,0,0,17991,7.4,19538,219,60,2664,3273,21.9,1799.1,5,8,7,0,0,0,0,15327,6.6,16265,187,40,-2664,-3273,18.7,1532.7,blue,4,1.5,24,21,red
4518028905,8,9,5,0,0,0,0,16560,6.8,17640,200,47,-1611,-1380,20,1656,9,8,9,1,1,0,0,18171,7.2,19020,209,56,1611,1380,20.9,1817.1,red,1.44,2.25,18,23,blue
4503585743,4,3,5,0,0,0,0,15260,7,17619,191,59,323,701,19.1,1526,3,4,0,2,1,1,0,14937,6.6,16918,212,52,-323,-701,21.2,1493.7,red,3,0.75,13,91,red
4521245361,2,10,1,0,0,0,0,13544,6.2,15367,206,18,-5820,-4066,20.6,1354.4,10,2,8,0,0,0,0,19364,7.2,19433,255,77,5820,4066,25.5,1936.4,red,0.3,9,19,17,blue
4453471235,4,6,4,0,0,0,0,15462,7.2,18980,239,55,-1870,-71,23.9,1546.2,6,4,6,1,1,0,0,17332,7.2,19051,238,60,1870,71,23.8,1733.2,blue,1.33,3,41,22,red
4485904786,3,9,2,1,1,0,0,15000,6.6,16731,221,51,-3761,-2552,22.1,1500,9,3,7,0,0,0,0,18761,7.2,19283,225,48,3761,2552,22.5,1876.1,red,0.56,5.33,20,33,blue
4476300394,6,2,6,1,0,1,0,16399,7.4,18784,235,62,2036,2773,23.5,1639.9,2,6,2,1,1,0,0,14363,6.6,16011,221,48,-2036,-2773,22.1,1436.3,blue,6,0.67,23,179,blue
4518690389,5,5,1,0,0,0,0,14594,6.8,17746,184,47,-1087,-108,18.4,1459.4,5,5,3,0,0,0,0,15681,7,17854,220,52,1087,108,22,1568.1,red,1.2,1.6,19,16,red
4525237424,13,2,10,1,0,1,1,21046,7.4,19706,250,45,7995,4733,25,2104.6,2,13,0,0,0,0,0,13051,6.4,14973,179,49,-7995,-4733,17.9,1305.1,blue,11.5,0.15,19,15,blue
4505269056,4,6,5,1,1,0,0,15382,7,17876,218,56,-1182,-944,21.8,1538.2,6,4,4,1,0,1,0,16564,7,18820,207,54,1182,944,20.7,1656.4,red,1.5,2.5,17,19,red
4524116491,5,9,8,0,0,0,0,16095,6.8,17192,222,50,-1905,-2185,22.2,1609.5,9,5,12,0,0,0,0,18000,7.2,19377,217,64,1905,2185,21.7,1800,blue,1.44,4.2,14,13,red
4524313588,3,10,1,0,0,0,0,14863,6.8,17880,222,59,-3630,668,22.2,1486.3,10,3,15,2,1,1,0,18493,6.8,17212,216,50,3630,-668,21.6,1849.3,red,0.4,8.33,15,22,red
4459923671,10,9,9,0,0,0,0,17668,7.2,18625,194,43,-788,-203,19.4,1766.8,9,10,18,1,1,0,0,18456,7,18828,185,68,788,203,18.5,1845.6,red,2.11,2.7,15,36,red
4523623443,6,13,6,0,0,0,0,16420,6.6,16281,223,40,-3593,-3086,22.3,1642,13,6,12,2,1,1,0,20013,7.4,19367,229,60,3593,3086,22.9,2001.3,red,0.92,4.17,19,23,red
4465119054,7,7,8,0,0,0,0,17194,7,18161,233,39,633,-944,23.3,1719.4,7,7,5,0,0,0,0,16561,7.2,19105,202,54,-633,944,20.2,1656.1,blue,2.14,1.71,27,20,red
4520397947,13,7,9,0,0,0,0,19529,7.2,19763,204,36,3476,2025,20.4,1952.9,7,13,5,1,1,0,0,16053,7,17738,182,45,-3476,-2025,18.2,1605.3,blue,3.14,0.92,21,39,blue
4514342696,9,7,11,1,1,0,0,17762,7,18599,233,32,849,794,23.3,1776.2,7,9,8,0,0,0,0,16913,6.8,17805,200,56,-849,-794,20,1691.3,blue,2.86,1.67,20,41,red
4518301313,5,4,4,0,0,0,0,16987,7.2,18495,255,44,1153,-5,25.5,1698.7,4,5,6,1,1,0,0,15834,7.2,18500,241,56,-1153,5,24.1,1583.4,blue,2.25,2,15,13,blue
4509828570,7,4,7,0,0,0,0,16985,7.2,18420,248,32,992,393,24.8,1698.5,4,7,5,1,1,0,0,15993,6.6,18027,229,65,-992,-393,22.9,1599.3,blue,3.5,1.29,16,15,blue
4500946527,2,8,4,0,0,0,0,14845,6.4,16713,236,49,-3193,-2101,23.6,1484.5,8,2,14,1,1,0,0,18038,7.2,18814,207,61,3193,2101,20.7,1803.8,red,0.75,11,20,123,red
4484976193,11,11,10,0,0,0,0,18174,6.8,17137,222,34,-787,-926,22.2,1817.4,11,11,16,1,1,0,0,18961,6.6,18063,225,40,787,926,22.5,1896.1,red,1.91,2.45,21,22,red
4509513084,7,6,7,1,1,0,0,17120,7,18447,205,55,860,284,20.5,1712,6,7,8,0,0,0,0,16260,7.2,18163,200,48,-860,-284,20,1626,blue,2.33,2,18,18,blue
4513396657,5,7,6,1,1,0,0,15776,6.8,16824,199,36,-400,-1311,19.9,1577.6,7,5,6,0,0,0,0,16176,6.8,18135,217,43,400,1311,21.7,1617.6,red,1.57,2.6,15,18,blue
4466163546,5,8,6,0,0,0,0,17175,7,18994,264,51,-680,567,26.4,1717.5,8,5,11,1,1,0,0,17855,7,18427,239,41,680,-567,23.9,1785.5,blue,1.38,3.8,26,19,red
4483147494,5,10,4,0,0,0,0,15656,6.6,16714,206,40,-1458,-618,20.6,1565.6,10,5,11,2,1,1,0,17114,6.6,17332,193,45,1458,618,19.3,1711.4,red,0.9,4.2,14,25,blue
4519091334,4,7,4,1,1,0,0,14867,7,17173,216,35,-2153,-2348,21.6,1486.7,7,4,4,0,0,0,0,17020,7.2,19521,220,75,2153,2348,22,1702,red,1.14,2.75,38,17,blue
4488941406,7,6,5,1,1,0,0,17381,7,18938,232,57,1895,635,23.2,1738.1,6,7,5,0,0,0,0,15486,7.2,18303,211,46,-1895,-635,21.1,1548.6,blue,2,1.57,13,14,blue
4438463370,12,3,8,2,1,1,0,18821,7.4,20341,225,72,5301,5872,22.5,1882.1,3,12,3,0,0,0,0,13520,6.4,14469,167,48,-5301,-5872,16.7,1352,blue,6.67,0.5,19,15,blue
4450617242,4,5,5,0,0,0,0,14459,6.8,17799,173,49,-2859,143,17.3,1445.9,5,4,8,0,0,0,0,17318,7,17656,242,46,2859,-143,24.2,1731.8,red,1.8,3.25,14,14,red
4524881267,6,9,6,1,1,0,0,16654,7,18387,239,42,-959,-1002,23.9,1665.4,9,6,12,0,0,0,0,17613,7,19389,211,48,959,1002,21.1,1761.3,red,1.33,3.5,19,90,red
4524327069,6,4,11,0,0,0,0,17438,7.2,18793,249,71,2152,1936,24.9,1743.8,4,6,7,2,1,1,0,15286,6.8,16857,227,41,-2152,-1936,22.7,1528.6,blue,4.25,1.83,18,21,red
4519857386,5,4,4,0,0,0,0,17431,7.2,18675,272,46,300,427,27.2,1743.1,4,5,3,2,1,1,1,17131,7,18248,236,56,-300,-427,23.6,1713.1,blue,2.25,1.4,21,19,blue
4520990102,6,4,5,1,1,0,0,17327,7.4,19938,240,68,2060,1621,24,1732.7,4,6,2,0,0,0,0,15267,7,18317,226,48,-2060,-1621,22.6,1526.7,blue,2.75,1,35,23,blue
4514495149,7,10,5,2,1,1,1,17637,6.8,17342,196,56,-430,-1028,19.6,1763.7,10,7,16,0,0,0,0,18067,7.2,18370,210,37,430,1028,21,1806.7,blue,1.2,3.71,15,16,blue
4514283603,6,8,4,1,1,0,0,16021,6.8,18021,199,48,-620,-384,19.9,1602.1,8,6,9,0,0,0,0,16641,7.2,18405,217,44,620,384,21.7,1664.1,blue,1.25,2.83,18,19,blue
4478517508,7,3,13,1,1,0,0,16997,6.8,17603,227,44,2107,1105,22.7,1699.7,3,7,5,0,0,0,0,14890,6.6,16498,220,48,-2107,-1105,22,1489,blue,6.67,1.14,24,20,blue
4462548167,5,9,7,1,1,0,0,15530,6.8,17375,220,60,-2141,-52,22,1553,9,5,12,1,0,1,0,17671,6.8,17427,236,35,2141,52,23.6,1767.1,red,1.33,4.2,16,47,blue
4515442306,2,6,2,0,0,0,0,14569,6.6,16380,234,52,-575,-1495,23.4,1456.9,6,2,3,1,1,0,0,15144,7,17875,200,52,575,1495,20,1514.4,blue,0.67,4.5,24,49,red
4459957549,7,5,7,0,0,0,0,17212,7,18257,225,60,559,-140,22.5,1721.2,5,7,7,1,1,0,0,16653,7,18397,225,60,-559,140,22.5,1665.3,blue,2.8,1.71,18,15,red
4523026204,10,12,8,0,0,0,0,18494,7,19080,223,49,-790,-834,22.3,1849.4,12,10,9,1,1,0,0,19284,7.2,19914,237,48,790,834,23.7,1928.4,red,1.5,2.1,21,17,blue
4523503421,4,8,3,1,0,1,0,15632,6.8,17715,230,56,-2293,-1323,23,1563.2,8,4,13,1,1,0,0,17925,7.2,19038,234,56,2293,1323,23.4,1792.5,red,0.88,5.25,13,17,red
4447333769,5,3,4,0,0,0,0,17455,7.4,19749,254,79,2409,2186,25.4,1745.5,3,5,4,1,0,1,0,15046,6.8,17563,239,45,-2409,-2186,23.9,1504.6,blue,3,1.4,26,16,red
4462356432,5,3,4,1,1,0,0,15716,7,18832,221,40,12,161,22.1,1571.6,3,5,3,0,0,0,0,15704,6.8,18671,244,60,-12,-161,24.4,1570.4,blue,3,1.2,23,17,red
4520816050,9,3,8,2,1,1,0,17577,7.4,20010,210,64,2812,2747,21,1757.7,3,9,4,0,0,0,0,14765,6.8,17263,205,56,-2812,-2747,20.5,1476.5,blue,5.67,0.78,23,19,blue
4452588232,7,3,10,1,1,0,0,17822,7.2,19861,237,63,2435,1428,23.7,1782.2,3,7,4,0,0,0,0,15387,6.8,18433,215,62,-2435,-1428,21.5,1538.7,blue,5.67,1,12,18,blue
4481630032,5,1,6,1,1,0,0,15381,7,17703,211,51,759,657,21.1,1538.1,1,5,0,0,0,0,0,14622,6.8,17046,245,50,-759,-657,24.5,1462.2,red,11,0.2,19,21,blue
4517997197,5,7,7,0,0,0,0,15485,6.6,16891,201,46,-215,-546,20.1,1548.5,7,5,8,2,1,1,0,15700,6.8,17437,170,56,215,546,17,1570,blue,1.71,3,17,14,blue
4523452574,6,5,5,1,0,1,0,16953,7.2,18804,238,64,1491,533,23.8,1695.3,5,6,4,1,1,0,0,15462,7,18271,213,55,-1491,-533,21.3,1546.2,blue,2.2,1.5,23,25,blue
4523517991,2,14,0,0,0,0,0,13229,6.4,15040,177,46,-6460,-5383,17.7,1322.9,14,2,11,0,0,0,0,19689,7.4,20423,233,44,6460,5383,23.3,1968.9,red,0.14,12.5,14,18,red
4525108877,4,5,5,1,1,0,0,16579,7.2,19488,249,65,-27,-649,24.9,1657.9,5,4,5,0,0,0,0,16606,7.4,20137,246,72,27,649,24.6,1660.6,blue,1.8,2.5,52,33,blue
4524771501,5,7,5,0,0,0,0,15562,7.2,17777,219,44,-1151,-753,21.9,1556.2,7,5,5,2,1,1,0,16713,7.2,18530,227,44,1151,753,22.7,1671.3,red,1.43,2.4,19,16,red
4502709604,6,7,8,1,0,1,0,17192,7,18065,221,56,662,44,22.1,1719.2,7,6,6,1,1,0,0,16530,6.8,18021,196,51,-662,-44,19.6,1653,blue,2,2.17,13,16,red
4502866090,7,1,9,1,0,1,1,18764,7,18764,268,51,5121,2946,26.8,1876.4,1,7,2,0,0,0,0,13643,6.4,15818,201,54,-5121,-2946,20.1,1364.3,blue,16,0.43,20,39,blue
4515691372,4,9,2,0,0,0,0,15790,6.6,16879,215,45,-1876,-2154,21.5,1579,9,4,10,1,1,0,0,17666,7.4,19033,208,60,1876,2154,20.8,1766.6,red,0.67,4.75,14,17,blue
4483696050,10,6,11,1,1,0,0,19380,7.2,19467,244,64,3844,2740,24.4,1938,6,10,6,0,0,0,0,15536,6.4,16727,189,46,-3844,-2740,18.9,1553.6,blue,3.5,1.2,21,21,blue
4485493657,6,7,8,0,0,0,0,16554,6.6,17192,215,49,-154,-193,21.5,1655.4,7,6,9,1,0,1,0,16708,6.8,17385,218,48,154,193,21.8,1670.8,red,2,2.67,19,18,blue
4487456805,3,9,4,0,0,0,0,14017,6.6,16680,185,54,-5089,-1828,18.5,1401.7,9,3,10,0,0,0,0,19106,7,18508,245,52,5089,1828,24.5,1910.6,red,0.78,6.33,19,16,red
4457806317,14,6,14,1,1,0,0,20136,7.4,19337,225,43,4322,3830,22.5,2013.6,6,14,8,0,0,0,0,15814,6.4,15507,186,33,-4322,-3830,18.6,1581.4,red,4.67,1,16,17,blue
4525194842,7,6,6,1,1,0,0,16717,7.2,18457,223,49,-450,-992,22.3,1671.7,6,7,5,0,0,0,0,17167,7.2,19449,247,48,450,992,24.7,1716.7,blue,2.17,1.57,21,23,blue
4516786355,5,6,8,1,0,1,0,15927,6.6,17498,220,58,-412,-609,22,1592.7,6,5,8,1,1,0,0,16339,6.6,18107,234,37,412,609,23.4,1633.9,blue,2.17,2.8,19,19,blue
4477737633,6,14,8,0,0,0,0,15729,6.6,16459,186,30,-5830,-3608,18.6,1572.9,14,6,14,1,0,1,1,21559,7.4,20067,225,56,5830,3608,22.5,2155.9,red,1,4.67,19,21,red
4513995465,2,9,0,1,1,0,0,14814,7,17587,222,64,-3402,-1459,22.2,1481.4,9,2,11,0,0,0,0,18216,7.4,19046,229,59,3402,1459,22.9,1821.6,red,0.22,10,18,25,red
4514844694,6,2,5,1,1,0,0,16610,7,18058,227,48,2044,378,22.7,1661,2,6,2,0,0,0,0,14566,7,17680,220,54,-2044,-378,22,1456.6,red,5.5,0.67,21,17,blue
4516036728,7,6,7,2,1,1,0,17588,7,18328,233,63,1219,292,23.3,1758.8,6,7,10,0,0,0,0,16369,6.8,18036,216,45,-1219,-292,21.6,1636.9,blue,2.33,2.29,18,17,blue
4500905906,6,4,4,1,1,0,0,16017,7.2,17471,208,51,1598,2478,20.8,1601.7,4,6,6,0,0,0,0,14419,6.2,14993,194,34,-1598,-2478,19.4,1441.9,red,2.5,1.67,33,19,red
4518770887,2,5,5,0,0,0,0,14851,6.6,17101,245,41,-1068,-17,24.5,1485.1,5,2,7,2,1,1,0,15919,6.8,17118,212,46,1068,17,21.2,1591.9,red,1.4,6,21,15,red
4500845726,4,7,3,2,1,1,0,15420,6.8,17930,235,43,-2264,-1389,23.5,1542,7,4,7,0,0,0,0,17684,7.4,19319,237,69,2264,1389,23.7,1768.4,red,1,3.5,23,25,blue
4505146259,6,8,9,0,0,0,0,15476,6.6,16323,192,40,-963,-546,19.2,1547.6,8,6,7,1,1,0,0,16439,6.6,16869,164,64,963,546,16.4,1643.9,blue,1.88,2.5,20,17,red
4484501357,1,5,3,0,0,0,0,14463,6.8,18394,224,68,-2820,-1048,22.4,1446.3,5,1,8,1,1,0,0,17283,7.4,19442,258,68,2820,1048,25.8,1728.3,red,0.8,13,20,20,red
4447213073,9,6,15,1,1,0,0,17653,7.2,18042,218,40,1931,92,21.8,1765.3,6,9,6,0,0,0,0,15722,7,17950,205,44,-1931,-92,20.5,1572.2,blue,4,1.33,20,19,blue
4523850579,3,2,1,0,0,0,0,15097,7.2,18396,218,65,-429,55,21.8,1509.7,2,3,1,2,1,1,0,15526,7.2,18341,244,64,429,-55,24.4,1552.6,red,2,1,20,13,blue
4512777907,6,4,2,1,1,0,0,16476,7,18421,238,64,-323,345,23.8,1647.6,4,6,10,0,0,0,0,16799,7,18076,231,60,323,-345,23.1,1679.9,blue,2,2.33,21,23,blue
4505255448,12,1,12,1,1,0,0,20136,7.8,20899,235,61,6290,4719,23.5,2013.6,1,12,0,0,0,0,0,13846,6.4,16180,201,63,-6290,-4719,20.1,1384.6,blue,24,0.08,19,13,blue
4525150021,2,2,3,0,0,0,0,14385,6.6,17383,216,49,-959,-1331,21.6,1438.5,2,2,2,1,1,0,0,15344,7,18714,223,80,959,1331,22.3,1534.4,red,2.5,2,14,18,blue
4493134423,6,9,4,0,0,0,0,16672,7,18758,231,52,-1112,311,23.1,1667.2,9,6,8,0,0,0,0,17784,6.8,18447,211,36,1112,-311,21.1,1778.4,red,1.11,2.83,35,16,blue
4518605903,6,9,7,0,0,0,0,17286,7.2,18839,222,61,431,625,22.2,1728.6,9,6,7,1,1,0,0,16855,7,18214,193,43,-431,-625,19.3,1685.5,blue,1.44,2.67,22,15,red
4501794843,4,1,4,0,0,0,0,16385,7,18374,249,44,3001,1223,24.9,1638.5,1,4,0,1,1,0,0,13384,6.8,17151,213,42,-3001,-1223,21.3,1338.4,red,8,0.25,19,61,blue
4525061092,9,6,7,0,0,0,0,16902,6.8,17878,207,49,1451,1154,20.7,1690.2,6,9,7,0,0,0,0,15451,6.8,16724,199,44,-1451,-1154,19.9,1545.1,blue,2.67,1.44,18,16,blue
4510905499,8,2,11,2,1,1,0,17127,7.2,19195,221,56,2735,2319,22.1,1712.7,2,8,2,0,0,0,0,14392,6.6,16876,208,56,-2735,-2319,20.8,1439.2,blue,9.5,0.5,59,18,blue
4458512740,9,2,13,0,0,0,0,18383,7,18694,233,37,4152,1466,23.3,1838.3,2,9,2,1,0,1,0,14231,7,17228,213,48,-4152,-1466,21.3,1423.1,blue,11,0.44,17,17,blue
4524110261,6,10,4,0,0,0,0,15475,6.4,15944,205,42,-2395,-3117,20.5,1547.5,10,6,13,1,1,0,0,17870,7.2,19061,210,53,2395,3117,21,1787,red,1,3.83,12,38,red
4516554844,12,11,13,0,0,0,0,18950,7.4,18183,216,40,227,939,21.6,1895,11,12,13,0,0,0,0,18723,6.8,17244,217,44,-227,-939,21.7,1872.3,blue,2.27,2,20,21,red
4518463691,7,0,11,1,1,0,0,16942,6.6,17249,214,48,3843,2831,21.4,1694.2,0,7,0,0,0,0,0,13099,6.2,14418,191,46,-3843,-2831,19.1,1309.9,blue,12.03,0,24,15,blue
4518585607,3,7,3,0,0,0,0,15423,7.2,18648,232,52,-2055,-860,23.2,1542.3,7,3,10,1,1,0,0,17478,7.2,19508,258,52,2055,860,25.8,1747.8,red,0.86,5.67,31,20,red
4491980235,10,7,10,0,0,0,0,18296,7,18788,208,52,1011,17,20.8,1829.6,7,10,8,0,0,0,0,17285,7,18771,237,48,-1011,-17,23.7,1728.5,red,2.86,1.5,16,21,blue
4508411042,6,13,6,0,0,0,0,15166,6.6,15761,162,44,-3865,-2920,16.2,1516.6,13,6,17,1,1,0,0,19031,7,18681,204,52,3865,2920,20.4,1903.1,red,0.92,5,20,23,red
4513194329,5,8,6,0,0,0,0,16230,6.8,18114,230,57,-1222,-125,23,1623,8,5,9,1,0,1,0,17452,6.8,18239,221,36,1222,125,22.1,1745.2,red,1.38,3.4,20,22,red
4523821481,14,3,17,1,1,0,0,20005,7.4,20561,222,68,5201,4398,22.2,2000.5,3,14,3,0,0,0,0,14804,6.6,16163,211,44,-5201,-4398,21.1,1480.4,blue,10.33,0.43,21,72,blue
4477453234,2,1,3,0,0,0,0,14485,6.6,17358,211,40,-953,-862,21.1,1448.5,1,2,2,0,0,0,0,15438,7,18220,246,60,953,862,24.6,1543.8,red,5,1.5,20,22,blue
4475645172,2,2,3,1,1,0,0,15313,7,18483,221,66,496,1365,22.1,1531.3,2,2,2,0,0,0,0,14817,6.8,17118,237,48,-496,-1365,23.7,1481.7,red,2.5,2,37,17,red
4517513355,9,6,7,0,0,0,0,17147,7.2,19004,197,52,1412,1897,19.7,1714.7,6,9,4,1,1,0,0,15735,6.8,17107,210,43,-1412,-1897,21,1573.5,blue,2.67,1.11,21,20,blue
4450783811,5,7,4,0,0,0,0,16078,6.8,18042,217,60,-1408,-1192,21.7,1607.8,7,5,12,1,1,0,0,17486,7,19234,245,58,1408,1192,24.5,1748.6,red,1.29,3.8,18,17,red
4514536242,4,5,5,0,0,0,0,14511,6.2,17013,193,52,-2246,-961,19.3,1451.1,5,4,7,1,1,0,0,16757,7,17974,233,44,2246,961,23.3,1675.7,red,1.8,3,48,24,red
4525242190,4,1,4,1,1,0,0,15224,6.6,17138,218,54,1168,481,21.8,1522.4,1,4,0,0,0,0,0,14056,6.4,16657,231,48,-1168,-481,23.1,1405.6,red,8,0.25,20,17,blue
4520538056,7,10,7,0,0,0,0,15989,6.4,16090,179,32,-2662,-2170,17.9,1598.9,10,7,16,1,1,0,0,18651,7,18260,204,43,2662,2170,20.4,1865.1,red,1.4,3.71,43,19,blue
4434566709,7,1,10,0,0,0,0,17558,7.2,19554,251,51,2704,1740,25.1,1755.8,1,7,1,1,1,0,0,14854,6.6,17814,224,72,-2704,-1740,22.4,1485.4,blue,17,0.29,20,18,blue
4378541993,5,4,2,0,0,0,0,15215,6.6,16664,212,41,0,-368,21.2,1521.5,4,5,5,1,1,0,0,15215,6.8,17032,197,55,0,368,19.7,1521.5,blue,1.75,1.8,17,38,blue
4514036288,4,9,2,0,0,0,0,14887,6.4,15841,209,38,-3088,-2028,20.9,1488.7,9,4,12,0,0,0,0,17975,6.8,17869,203,39,3088,2028,20.3,1797.5,blue,0.67,5.25,19,19,blue
4482303478,2,12,1,0,0,0,0,14100,6.6,16725,204,48,-5508,-3521,20.4,1410,12,2,15,1,1,0,0,19608,7.6,20246,239,56,5508,3521,23.9,1960.8,red,0.25,13.5,16,15,red
4471300165,7,5,7,1,1,0,0,17097,7,17368,199,62,1800,546,19.9,1709.7,5,7,9,0,0,0,0,15297,6.6,16822,182,41,-1800,-546,18.2,1529.7,blue,2.8,2,21,20,red
4437158302,2,10,0,0,0,0,0,14082,6.6,16368,238,29,-3196,-1322,23.8,1408.2,10,2,14,1,1,0,0,17278,6.8,17690,216,60,3196,1322,21.6,1727.8,red,0.2,12,18,16,red
4504089407,6,6,7,0,0,0,0,17500,7.2,18692,226,56,2077,266,22.6,1750,6,6,4,1,1,0,0,15423,6.8,18426,212,47,-2077,-266,21.2,1542.3,blue,2.17,1.67,10,18,blue
4508792949,11,4,12,2,1,1,0,17970,7.2,19866,208,64,2003,2155,20.8,1797,4,11,4,0,0,0,0,15967,7,17711,230,54,-2003,-2155,23,1596.7,blue,5.75,0.73,13,21,blue
4512064032,4,4,5,0,0,0,0,15198,7,18486,205,60,-266,15,20.5,1519.8,4,4,2,1,1,0,0,15464,7,18471,224,57,266,-15,22.4,1546.4,blue,2.25,1.5,15,20,red
4522584665,5,3,3,0,0,0,0,17194,7.4,19447,263,61,2588,1628,26.3,1719.4,3,5,3,0,0,0,0,14606,7,17819,215,37,-2588,-1628,21.5,1460.6,blue,2.67,1.2,43,16,blue
4515418492,3,7,3,0,0,0,0,14951,6.8,17632,206,48,-2002,-565,20.6,1495.1,7,3,6,1,1,0,0,16953,7,18197,214,59,2002,565,21.4,1695.3,red,0.86,4.33,19,17,blue
4522629474,7,2,9,1,1,0,0,16966,7.2,19062,222,55,1996,2078,22.2,1696.6,2,7,2,0,0,0,0,14970,6.8,16984,222,43,-1996,-2078,22.2,1497,red,8,0.57,46,19,blue
4521033474,3,6,4,1,1,0,0,14513,6.8,16872,202,52,-1494,-368,20.2,1451.3,6,3,5,0,0,0,0,16007,6.8,17240,232,51,1494,368,23.2,1600.7,blue,1.17,3.67,22,21,red
4502741131,10,7,13,0,0,0,0,18446,7.2,19075,195,44,1918,1638,19.5,1844.6,7,10,8,2,1,1,0,16528,7,17437,191,48,-1918,-1638,19.1,1652.8,red,3.29,1.5,18,13,blue
4521393956,8,6,9,0,0,0,0,17100,7.2,18774,213,55,825,318,21.3,1710,6,8,10,1,1,0,0,16275,7.2,18456,196,56,-825,-318,19.6,1627.5,red,2.83,2,24,17,red
4506646295,13,7,16,2,1,1,1,20611,7,19378,210,51,4096,3516,21,2061.1,7,13,8,0,0,0,0,16515,6.4,15862,166,44,-4096,-3516,16.6,1651.5,blue,4.14,1.15,22,19,blue
4464361893,8,7,11,0,0,0,0,18672,7.2,19296,250,55,2427,742,25,1867.2,7,8,5,1,1,0,0,16245,7,18554,184,49,-2427,-742,18.4,1624.5,blue,2.71,1.5,20,17,red
4519911562,1,3,1,0,0,0,0,14988,7.2,18065,256,44,428,-36,25.6,1498.8,3,1,1,1,1,0,0,14560,7,18101,220,56,-428,36,22,1456,red,0.67,4,19,22,red
4523830779,6,10,5,0,0,0,0,17250,7,18266,222,60,-862,-1596,22.2,1725,10,6,11,0,0,0,0,18112,7.4,19862,216,43,862,1596,21.6,1811.2,red,1.1,3.5,15,12,blue
4519439702,11,3,14,1,0,1,1,20145,7.4,19898,242,39,5634,2094,24.2,2014.5,3,11,1,1,1,0,0,14511,6.8,17804,196,85,-5634,-2094,19.6,1451.1,blue,8.33,0.36,46,18,blue
4455410303,7,4,8,1,1,0,0,17325,7,18954,207,55,1243,1506,20.7,1732.5,4,7,4,0,0,0,0,16082,6.8,17448,218,59,-1243,-1506,21.8,1608.2,blue,3.75,1.14,20,18,red
4472741177,10,1,7,1,0,1,0,19336,7.8,21123,267,52,6221,6143,26.7,1933.6,1,10,1,1,1,0,0,13115,6.2,14980,205,40,-6221,-6143,20.5,1311.5,blue,17,0.2,31,19,blue
4520036166,1,11,0,0,0,0,0,13701,6.6,15626,200,48,-4873,-2666,20,1370.1,11,1,12,1,1,0,0,18574,7.2,18292,222,46,4873,2666,22.2,1857.4,red,0.09,23,16,16,red
4497475863,6,5,6,1,1,0,0,15765,7,17647,214,45,-164,-313,21.4,1576.5,5,6,6,0,0,0,0,15929,6.8,17960,218,47,164,313,21.8,1592.9,red,2.4,1.83,37,14,blue
4524450290,4,2,2,0,0,0,0,14841,7,17969,183,72,-224,635,18.3,1484.1,2,4,2,2,1,1,0,15065,6.8,17334,234,56,224,-635,23.4,1506.5,red,3,1,23,45,red
4522471195,4,4,4,0,0,0,0,15597,6.8,17541,232,36,717,215,23.2,1559.7,4,4,3,1,1,0,0,14880,6.8,17326,197,52,-717,-215,19.7,1488,red,2,1.75,26,17,blue
4521939526,1,7,0,0,0,0,0,13828,6.6,16964,228,53,-3588,-2501,22.8,1382.8,7,1,6,0,0,0,0,17416,7.2,19465,258,60,3588,2501,25.8,1741.6,red,0.14,13,16,19,red
4515391813,6,5,9,0,0,0,0,16275,7.2,18687,209,46,-184,57,20.9,1627.5,5,6,3,1,1,0,0,16459,7.2,18630,250,60,184,-57,25,1645.9,red,3,1.33,17,16,red
4525068217,5,7,5,0,0,0,0,16763,7.2,19010,252,48,-729,-620,25.2,1676.3,7,5,6,2,1,1,0,17492,7.2,19630,241,61,729,620,24.1,1749.2,red,1.43,2.6,41,48,red
4521099004,16,5,28,0,0,0,0,21089,7,18924,218,55,5859,3289,21.8,2108.9,5,16,7,0,0,0,0,15230,6.4,15635,205,41,-5859,-3289,20.5,1523,blue,8.8,0.75,42,25,blue
4481839790,4,8,2,0,0,0,0,15155,6.6,16875,201,68,-2548,-826,20.1,1515.5,8,4,10,1,1,0,0,17703,7.2,17701,212,44,2548,826,21.2,1770.3,red,0.75,4.5,15,15,red
4494508204,8,3,9,2,1,1,0,17226,7.2,18458,193,59,2061,1693,19.3,1722.6,3,8,5,0,0,0,0,15165,6.4,16765,220,43,-2061,-1693,22,1516.5,blue,5.67,1,49,22,blue
4516392840,7,7,6,1,0,1,0,17634,7.2,18416,237,52,825,-1367,23.7,1763.4,7,7,4,1,1,0,0,16809,7,19783,215,59,-825,1367,21.5,1680.9,red,1.86,1.57,12,14,blue
4509353286,9,3,8,1,1,0,0,17562,7,18512,224,50,1948,764,22.4,1756.2,3,9,6,0,0,0,0,15614,7,17748,202,62,-1948,-764,20.2,1561.4,blue,5.67,1,19,15,red
4515245174,5,6,7,0,0,0,0,16161,7,18920,214,63,-167,855,21.4,1616.1,6,5,7,0,0,0,0,16328,7.2,18065,213,48,167,-855,21.3,1632.8,blue,2,2.6,98,43,red
4497565171,13,5,18,1,1,0,1,20853,7.4,20447,251,49,5477,3692,25.1,2085.3,5,13,4,0,0,0,0,15376,6.6,16755,206,46,-5477,-3692,20.6,1537.6,blue,6.2,0.69,14,16,blue
4520358901,1,5,1,1,0,1,0,15743,6.8,18383,264,61,-251,557,26.4,1574.3,5,1,11,1,1,0,0,15994,7,17826,210,56,251,-557,21,1599.4,blue,0.4,16,19,19,red
4511992629,3,3,6,1,0,1,0,15204,6.8,17963,209,68,153,917,20.9,1520.4,3,3,3,1,1,0,0,15051,6.8,17046,232,51,-153,-917,23.2,1505.1,blue,3,2,20,17,blue
4513252060,3,4,4,0,0,0,0,15013,6.6,16860,212,56,-741,-637,21.2,1501.3,4,3,7,1,1,0,0,15754,6.8,17497,225,55,741,637,22.5,1575.4,red,1.75,3.67,17,20,red
4524160541,11,4,8,1,0,1,1,20176,7.6,19773,260,55,5830,1979,26,2017.6,4,11,0,0,0,0,0,14346,6.8,17794,194,52,-5830,-1979,19.4,1434.6,blue,4.75,0.36,118,26,blue
4419275391,6,6,5,0,0,0,0,15856,7,17723,224,47,-460,60,22.4,1585.6,6,6,7,1,1,0,0,16316,6.8,17663,238,36,460,-60,23.8,1631.6,red,1.83,2.17,17,18,red
4524796827,9,4,10,2,1,1,0,17097,7.2,18583,220,47,1186,907,22,1709.7,4,9,3,0,0,0,0,15911,7,17676,213,68,-1186,-907,21.3,1591.1,blue,4.75,0.78,17,15,blue
4516360817,6,8,7,0,0,0,0,16595,7.2,18766,217,57,-829,289,21.7,1659.5,8,6,10,2,1,1,0,17424,7.2,18477,220,62,829,-289,22,1742.4,red,1.62,3,43,20,blue
4514809732,3,5,4,0,0,0,0,13952,6.2,15665,172,47,-3559,-2812,17.2,1395.2,5,3,3,2,1,1,1,17511,7,18477,230,57,3559,2812,23,1751.1,red,1.4,2.67,53,128,red
4513037012,11,7,6,2,1,1,0,18413,7.2,19681,228,60,2377,2335,22.8,1841.3,7,11,7,0,0,0,0,16036,7,17346,172,60,-2377,-2335,17.2,1603.6,blue,2.43,1.27,22,24,blue
4495029898,5,2,9,0,0,0,0,16113,7,18642,236,53,1277,1357,23.6,1611.3,2,5,4,1,1,0,0,14836,6.8,17285,221,54,-1277,-1357,22.1,1483.6,red,7,1.2,21,25,blue
4516616203,2,5,1,0,0,0,0,15508,7,17985,258,60,-919,-923,25.8,1550.8,5,2,8,0,0,0,0,16427,7.2,18908,226,48,919,923,22.6,1642.7,blue,0.6,6.5,23,13,red
4518053347,12,9,16,1,1,0,0,18345,6.8,17559,222,32,941,-561,22.2,1834.5,9,12,8,1,0,1,0,17404,7,18120,207,48,-941,561,20.7,1740.4,red,3.11,1.42,21,18,blue
4515343206,12,11,10,0,0,0,0,18882,7.2,19357,224,56,291,839,22.4,1888.2,11,12,13,0,0,0,0,18591,6.8,18518,222,38,-291,-839,22.2,1859.1,blue,2,2,20,23,blue
4488342223,3,6,1,0,0,0,0,14734,6.8,17665,226,42,-1871,-605,22.6,1473.4,6,3,6,0,0,0,0,16605,7,18270,231,48,1871,605,23.1,1660.5,red,0.67,4,14,19,blue
4449468024,4,9,4,0,0,0,0,15337,6.8,17456,211,43,-1167,-1265,21.1,1533.7,9,4,8,0,0,0,0,16504,7,18721,173,45,1167,1265,17.3,1650.4,red,0.89,4.25,35,22,red
4521833199,2,2,2,0,0,0,0,15280,7.2,18773,257,64,447,609,25.7,1528,2,2,2,1,1,0,0,14833,6.8,18164,240,51,-447,-609,24,1483.3,red,2,2,20,19,red
4523056816,7,2,8,0,0,0,0,16861,7.2,18561,196,51,2211,1501,19.6,1686.1,2,7,1,1,1,0,0,14650,7,17060,208,48,-2211,-1501,20.8,1465,blue,7.5,0.43,18,34,blue
4516980931,5,11,3,0,0,0,0,16321,7,17802,185,64,-2593,-1668,18.5,1632.1,11,5,18,1,1,0,0,18914,7.2,19470,245,45,2593,1668,24.5,1891.4,blue,0.73,5.8,13,12,red
4488789257,5,7,8,0,0,0,0,15885,6.6,16848,220,43,-1566,-2539,22,1588.5,7,5,7,1,1,0,0,17451,7.2,19387,221,80,1566,2539,22.1,1745.1,red,1.86,2.8,20,22,blue
4474587492,5,11,3,0,0,0,0,16007,6.6,17004,206,64,-3397,-2492,20.6,1600.7,11,5,8,1,1,0,1,19404,7.2,19496,229,68,3397,2492,22.9,1940.4,red,0.73,3.8,13,21,red
4440152952,6,6,8,0,0,0,0,16171,6.8,17226,191,52,-857,-1356,19.1,1617.1,6,6,5,1,1,0,0,17028,7,18582,234,59,857,1356,23.4,1702.8,blue,2.33,1.83,19,20,red
4521361583,8,9,8,0,0,0,0,15726,6.4,16968,176,45,-3796,-326,17.6,1572.6,9,8,7,0,0,0,1,19522,6.8,17294,219,40,3796,326,21.9,1952.2,red,1.78,2,20,24,red
4465302034,7,13,6,0,0,0,0,16851,6.8,17624,215,52,-2174,-117,21.5,1685.1,13,7,17,0,0,0,0,19025,7,17741,211,52,2174,117,21.1,1902.5,red,1,4.29,23,20,red
4458497887,5,6,4,0,0,0,0,14448,6.8,17263,156,36,-2969,-1135,15.6,1444.8,6,5,8,1,1,0,0,17417,7,18398,225,70,2969,1135,22.5,1741.7,red,1.5,2.8,17,39,red
4524068681,3,3,3,0,0,0,0,15045,6.6,16887,221,46,220,-284,22.1,1504.5,3,3,5,0,0,0,0,14825,6.8,17171,199,39,-220,284,19.9,1482.5,blue,2,2.67,19,22,blue
4496547749,8,9,8,2,1,1,0,17267,7,17580,203,51,-356,-408,20.3,1726.7,9,8,16,0,0,0,0,17623,6.8,17988,180,44,356,408,18,1762.3,blue,1.78,3.12,16,51,blue
4516748308,8,6,4,0,0,0,1,17706,6.8,18003,194,40,1893,763,19.4,1770.6,6,8,7,1,1,0,0,15813,6.6,17240,193,44,-1893,-763,19.3,1581.3,blue,2,1.62,16,17,blue
4469636302,5,7,5,0,0,0,0,15576,6.6,16352,221,35,-887,-1878,22.1,1557.6,7,5,7,1,0,1,0,16463,7,18230,197,68,887,1878,19.7,1646.3,red,1.43,2.8,14,16,blue
4518861669,6,4,7,1,1,0,0,17084,7.2,18215,227,59,2439,2070,22.7,1708.4,4,6,9,0,0,0,0,14645,6.6,16145,208,45,-2439,-2070,20.8,1464.5,blue,3.25,2.17,21,47,blue
4519896224,6,10,8,1,1,0,0,15614,6.4,16000,196,27,-2683,-3323,19.6,1561.4,10,6,7,1,0,1,0,18297,7.4,19323,223,52,2683,3323,22.3,1829.7,red,1.4,2.83,23,20,blue
4500210333,10,1,13,1,1,0,0,19602,7.4,20259,236,57,5238,2654,23.6,1960.2,1,10,2,0,0,0,0,14364,6.8,17605,209,76,-5238,-2654,20.9,1436.4,blue,23,0.3,28,67,blue
4516773266,2,7,1,0,0,0,0,15409,7,18219,247,64,-2550,-792,24.7,1540.9,7,2,10,1,1,0,0,17959,7,19011,256,52,2550,792,25.6,1795.9,red,0.43,8.5,27,23,blue
4499860078,4,1,8,0,0,0,0,14298,6.4,15101,171,33,852,-26,17.1,1429.8,1,4,1,0,0,0,0,13446,6.4,15127,213,39,-852,26,21.3,1344.6,blue,12,0.5,17,14,blue
4524209230,7,2,10,2,1,1,0,18507,7.2,19423,245,52,3756,1754,24.5,1850.7,2,7,3,0,0,0,0,14751,6.6,17669,247,48,-3756,-1754,24.7,1475.1,blue,8.5,0.71,10,17,blue
4495909793,5,6,5,0,0,0,0,16179,7,18305,263,32,-97,1114,26.3,1617.9,6,5,7,2,1,1,0,16276,6.8,17191,221,60,97,-1114,22.1,1627.6,red,1.67,2.6,18,18,red
4513165995,7,4,6,1,1,0,0,17018,7.2,19495,238,40,1463,1571,23.8,1701.8,4,7,4,0,0,0,0,15555,7,17924,219,55,-1463,-1571,21.9,1555.5,blue,3.25,1.14,24,23,blue
4487965744,3,4,4,1,1,0,0,15306,6.8,16874,220,52,-961,-1427,22,1530.6,4,3,1,0,0,0,0,16267,7.2,18301,256,62,961,1427,25.6,1626.7,red,1.75,1.67,41,18,red
4489207578,4,5,4,0,0,0,0,15079,7,18092,196,55,-1226,-1378,19.6,1507.9,5,4,3,0,0,0,0,16305,7.2,19470,261,56,1226,1378,26.1,1630.5,red,1.6,2,22,42,blue
4504056822,9,7,11,1,1,0,0,17622,7.2,17879,192,52,173,41,19.2,1762.2,7,9,7,0,0,0,0,17449,6.8,17838,227,44,-173,-41,22.7,1744.9,blue,2.86,1.56,18,19,blue
4524110417,9,6,5,0,0,0,0,17341,7.2,19621,203,51,1266,1770,20.3,1734.1,6,9,6,0,0,0,0,16075,7,17851,193,52,-1266,-1770,19.3,1607.5,red,2.33,1.33,21,43,blue
4516604848,6,6,5,0,0,0,0,15868,6.6,16452,201,38,-585,-795,20.1,1586.8,6,6,7,0,0,0,0,16453,6.8,17247,242,41,585,795,24.2,1645.3,red,1.83,2.17,16,20,blue
4496540023,9,10,8,1,1,0,0,17170,7,18583,204,46,-522,226,20.4,1717,10,9,10,0,0,0,0,17692,7,18357,192,42,522,-226,19.2,1769.2,blue,1.7,2.22,22,18,red
4517001678,6,12,5,1,1,0,0,15716,6.8,17135,189,46,-3393,-1177,18.9,1571.6,12,6,19,0,0,0,0,19109,6.8,18312,206,44,3393,1177,20.6,1910.9,red,0.92,5.17,16,17,red
4460970980,3,8,3,0,0,0,0,15036,7.2,17957,198,60,-2855,-2453,19.8,1503.6,8,3,7,1,1,0,0,17891,7.4,20410,269,52,2855,2453,26.9,1789.1,red,0.75,5,15,17,red
4523826301,8,9,5,0,0,0,0,16608,7.2,18490,201,40,-114,1359,20.1,1660.8,9,8,10,1,1,0,0,16722,6.8,17131,200,50,114,-1359,20,1672.2,blue,1.44,2.38,45,23,red
4524622729,6,8,9,0,0,0,0,16116,6.8,17070,196,64,-77,416,19.6,1611.6,8,6,11,1,1,0,0,16193,6.6,16654,204,43,77,-416,20.4,1619.3,red,1.88,3.17,19,19,red
4462061093,13,3,11,1,1,0,0,21386,7.4,20807,264,60,7420,5869,26.4,2138.6,3,13,3,0,0,0,0,13966,6,14938,190,43,-7420,-5869,19,1396.6,blue,8,0.46,42,18,blue
4462053838,7,6,8,0,0,0,0,16441,6.4,16272,218,42,132,-2613,21.8,1644.1,6,7,6,1,1,0,0,16309,7,18885,203,69,-132,2613,20.3,1630.9,red,2.5,1.71,20,44,red
4462226806,6,8,4,0,0,0,0,15446,6.4,16131,198,47,-1995,-1392,19.8,1544.6,8,6,7,1,1,0,0,17441,7,17523,216,44,1995,1392,21.6,1744.1,red,1.25,2.5,10,13,red
4515286916,5,7,7,0,0,0,0,15799,6.4,16589,224,32,-1069,-1901,22.4,1579.9,7,5,5,0,0,0,0,16868,7,18490,215,53,1069,1901,21.5,1686.8,red,1.71,2.4,43,24,blue
4507879201,9,11,11,1,1,0,0,17909,7,18562,214,43,-292,-506,21.4,1790.9,11,9,13,0,0,0,0,18201,7.2,19068,205,52,292,506,20.5,1820.1,blue,1.82,2.67,22,19,red
4470286128,4,13,5,0,0,0,0,15309,6.6,16938,175,48,-4962,-2312,17.5,1530.9,13,4,14,1,0,1,0,20271,7.2,19250,242,38,4962,2312,24.2,2027.1,red,0.69,6.75,19,19,red
4470651076,13,4,11,1,1,0,0,19077,7.2,18861,215,63,3669,3030,21.5,1907.7,4,13,5,0,0,0,0,15408,6.4,15831,207,45,-3669,-3030,20.7,1540.8,blue,6,0.69,15,18,blue
4455008187,7,7,5,0,0,0,0,15321,6.6,17311,171,44,-2338,-2724,17.1,1532.1,7,7,10,0,0,0,0,17659,7.4,20035,225,47,2338,2724,22.5,1765.9,red,1.71,2.43,22,18,blue
4462288936,3,8,2,0,0,0,0,14522,6.4,15305,211,39,-3596,-2738,21.1,1452.2,8,3,6,1,0,1,1,18118,7,18043,236,52,3596,2738,23.6,1811.8,red,0.62,4.67,105,43,red
4497473518,8,7,7,2,1,1,0,17996,7,18896,208,64,1295,435,20.8,1799.6,7,8,5,0,0,0,0,16701,7,18461,227,52,-1295,-435,22.7,1670.1,red,2.14,1.5,17,45,red
4475645681,6,7,10,1,1,0,0,16447,7,18423,201,60,-168,376,20.1,1644.7,7,6,10,0,0,0,0,16615,7,18047,224,42,168,-376,22.4,1661.5,red,2.29,2.83,20,20,blue
4509931698,0,7,0,0,0,0,0,13068,6.4,15506,198,48,-5375,-4425,19.8,1306.8,7,0,5,2,1,1,0,18443,7.2,19931,235,63,5375,4425,23.5,1844.3,red,0,12.65,13,125,red
4525232223,9,5,8,0,0,0,0,17757,7,18821,217,48,2341,2225,21.7,1775.7,5,9,5,1,1,0,0,15416,6.8,16596,185,58,-2341,-2225,18.5,1541.6,red,3.4,1.11,22,21,blue
4519116832,9,9,11,0,0,0,0,17459,6.8,17338,226,44,-531,-1077,22.6,1745.9,9,9,11,0,0,0,0,17990,7.2,18415,200,43,531,1077,20,1799,red,2.22,2.22,20,85,blue
4523397279,3,7,1,0,0,0,0,14068,6.8,17057,206,40,-3083,-2239,20.6,1406.8,7,3,6,0,0,0,0,17151,7,19296,252,32,3083,2239,25.2,1715.1,blue,0.57,4.33,33,47,red
4505988768,3,8,1,0,0,0,0,13960,6.2,15667,202,39,-4808,-4098,20.2,1396,8,3,9,1,1,0,0,18768,7.4,19765,241,73,4808,4098,24.1,1876.8,red,0.5,5.67,38,19,red
4453255599,10,13,8,1,0,1,0,18255,6.8,17685,206,29,-1237,-874,20.6,1825.5,13,10,22,0,0,0,0,19492,7,18559,203,50,1237,874,20.3,1949.2,blue,1.38,3.5,20,15,red
4517481803,7,5,8,0,0,0,0,17134,7,19465,207,60,408,742,20.7,1713.4,5,7,4,1,1,0,0,16726,7.2,18723,236,56,-408,-742,23.6,1672.6,blue,3,1.29,18,18,blue
4477045051,10,9,12,0,0,0,0,17487,6.8,17660,211,41,274,-459,21.1,1748.7,9,10,13,1,1,0,0,17213,7,18119,198,52,-274,459,19.8,1721.3,red,2.44,2.2,23,17,blue
4519240372,6,10,4,0,0,0,0,16335,6.6,17339,192,45,-956,16,19.2,1633.5,10,6,11,1,0,1,0,17291,6.8,17323,202,32,956,-16,20.2,1729.1,red,1,3.5,17,22,blue
4499861497,5,5,6,1,0,1,0,16405,7,18502,239,43,861,1078,23.9,1640.5,5,5,9,1,1,0,0,15544,6.6,17424,233,44,-861,-1078,23.3,1554.4,blue,2.2,2.8,17,16,blue
4517783802,3,11,5,0,0,0,0,14145,6,15252,186,40,-5471,-4481,18.6,1414.5,11,3,10,2,1,1,1,19616,7.6,19733,228,57,5471,4481,22.8,1961.6,red,0.73,7,12,12,blue
4523495591,5,5,6,0,0,0,0,16419,6.8,17295,233,42,159,363,23.3,1641.9,5,5,5,2,1,1,0,16260,6.6,16932,194,68,-159,-363,19.4,1626,blue,2.2,2,48,16,red
4507582515,3,4,3,0,0,0,0,14482,6.8,17114,198,34,-3335,-2502,19.8,1448.2,4,3,4,2,1,1,1,17817,7.2,19616,248,52,3335,2502,24.8,1781.7,blue,1.5,2.67,55,24,blue
4442492836,5,4,5,1,1,0,0,15967,6.8,17855,203,62,803,798,20.3,1596.7,4,5,6,0,0,0,0,15164,6.8,17057,226,38,-803,-798,22.6,1516.4,blue,2.5,2,43,19,blue
4519612856,5,9,5,0,0,0,0,16093,6.8,17056,209,49,-700,-1781,20.9,1609.3,9,5,6,0,0,0,0,16793,7,18837,192,40,700,1781,19.2,1679.3,red,1.11,3,21,20,red
4516101575,16,4,13,0,0,0,0,20827,7.4,19657,215,50,5491,4640,21.5,2082.7,4,16,4,0,0,0,0,15336,6.4,15017,183,54,-5491,-4640,18.3,1533.6,blue,7.25,0.5,22,20,blue
4522209032,4,4,2,1,1,0,0,14697,7,17818,222,48,-1620,-1655,22.2,1469.7,4,4,4,0,0,0,0,16317,7.4,19473,255,72,1620,1655,25.5,1631.7,red,1.5,2,19,17,red
4516964938,10,11,10,0,0,0,0,17702,6.4,16589,198,44,-1478,-1657,19.8,1770.2,11,10,14,0,0,0,0,19180,6.8,18246,202,52,1478,1657,20.2,1918,red,1.82,2.5,19,18,red
4514521054,2,9,2,1,1,0,0,14730,6.6,17103,246,41,-4406,-2663,24.6,1473,9,2,6,1,0,1,1,19136,7.6,19766,233,60,4406,2663,23.3,1913.6,red,0.44,7.5,19,31,red
4501029186,6,10,10,0,0,0,0,16876,6.6,16812,238,40,-1015,-1031,23.8,1687.6,10,6,9,0,0,0,0,17891,6.8,17843,212,48,1015,1031,21.2,1789.1,red,1.6,3.17,21,21,red
4513514552,5,15,7,0,0,0,0,16203,6.6,17059,187,56,-5057,-3732,18.7,1620.3,15,5,16,1,1,0,0,21260,7.4,20791,255,56,5057,3732,25.5,2126,blue,0.8,6.2,16,22,red
4508400080,7,7,7,1,0,1,0,17214,7.2,18232,219,44,1465,1232,21.9,1721.4,7,7,4,1,1,0,0,15749,6.8,17000,193,49,-1465,-1232,19.3,1574.9,red,2,1.57,14,24,blue
4488286080,1,8,0,1,1,0,0,14019,6.6,17177,206,64,-3720,-2126,20.6,1401.9,8,1,10,0,0,0,0,17739,7.4,19303,251,33,3720,2126,25.1,1773.9,blue,0.12,18,26,28,red
4464174645,8,10,2,0,0,0,0,16163,6.8,16956,201,32,-1825,-1174,20.1,1616.3,10,8,13,1,1,0,0,17988,7.2,18130,196,40,1825,1174,19.6,1798.8,red,1,2.88,19,21,red
4498395907,5,7,7,2,1,1,0,15745,6.8,17708,225,52,-2082,-1005,22.5,1574.5,7,5,5,0,0,0,0,17827,7,18713,264,56,2082,1005,26.4,1782.7,red,1.71,2.4,44,24,red
4509719745,13,6,13,0,0,0,0,18933,7.4,19905,210,45,2109,3154,21,1893.3,6,13,10,0,0,0,0,16824,6.6,16751,194,50,-2109,-3154,19.4,1682.4,blue,4.33,1.23,50,21,red
4502410789,4,4,4,1,1,0,0,16452,7.4,19169,266,60,772,702,26.6,1645.2,4,4,2,0,0,0,0,15680,7,18467,215,60,-772,-702,21.5,1568,blue,2,1.5,19,44,red
4496572605,6,4,11,0,0,0,0,16527,7,17257,225,44,1338,-385,22.5,1652.7,4,6,7,0,0,0,0,15189,7,17642,191,52,-1338,385,19.1,1518.9,red,4.25,1.83,26,44,blue
4514428234,7,6,8,0,0,0,0,16977,6.6,16961,222,43,841,-678,22.2,1697.7,6,7,8,0,0,0,0,16136,6.8,17639,216,40,-841,678,21.6,1613.6,red,2.5,2,19,18,red
4520985137,1,7,1,0,0,0,0,13874,6.4,15799,219,33,-2933,-2159,21.9,1387.4,7,1,8,2,1,1,0,16807,7,17958,215,62,2933,2159,21.5,1680.7,red,0.29,15,21,15,red
4523843821,10,8,10,2,1,1,0,17272,7,18189,210,41,-88,555,21,1727.2,8,10,13,0,0,0,0,17360,7,17634,223,45,88,-555,22.3,1736,red,2.5,2.1,22,22,red
4524683257,4,7,2,0,0,0,0,15125,6.8,17217,223,56,-3346,-1685,22.3,1512.5,7,4,8,2,1,1,1,18471,7.2,18902,219,54,3346,1685,21.9,1847.1,red,0.86,3.75,15,22,red
4508198441,2,9,4,0,0,0,0,14691,6.8,17573,207,67,-4024,-1999,20.7,1469.1,9,2,18,1,1,0,0,18715,7.4,19572,242,55,4024,1999,24.2,1871.5,red,0.67,13.5,21,16,red
4522118133,6,5,3,0,0,0,0,16961,7.2,18707,240,58,1155,868,24,1696.1,5,6,6,1,1,0,0,15806,6.8,17839,201,53,-1155,-868,20.1,1580.6,red,1.8,1.83,11,17,blue
4524267353,3,3,4,0,0,0,0,16688,7,18637,215,59,1004,458,21.5,1668.8,3,3,4,0,0,0,0,15684,7,18179,231,72,-1004,-458,23.1,1568.4,blue,2.33,2.33,16,62,red
4518992502,4,3,3,1,0,1,1,17143,7.2,18702,237,57,2043,1866,23.7,1714.3,3,4,4,1,1,0,0,15100,6.4,16836,236,45,-2043,-1866,23.6,1510,blue,2.33,1.75,15,16,blue
4494596077,7,9,6,1,0,1,1,18097,7,18058,243,39,811,426,24.3,1809.7,9,7,12,1,1,0,0,17286,6.6,17632,194,59,-811,-426,19.4,1728.6,blue,1.44,3,45,24,blue
4523731110,11,3,14,1,1,0,0,19276,7.4,19210,237,42,4275,2943,23.7,1927.6,3,11,6,0,0,0,0,15001,6.4,16267,205,43,-4275,-2943,20.5,1500.1,blue,8.33,0.82,40,17,blue
4455272131,7,7,8,1,1,0,0,17114,7,18783,210,41,-218,-840,21,1711.4,7,7,6,0,0,0,0,17332,7.4,19623,226,71,218,840,22.6,1733.2,red,2.14,1.86,41,22,red
4511726716,8,6,8,0,0,0,0,16602,6.8,16879,163,49,-786,-808,16.3,1660.2,6,8,2,0,0,0,1,17388,6.8,17687,206,54,786,808,20.6,1738.8,blue,2.67,1,87,46,red
4523706574,5,11,4,0,0,0,0,14975,6.4,15932,194,44,-3359,-2255,19.4,1497.5,11,5,8,1,1,0,0,18334,7,18187,221,60,3359,2255,22.1,1833.4,red,0.82,3.8,20,21,red
4510806182,6,9,7,1,1,0,0,15843,7,16910,206,36,-2292,-810,20.6,1584.3,9,6,11,0,0,0,0,18135,6.8,17720,210,48,2292,810,21,1813.5,blue,1.44,3.33,17,18,red
4523124807,6,7,3,0,0,0,0,15777,6.8,18110,203,58,-1838,-366,20.3,1577.7,7,6,8,1,1,0,0,17615,7,18476,214,54,1838,366,21.4,1761.5,red,1.29,2.5,20,95,red
4464723011,10,6,5,0,0,0,0,17142,7,18615,221,45,2121,1813,22.1,1714.2,6,10,3,0,0,0,0,15021,6.4,16802,200,31,-2121,-1813,20,1502.1,blue,2.5,0.9,14,16,blue
4509809215,7,6,11,0,0,0,0,18027,7,17905,217,59,2394,873,21.7,1802.7,6,7,5,1,1,0,0,15633,6.8,17032,219,53,-2394,-873,21.9,1563.3,blue,3,1.57,15,145,blue
4470222425,4,5,6,1,1,0,0,16003,6.8,17885,238,44,-1084,-1632,23.8,1600.3,5,4,8,0,0,0,0,17087,7.2,19517,244,66,1084,1632,24.4,1708.7,blue,2,3.25,20,15,blue
4518542421,11,11,9,1,1,0,0,19116,7,19104,220,56,1159,3144,22,1911.6,11,11,14,0,0,0,0,17957,6.4,15960,169,31,-1159,-3144,16.9,1795.7,blue,1.82,2.27,20,20,red
4472513003,11,7,17,1,1,0,0,18078,6.8,18102,192,64,1328,1106,19.2,1807.8,7,11,6,0,0,0,0,16750,6.8,16996,197,39,-1328,-1106,19.7,1675,blue,4,1.18,18,18,red
4516945455,8,8,8,1,1,0,0,18011,7,18540,243,57,1522,277,24.3,1801.1,8,8,7,0,0,0,0,16489,7.2,18263,210,38,-1522,-277,21,1648.9,blue,2,1.88,14,17,red
4524654966,6,13,6,0,0,0,0,15336,6.8,16216,196,44,-3534,-1814,19.6,1533.6,13,6,13,1,1,0,0,18870,7,18030,208,40,3534,1814,20.8,1887,red,0.92,4.33,51,22,blue
4524608366,6,7,6,1,1,0,0,17273,7.2,18685,226,64,292,760,22.6,1727.3,7,6,10,0,0,0,0,16981,6.8,17925,225,47,-292,-760,22.5,1698.1,red,1.71,2.83,23,22,red
4434652049,9,7,8,0,0,0,0,17875,7,18320,203,43,2561,1875,20.3,1787.5,7,9,6,0,0,0,0,15314,6.6,16445,179,32,-2561,-1875,17.9,1531.4,red,2.43,1.44,19,14,blue
4456782548,9,10,14,0,0,0,0,17215,6.8,17349,198,31,-1908,-994,19.8,1721.5,10,9,11,0,0,0,0,19123,7.2,18343,235,55,1908,994,23.5,1912.3,red,2.3,2.33,42,18,red
4432011419,6,8,10,0,0,0,0,15579,6.8,16747,204,46,-1815,-1309,20.4,1557.9,8,6,8,2,1,1,0,17394,7,18056,205,59,1815,1309,20.5,1739.4,blue,2,2.67,18,18,red
4516422291,6,8,9,0,0,0,0,16479,6.6,16357,230,36,-266,-65,23,1647.9,8,6,13,2,1,1,0,16745,6.6,16422,186,52,266,65,18.6,1674.5,red,1.88,3.5,17,15,red
4520682633,2,3,6,1,1,0,0,13918,6.8,17189,209,48,-1382,-271,20.9,1391.8,3,2,1,0,0,0,0,15300,6.8,17460,260,40,1382,271,26,1530,red,2.67,2,20,16,red
4523932560,9,5,8,2,1,1,0,17615,7.2,19117,218,48,2643,3340,21.8,1761.5,5,9,6,0,0,0,0,14972,6.4,15777,194,41,-2643,-3340,19.4,1497.2,blue,3.4,1.22,23,18,red
4484818396,3,3,1,1,1,0,0,15848,7,18490,251,60,1259,720,25.1,1584.8,3,3,2,0,0,0,0,14589,6.8,17770,220,43,-1259,-720,22,1458.9,red,1.33,1.67,18,21,blue
4522415316,6,3,6,0,0,0,0,15941,7.2,17560,228,33,1231,93,22.8,1594.1,3,6,3,0,0,0,0,14710,6.8,17467,212,43,-1231,-93,21.2,1471,red,4,1,16,85,blue
4458821215,2,6,1,2,1,1,0,14448,6.8,17294,198,68,-2279,-958,19.8,1444.8,6,2,7,0,0,0,0,16727,7.2,18252,239,40,2279,958,23.9,1672.7,blue,0.5,6.5,22,31,blue
4523270245,3,2,4,0,0,0,0,15719,7.4,19029,230,60,753,263,23,1571.9,2,3,3,1,1,0,0,14966,7.2,18766,236,63,-753,-263,23.6,1496.6,blue,3.5,1.67,15,13,blue
4510569686,8,10,9,0,0,0,0,17139,6.6,16389,199,50,-201,-1063,19.9,1713.9,10,8,11,1,1,0,0,17340,6.8,17452,167,41,201,1063,16.7,1734,red,1.7,2.62,22,57,red
4499840707,4,4,4,1,1,0,0,15977,6.8,17115,224,56,1033,1209,22.4,1597.7,4,4,3,0,0,0,0,14944,6.4,15906,185,52,-1033,-1209,18.5,1494.4,red,2,1.75,19,85,red
4505443029,2,4,2,1,1,0,0,14938,6.8,17538,246,42,-353,-370,24.6,1493.8,4,2,6,0,0,0,0,15291,7,17908,230,41,353,370,23,1529.1,blue,1,5,41,13,blue
4462200900,9,6,13,0,0,0,0,17187,7,18709,199,47,619,1021,19.9,1718.7,6,9,6,1,1,0,0,16568,6.8,17688,214,67,-619,-1021,21.4,1656.8,red,3.67,1.33,42,22,blue
4524850918,8,9,10,1,0,1,0,17558,6.8,17905,202,44,-483,-427,20.2,1755.8,9,8,9,1,1,0,0,18041,7.2,18332,205,48,483,427,20.5,1804.1,blue,2,2.25,42,60,blue
4494953056,6,2,5,2,1,1,1,17945,7,18758,268,44,2404,1129,26.8,1794.5,2,6,1,0,0,0,0,15541,6.8,17629,260,49,-2404,-1129,26,1554.1,blue,5.5,0.5,21,99,blue
4482020430,5,5,10,0,0,0,0,15151,6.8,16795,203,29,-244,78,20.3,1515.1,5,5,6,0,0,0,0,15395,6.4,16717,215,38,244,-78,21.5,1539.5,blue,3,2.2,22,16,red
4489780807,4,11,5,0,0,0,0,14983,6.8,16993,208,47,-2653,-1372,20.8,1498.3,11,4,16,1,1,0,0,17636,7,18365,207,40,2653,1372,20.7,1763.6,blue,0.82,6.75,17,56,red
4473648726,6,7,7,1,1,0,0,16527,6.6,16322,229,40,94,-487,22.9,1652.7,7,6,11,0,0,0,0,16433,6.8,16809,190,37,-94,487,19,1643.3,blue,1.86,3,20,97,red
4506851562,8,8,4,1,1,0,0,16359,7,17830,204,56,-736,-226,20.4,1635.9,8,8,7,1,0,1,0,17095,7.2,18056,232,39,736,226,23.2,1709.5,red,1.5,1.88,19,15,red
4512489838,8,3,12,1,1,0,0,19038,7.2,18856,239,44,4034,1938,23.9,1903.8,3,8,4,0,0,0,0,15004,6.8,16918,228,49,-4034,-1938,22.8,1500.4,blue,6.67,0.88,16,18,blue
4456743513,5,4,10,1,1,0,0,15976,6.8,17352,232,37,609,-609,23.2,1597.6,4,5,5,1,0,1,0,15367,7,17961,235,49,-609,609,23.5,1536.7,red,3.75,1.8,18,16,red
4522569310,1,4,1,0,0,0,0,13512,6.4,16628,224,47,-2327,-742,22.4,1351.2,4,1,6,1,1,0,0,15839,7,17370,215,48,2327,742,21.5,1583.9,red,0.5,10,22,19,red
4480568476,5,9,6,0,0,0,0,14923,6.8,17285,173,37,-3916,-2883,17.3,1492.3,9,5,8,1,1,0,0,18839,7.4,20168,239,68,3916,2883,23.9,1883.9,red,1.22,3.4,19,14,blue
4515413572,6,6,6,1,0,1,0,16124,6.6,17227,225,24,-725,-925,22.5,1612.4,6,6,6,1,1,0,0,16849,6.8,18152,246,54,725,925,24.6,1684.9,red,2,2,68,18,blue
4486418499,1,6,1,0,0,0,0,14058,6.6,16215,213,51,-2675,-2192,21.3,1405.8,6,1,4,1,0,1,0,16733,7,18407,229,52,2675,2192,22.9,1673.3,red,0.33,10,17,90,red
4523419872,3,6,4,0,0,0,0,14422,6.8,16781,201,43,-2346,-1871,20.1,1442.2,6,3,6,0,0,0,0,16768,7.2,18652,237,58,2346,1871,23.7,1676.8,red,1.17,4,19,14,blue
4477069725,5,6,7,1,1,0,0,16539,7.4,19570,242,62,-65,1208,24.2,1653.9,6,5,7,0,0,0,0,16604,7,18362,230,43,65,-1208,23,1660.4,blue,2,2.6,19,25,red
4523857343,5,10,6,0,0,0,0,15794,6.6,16652,203,44,-3750,-1447,20.3,1579.4,10,5,13,1,1,0,1,19544,6.8,18099,212,54,3750,1447,21.2,1954.4,red,1.1,4.6,19,16,red
4460351665,8,7,15,0,0,0,0,16867,6.8,17923,228,37,150,-446,22.8,1686.7,7,8,5,1,1,0,0,16717,7.2,18369,222,44,-150,446,22.2,1671.7,red,3.29,1.5,43,15,blue
4520401990,9,9,9,0,0,0,0,17197,7.2,18127,205,40,-1383,-970,20.5,1719.7,9,9,12,0,0,0,0,18580,7,19097,232,51,1383,970,23.2,1858,red,2,2.33,18,16,blue
4503249244,5,9,5,1,0,1,0,15881,6.4,16164,204,44,-1441,-938,20.4,1588.1,9,5,16,1,1,0,0,17322,6.8,17102,197,53,1441,938,19.7,1732.2,blue,1.11,5,21,20,blue
4513811621,11,3,14,0,0,0,0,19373,7.2,19208,228,40,4898,3092,22.8,1937.3,3,11,2,1,1,0,0,14475,6.6,16116,190,60,-4898,-3092,19,1447.5,blue,8.33,0.45,20,16,red
4475517974,6,5,10,0,0,0,0,16548,6.6,17430,230,23,503,-194,23,1654.8,5,6,8,2,1,1,0,16045,7,17624,211,67,-503,194,21.1,1604.5,red,3.2,2.17,57,24,red
4486146372,3,13,4,0,0,0,0,14126,6.4,15246,200,44,-6319,-3391,20,1412.6,13,3,22,1,1,0,0,20445,7.2,18637,193,56,6319,3391,19.3,2044.5,red,0.54,11.67,14,19,red
4478222063,7,5,9,0,0,0,0,16518,6.6,17024,202,44,238,275,20.2,1651.8,5,7,9,0,0,0,0,16280,6.6,16749,210,42,-238,-275,21,1628,blue,3.2,2,21,150,red
4489610155,5,11,7,0,0,0,0,15897,6.8,17075,215,51,-3048,-3175,21.5,1589.7,11,5,8,1,1,0,0,18945,7.4,20250,245,48,3048,3175,24.5,1894.5,blue,1.09,3.8,20,39,blue
4500435110,13,5,8,0,0,0,3,22845,7.4,19608,250,51,8234,6026,25,2284.5,5,13,5,0,0,0,0,14611,6,13582,158,40,-8234,-6026,15.8,1461.1,blue,4.2,0.77,132,26,red
4524652479,1,5,2,1,1,0,0,14445,6.8,17594,232,61,-925,41,23.2,1444.5,5,1,9,0,0,0,0,15370,7,17553,211,52,925,-41,21.1,1537,red,0.6,14,20,15,red
4502701964,6,5,3,1,0,1,0,17293,7,18795,231,60,1339,614,23.1,1729.3,5,6,6,1,1,0,0,15954,7.2,18181,236,48,-1339,-614,23.6,1595.4,blue,1.8,1.83,25,52,blue
4466011800,8,4,7,0,0,0,0,17239,6.8,18339,210,52,1201,-46,21,1723.9,4,8,4,1,1,0,0,16038,7,18385,225,80,-1201,46,22.5,1603.8,red,3.75,1,21,21,blue
4518912050,8,9,8,2,1,1,0,18339,7.2,19765,233,62,-59,1231,23.3,1833.9,9,8,9,0,0,0,0,18398,7,18534,212,60,59,-1231,21.2,1839.8,blue,1.78,2.25,18,18,red
4483304287,6,4,7,1,1,0,0,16541,7,19056,249,44,1294,1165,24.9,1654.1,4,6,6,0,0,0,0,15247,7,17891,211,50,-1294,-1165,21.1,1524.7,blue,3.25,1.67,95,14,red
4523694899,14,7,13,1,1,0,1,20488,6.8,17390,201,52,4535,1970,20.1,2048.8,7,14,5,0,0,0,0,15953,6.2,15420,191,40,-4535,-1970,19.1,1595.3,blue,3.86,0.86,23,24,red
4505081158,5,6,4,1,0,1,0,15072,7,17951,189,53,-1925,-904,18.9,1507.2,6,5,5,0,0,0,0,16997,7.2,18855,244,67,1925,904,24.4,1699.7,blue,1.5,2.2,17,14,red
4525171151,4,6,4,1,1,0,0,15433,7.2,18889,218,66,-1629,-287,21.8,1543.3,6,4,4,0,0,0,0,17062,7.4,19176,249,42,1629,287,24.9,1706.2,red,1.33,2.5,17,17,red
4476138095,4,6,7,0,0,0,0,15766,6.8,16923,213,47,-856,-642,21.3,1576.6,6,4,6,1,1,0,0,16622,6.6,17565,239,58,856,642,23.9,1662.2,blue,1.83,3,54,19,red
4497851268,10,5,14,1,1,0,0,18459,7,17936,187,52,2955,1124,18.7,1845.9,5,10,7,0,0,0,0,15504,6.8,16812,196,36,-2955,-1124,19.6,1550.4,blue,4.8,1.2,24,43,blue
4516722172,7,3,7,2,1,1,0,16467,6.8,17952,209,48,1418,129,20.9,1646.7,3,7,2,0,0,0,0,15049,6.8,17823,231,56,-1418,-129,23.1,1504.9,red,4.67,0.71,17,32,blue
4519753140,11,8,13,1,1,0,0,18384,7.2,18583,208,46,1263,-392,20.8,1838.4,8,11,7,0,0,0,0,17121,7,18975,207,51,-1263,392,20.7,1712.1,blue,3,1.36,23,17,blue
4522036239,11,3,11,1,0,1,0,18479,7.4,19708,232,48,3187,1811,23.2,1847.9,3,11,2,1,1,0,0,15292,6.8,17897,258,50,-3187,-1811,25.8,1529.2,blue,7.33,0.45,20,21,blue
4521281079,3,9,4,1,0,1,0,14812,6.8,16674,199,64,-3244,-1208,19.9,1481.2,9,3,12,1,1,0,0,18056,6.8,17882,205,52,3244,1208,20.5,1805.6,red,0.78,7,17,17,red
4447656785,2,6,1,1,1,0,0,14702,6.8,17961,212,60,-1626,-849,21.2,1470.2,6,2,5,1,0,1,0,16328,7.2,18810,243,48,1626,849,24.3,1632.8,blue,0.5,5.5,26,24,blue
4523432190,3,7,4,0,0,0,0,15715,7,18159,246,54,-1235,-956,24.6,1571.5,7,3,4,1,1,0,0,16950,7.2,19115,252,52,1235,956,25.2,1695,blue,1,3.67,42,34,blue
4467393219,8,5,9,0,0,0,0,16736,7.2,18330,227,56,1271,531,22.7,1673.6,5,8,4,0,0,0,0,15465,7,17799,221,48,-1271,-531,22.1,1546.5,red,3.4,1.12,20,15,blue
4450553888,10,8,9,1,1,0,0,17344,7,18253,184,48,706,766,18.4,1734.4,8,10,7,1,0,1,0,16638,6.6,17487,206,40,-706,-766,20.6,1663.8,red,2.38,1.5,16,23,red
4520633128,11,8,13,1,0,1,0,18625,6.6,17323,190,45,1430,916,19,1862.5,8,11,9,1,1,0,0,17195,6.6,16407,215,54,-1430,-916,21.5,1719.5,blue,3,1.55,17,18,red
4524963082,2,7,2,0,0,0,0,13825,6.6,15977,185,51,-2891,-3196,18.5,1382.5,7,2,7,0,0,0,0,16716,7.4,19173,229,53,2891,3196,22.9,1671.6,blue,0.57,7,16,16,red
4495592386,3,7,1,1,1,0,0,14604,6.6,17494,198,58,-3333,-379,19.8,1460.4,7,3,10,1,0,1,0,17937,6.8,17873,245,40,3333,379,24.5,1793.7,red,0.57,5.67,15,18,red
4441657789,5,8,5,0,0,0,0,15770,6.4,16913,241,36,-2580,-3307,24.1,1577,8,5,6,1,0,1,0,18350,7.2,20220,224,79,2580,3307,22.4,1835,red,1.25,2.8,19,17,red
4517721011,8,9,4,0,0,0,0,16566,7.2,18723,214,48,-1838,-1127,21.4,1656.6,9,8,7,2,1,1,0,18404,7.2,19850,238,60,1838,1127,23.8,1840.4,blue,1.33,2,19,17,red
4513226809,7,4,6,0,0,0,0,17129,6.8,17586,228,36,1440,247,22.8,1712.9,4,7,4,1,1,0,0,15689,7,17339,211,60,-1440,-247,21.1,1568.9,red,3.25,1.14,97,20,blue
4515717672,4,7,5,0,0,0,0,16176,7,18293,254,59,-992,-804,25.4,1617.6,7,4,6,1,1,0,0,17168,6.8,19097,262,48,992,804,26.2,1716.8,red,1.29,3.25,16,54,red
4521167272,15,5,15,1,0,1,1,21056,7.2,19016,206,35,5433,3364,20.6,2105.6,5,15,3,0,0,0,0,15623,6.4,15652,193,53,-5433,-3364,19.3,1562.3,blue,6,0.53,23,35,red
4516816760,12,7,10,1,1,0,0,20471,7.6,20212,230,62,3941,3044,23,2047.1,7,12,6,0,0,0,0,16530,6.6,17168,198,39,-3941,-3044,19.8,1653,blue,3.14,1.08,20,19,blue
4493323952,8,3,14,0,0,0,1,18823,6.6,18188,245,47,4509,2253,24.5,1882.3,3,8,2,1,1,0,0,14314,6.6,15935,218,40,-4509,-2253,21.8,1431.4,blue,7.33,0.62,21,18,red
4498404672,7,3,6,0,0,0,0,17204,7.4,19558,255,48,2385,966,25.5,1720.4,3,7,4,1,1,0,0,14819,7,18592,215,52,-2385,-966,21.5,1481.9,blue,4.33,1,9,37,blue
4524720967,12,2,23,0,0,0,0,17628,6.2,14939,184,28,4007,970,18.4,1762.8,2,12,3,0,0,0,0,13621,6.2,13969,183,44,-4007,-970,18.3,1362.1,blue,17.5,0.42,17,19,blue
4522623141,7,8,11,1,1,0,0,16562,7,17625,180,51,438,196,18,1656.2,8,7,5,0,0,0,0,16124,7,17429,201,48,-438,-196,20.1,1612.4,red,2.25,1.86,42,18,blue
4522349716,6,11,6,1,1,0,0,16543,7,17893,213,47,-3032,-1002,21.3,1654.3,11,6,16,0,0,0,0,19575,7.2,18895,240,39,3032,1002,24,1957.5,red,1.09,4.5,15,18,red
4480203372,9,4,12,0,0,0,1,19292,6.8,18197,213,49,4062,2332,21.3,1929.2,4,9,6,2,1,1,0,15230,6.4,15865,191,42,-4062,-2332,19.1,1523,red,5.25,1.11,15,28,red
4463154481,5,6,6,0,0,0,0,15590,7.2,18314,211,36,-816,332,21.1,1559,6,5,4,0,0,0,0,16406,7,17982,227,60,816,-332,22.7,1640.6,red,1.83,2,41,15,red
4525197768,5,1,5,0,0,0,0,15885,7,17852,250,45,2107,464,25,1588.5,1,5,1,1,1,0,0,13778,6.6,17388,231,38,-2107,-464,23.1,1377.8,blue,10,0.4,15,15,red
4520800745,6,10,6,1,1,0,0,15936,6.6,17184,233,36,-2542,-1008,23.3,1593.6,10,6,9,0,0,0,0,18478,7,18192,233,52,2542,1008,23.3,1847.8,blue,1.2,3.17,17,19,red
4519585226,3,7,3,0,0,0,0,15040,6.6,16582,205,48,-952,-1268,20.5,1504,7,3,4,2,1,1,0,15992,7,17850,205,44,952,1268,20.5,1599.2,blue,0.86,3.67,40,18,blue
4513405592,6,3,9,1,1,0,0,15927,6.8,17735,198,49,1824,638,19.8,1592.7,3,6,1,0,0,0,0,14103,7,17097,202,46,-1824,-638,20.2,1410.3,blue,5,0.67,19,18,red
4480561507,0,5,0,0,0,0,0,14231,6.8,17522,230,64,-2681,-1877,23,1423.1,5,0,6,2,1,1,0,16912,7.2,19399,248,56,2681,1877,24.8,1691.2,red,0,12.65,21,43,red
4516554886,3,6,2,0,0,0,0,14998,7,17859,218,60,-993,-1150,21.8,1499.8,6,3,6,1,1,0,0,15991,7,19009,236,55,993,1150,23.6,1599.1,red,0.83,4,18,42,red
4480147413,11,13,12,1,0,1,0,18315,6.6,17665,232,40,-337,-1295,23.2,1831.5,13,11,14,1,1,0,0,18652,7.2,18960,197,56,337,1295,19.7,1865.2,red,1.77,2.45,21,19,red
4492470174,8,0,9,1,1,0,0,16977,7.4,19499,199,39,3115,2163,19.9,1697.7,0,8,0,0,0,0,0,13862,6.8,17336,217,67,-3115,-2163,21.7,1386.2,blue,12.03,0,40,15,blue
4502350951,3,7,2,1,1,0,0,14857,6.6,17267,228,57,-2748,-2417,22.8,1485.7,7,3,8,1,0,1,0,17605,7.4,19684,208,64,2748,2417,20.8,1760.5,blue,0.71,5,18,17,blue
4522690017,5,9,5,0,0,0,0,14819,6.4,15937,183,46,-3477,-3301,18.3,1481.9,9,5,7,1,1,0,0,18296,7.2,19238,227,58,3477,3301,22.7,1829.6,red,1.11,3.2,21,46,blue
4467269320,3,2,5,1,1,0,0,15570,7.2,18813,236,60,-61,-100,23.6,1557,2,3,2,0,0,0,0,15631,7.2,18913,260,60,61,100,26,1563.1,red,4,1.33,54,32,blue
4477180489,3,14,7,0,0,0,0,14231,6.2,15543,208,44,-5316,-3648,20.8,1423.1,14,3,21,0,0,0,0,19547,7.4,19191,214,48,5316,3648,21.4,1954.7,red,0.71,11.67,19,22,red
4518677931,13,7,12,1,1,0,0,19558,7,19133,215,44,3257,1407,21.5,1955.8,7,13,5,0,0,0,0,16301,6.8,17726,203,66,-3257,-1407,20.3,1630.1,blue,3.57,0.92,20,17,blue
4512800157,10,9,9,1,1,0,0,18531,7.2,18550,217,44,1492,-676,21.7,1853.1,9,10,4,0,0,0,0,17039,7,19226,214,56,-1492,676,21.4,1703.9,blue,2.11,1.3,22,26,blue
4453026887,5,5,6,0,0,0,0,15211,6.6,16678,179,55,-1310,-1595,17.9,1521.1,5,5,4,0,0,0,0,16521,6.8,18273,222,48,1310,1595,22.2,1652.1,red,2.2,1.8,30,18,red
4494384806,1,2,2,2,1,1,0,13683,6.8,16232,198,60,-2032,-1876,19.8,1368.3,2,1,1,0,0,0,0,15715,6.8,18108,262,51,2032,1876,26.2,1571.5,red,1.5,3,36,19,red
4523536218,6,3,7,0,0,0,0,16887,7.4,19954,232,64,846,680,23.2,1688.7,3,6,1,1,1,0,0,16041,7.2,19274,242,64,-846,-680,24.2,1604.1,blue,4.33,0.67,38,35,blue
4514199075,4,6,4,0,0,0,0,16317,7,17928,228,50,-248,-1557,22.8,1631.7,6,4,4,2,1,1,0,16565,7.2,19485,225,59,248,1557,22.5,1656.5,blue,1.33,2.5,20,23,blue
4522545696,12,4,15,1,0,1,0,19000,7,18072,210,48,4181,1584,21,1900,4,12,4,0,0,0,0,14819,6.4,16488,193,45,-4181,-1584,19.3,1481.9,blue,6.75,0.67,18,17,blue
4484079489,6,6,8,0,0,0,0,16421,7.4,18535,222,52,121,-123,22.2,1642.1,6,6,4,1,1,0,0,16300,7.2,18658,240,52,-121,123,24,1630,red,2.33,1.67,17,18,red
4503781874,4,4,8,1,1,0,0,16341,7.4,19567,236,72,1567,1637,23.6,1634.1,4,4,3,1,0,1,0,14774,6.8,17930,203,55,-1567,-1637,20.3,1477.4,blue,3,1.75,13,14,blue
4424203287,13,6,13,0,0,0,0,18901,7.2,19110,244,36,2972,1799,24.4,1890.1,6,13,4,0,0,0,0,15929,6.8,17311,206,52,-2972,-1799,20.6,1592.9,blue,4.33,0.77,20,16,blue
4432359708,2,5,1,0,0,0,0,13860,6.6,16835,193,52,-2807,-1537,19.3,1386,5,2,6,0,0,0,0,16667,6.8,18372,249,42,2807,1537,24.9,1666.7,blue,0.6,5.5,18,95,red
4462971109,4,7,4,0,0,0,0,15317,7,18310,225,56,-1742,-357,22.5,1531.7,7,4,7,1,1,0,0,17059,6.8,18667,221,67,1742,357,22.1,1705.9,red,1.14,3.5,15,30,red
4509546760,11,6,13,1,1,0,1,20111,7,18316,231,46,4588,930,23.1,2011.1,6,11,6,0,0,0,0,15523,7,17386,153,54,-4588,-930,15.3,1552.3,blue,4,1.09,90,12,blue
4495614146,11,6,19,1,1,0,0,18631,7.4,19229,229,53,3123,3364,22.9,1863.1,6,11,10,0,0,0,0,15508,6.6,15865,194,38,-3123,-3364,19.4,1550.8,blue,5,1.45,21,21,blue
4511245334,2,7,5,0,0,0,0,14766,6.8,16685,236,47,-1174,-1478,23.6,1476.6,7,2,7,1,1,0,0,15940,7,18163,190,64,1174,1478,19,1594,red,1,7,37,43,blue
4508663861,6,6,6,0,0,0,0,15967,6.8,17567,222,56,-844,-640,22.2,1596.7,6,6,6,0,0,0,0,16811,7,18207,234,48,844,640,23.4,1681.1,blue,2,2,18,18,red
4510820768,7,2,7,1,1,0,0,18117,7.4,19804,236,72,5779,5212,23.6,1811.7,2,7,0,0,0,0,0,12338,5.6,14592,197,8,-5779,-5212,19.7,1233.8,blue,7,0.29,11,17,blue
4523434637,7,5,8,1,1,0,0,16379,6.8,17323,207,48,377,372,20.7,1637.9,5,7,9,0,0,0,0,16002,6.8,16951,243,44,-377,-372,24.3,1600.2,blue,3,2,53,25,blue
4523647003,6,8,5,0,0,0,0,16530,6.8,17332,226,47,-673,-1416,22.6,1653,8,6,6,0,0,0,0,17203,7.2,18748,198,44,673,1416,19.8,1720.3,blue,1.38,2.33,18,18,red
4500133992,3,11,2,0,0,0,0,15451,6.8,17544,243,57,-3380,-2659,24.3,1545.1,11,3,11,0,0,0,0,18831,7.4,20203,234,63,3380,2659,23.4,1883.1,red,0.45,7.33,36,49,red
4525224420,8,4,5,1,0,1,0,17553,7.4,19041,203,64,2034,2002,20.3,1755.3,4,8,4,1,1,0,0,15519,6.8,17039,211,52,-2034,-2002,21.1,1551.9,blue,3.25,1,33,16,red
4470635951,9,5,15,0,0,0,0,18721,7.2,19444,240,48,2411,1852,24,1872.1,5,9,6,1,1,0,0,16310,6.8,17592,219,58,-2411,-1852,21.9,1631,blue,4.8,1.22,18,18,blue
4522429552,7,6,3,0,0,0,0,16611,6.8,18323,216,60,912,505,21.6,1661.1,6,7,6,1,1,0,0,15699,7,17818,195,57,-912,-505,19.5,1569.9,blue,1.67,1.71,19,31,blue
4519057052,4,4,5,1,1,0,0,15059,6.8,17260,196,60,-345,-715,19.6,1505.9,4,4,2,0,0,0,0,15404,6.6,17975,237,52,345,715,23.7,1540.4,red,2.25,1.5,53,47,blue
4467340855,3,6,3,0,0,0,0,14715,7,17406,198,58,-2290,-1334,19.8,1471.5,6,3,8,1,1,0,0,17005,7,18740,229,56,2290,1334,22.9,1700.5,red,1,4.67,21,44,red
4520358684,8,5,9,1,1,0,0,16753,6.8,18557,233,40,204,-830,23.3,1675.3,5,8,4,1,0,1,0,16549,7.2,19387,217,52,-204,830,21.7,1654.9,red,3.4,1.12,19,16,red
4456531683,6,12,3,0,0,0,0,15676,6.6,17356,210,44,-2653,-376,21,1567.6,12,6,15,1,1,0,0,18329,7,17732,191,48,2653,376,19.1,1832.9,red,0.75,4.5,20,16,red
4440516925,9,7,11,0,0,0,0,17616,7,18731,195,73,356,565,19.5,1761.6,7,9,8,0,0,0,0,17260,7,18166,208,55,-356,-565,20.8,1726,red,2.86,1.67,26,46,red
4490273842,6,4,5,2,1,1,0,16727,7.2,18834,220,55,613,-602,22,1672.7,4,6,3,0,0,0,0,16114,7.4,19436,247,52,-613,602,24.7,1611.4,blue,2.75,1.17,20,43,blue
4517908565,12,3,13,1,1,0,0,19626,7.6,20682,228,68,4400,3092,22.8,1962.6,3,12,2,0,0,0,0,15226,6.6,17590,223,48,-4400,-3092,22.3,1522.6,blue,8.33,0.42,16,16,blue
4424223586,6,6,6,0,0,0,0,16763,6.8,17822,207,52,54,-119,20.7,1676.3,6,6,7,1,1,0,0,16709,6.8,17941,214,53,-54,119,21.4,1670.9,blue,2,2.17,20,23,red
4515202068,4,4,4,0,0,0,0,15686,7,18036,206,52,126,290,20.6,1568.6,4,4,6,0,0,0,0,15560,6.8,17746,224,48,-126,-290,22.4,1556,blue,2,2.5,37,17,blue
4521842846,3,2,2,1,1,0,0,14502,7,17745,217,43,-430,53,21.7,1450.2,2,3,1,0,0,0,0,14932,6.8,17692,223,60,430,-53,22.3,1493.2,blue,2.5,1,16,35,red
4457008348,3,10,3,0,0,0,0,15130,6.6,16749,220,42,-2528,-1326,22,1513,10,3,13,0,0,0,0,17658,7,18075,218,41,2528,1326,21.8,1765.8,red,0.6,7.67,22,59,red
4488603223,7,3,7,0,0,0,0,16718,7,18415,200,48,558,-1308,20,1671.8,3,7,2,0,0,0,0,16160,7.2,19723,225,80,-558,1308,22.5,1616,blue,4.67,0.71,20,20,blue
4500756552,8,4,10,0,0,0,0,16929,7,18100,200,48,1134,1146,20,1692.9,4,8,3,1,1,0,0,15795,6.6,16954,239,52,-1134,-1146,23.9,1579.5,blue,4.5,0.88,43,22,blue
4491170236,6,9,6,0,0,0,0,16407,7.4,18871,168,67,-949,-297,16.8,1640.7,9,6,3,1,1,0,0,17356,7.2,19168,216,53,949,297,21.6,1735.6,blue,1.33,2,20,73,red
4522097658,11,4,11,1,1,0,0,19165,7.4,20050,219,47,4297,2642,21.9,1916.5,4,11,4,0,0,0,0,14868,6.8,17408,177,55,-4297,-2642,17.7,1486.8,blue,5.5,0.73,19,18,blue
4519881669,3,8,6,1,0,1,1,15698,6.4,16251,189,47,-1838,-1430,18.9,1569.8,8,3,9,1,1,0,0,17536,6.8,17681,211,58,1838,1430,21.1,1753.6,red,1.12,5.67,27,72,blue
4500109652,6,9,3,0,0,0,0,15398,6.6,17682,184,40,-2115,-1147,18.4,1539.8,9,6,6,0,0,0,0,17513,7,18829,233,36,2115,1147,23.3,1751.3,red,1,2.5,16,15,red
4452913051,6,3,6,2,1,1,0,17201,6.8,17943,186,67,2184,419,18.6,1720.1,3,6,4,0,0,0,0,15017,6.8,17524,211,52,-2184,-419,21.1,1501.7,blue,4,1.17,20,51,blue
4523656538,4,7,3,1,0,1,0,15964,7,18056,199,55,-406,-1050,19.9,1596.4,7,4,5,1,1,0,0,16370,7.2,19106,190,54,406,1050,19,1637,blue,1,3,142,25,red
4506573625,2,14,1,0,0,0,0,13121,6,14672,172,32,-6707,-5252,17.2,1312.1,14,2,13,2,1,1,0,19828,7.6,19924,203,55,6707,5252,20.3,1982.8,red,0.21,13.5,222,32,red
4495693355,3,4,1,1,1,0,0,15701,7,17966,245,44,826,-382,24.5,1570.1,4,3,6,0,0,0,0,14875,7,18348,193,62,-826,382,19.3,1487.5,red,1,3.33,19,14,red
4515999834,10,10,13,0,0,0,0,17917,6.8,17997,199,44,-1074,-1029,19.9,1791.7,10,10,9,1,1,0,0,18991,7.2,19026,233,56,1074,1029,23.3,1899.1,blue,2.3,1.9,17,20,blue
4487355594,11,7,8,0,0,0,0,18288,7.4,19406,207,57,2616,3108,20.7,1828.8,7,11,9,1,1,0,0,15672,6.6,16298,177,44,-2616,-3108,17.7,1567.2,blue,2.71,1.45,14,12,blue
4524977254,12,9,17,1,1,0,0,18857,7.2,18670,195,50,1292,812,19.5,1885.7,9,12,10,0,0,0,0,17565,7,17858,207,48,-1292,-812,20.7,1756.5,blue,3.22,1.58,55,39,blue
4471320311,10,6,12,0,0,0,0,17374,6.8,17514,214,39,562,243,21.4,1737.4,6,10,9,1,1,0,0,16812,6.8,17271,204,47,-562,-243,20.4,1681.2,red,3.67,1.5,28,19,blue
4522026969,6,7,4,1,0,1,1,17620,6.8,18344,227,56,1345,1361,22.7,1762,7,6,14,1,1,0,0,16275,6.6,16983,199,45,-1345,-1361,19.9,1627.5,red,1.43,3.5,20,44,blue
4470994961,8,13,8,0,0,0,0,17238,7,17907,204,49,-2693,-709,20.4,1723.8,13,8,9,0,0,0,0,19931,7.2,18616,228,49,2693,709,22.8,1993.1,red,1.23,2.75,32,19,red
4423927997,4,9,1,1,0,1,0,15709,7,17814,207,52,-1696,-1748,20.7,1570.9,9,4,6,1,1,0,0,17405,7.2,19562,239,55,1696,1748,23.9,1740.5,red,0.56,3.75,44,26,blue
4494539160,8,11,6,1,0,1,0,17693,7.2,19111,202,52,-384,-345,20.2,1769.3,11,8,10,1,1,0,0,18077,7.2,19456,199,37,384,345,19.9,1807.7,red,1.27,2.62,19,22,red
4520968733,5,7,5,0,0,0,0,16343,6.8,18250,233,52,77,239,23.3,1634.3,7,5,9,1,1,0,0,16266,6.8,18011,203,52,-77,-239,20.3,1626.6,blue,1.43,3.2,64,21,red
4520825058,7,2,7,1,1,0,0,17033,6.8,18063,225,41,2789,2000,22.5,1703.3,2,7,2,0,0,0,0,14244,6.4,16063,210,41,-2789,-2000,21,1424.4,blue,7,0.57,67,20,red
4522605613,6,5,4,0,0,0,0,15956,7,17947,229,43,56,-587,22.9,1595.6,5,6,2,1,1,0,0,15900,7,18534,231,44,-56,587,23.1,1590,red,2,1.17,39,19,blue
4501009376,3,7,1,0,0,0,0,14780,6.8,16972,215,61,-2568,-2314,21.5,1478,7,3,10,1,1,0,0,17348,7.2,19286,215,54,2568,2314,21.5,1734.8,red,0.57,5.67,20,44,red
4505375338,5,5,8,2,1,1,0,16709,7,18855,222,68,728,2095,22.2,1670.9,5,5,8,0,0,0,0,15981,6.8,16760,224,44,-728,-2095,22.4,1598.1,blue,2.6,2.6,24,22,red
4524018091,13,5,12,1,1,0,0,18748,7,17735,181,44,2236,337,18.1,1874.8,5,13,2,0,0,0,0,16512,6.6,17398,194,63,-2236,-337,19.4,1651.2,blue,5,0.54,19,16,blue
4494347491,4,5,2,0,0,0,0,15598,7,18672,204,72,-518,868,20.4,1559.8,5,4,10,0,0,0,0,16116,7,17804,225,40,518,-868,22.5,1611.6,red,1.2,3.75,19,21,blue
4476326915,5,9,3,0,0,0,0,15108,6.8,17595,202,53,-3086,-1701,20.2,1510.8,9,5,8,1,1,0,0,18194,7.2,19296,222,47,3086,1701,22.2,1819.4,red,0.89,3.4,139,19,red
4499828809,1,6,1,0,0,0,0,13679,6.4,16597,209,52,-4365,-2883,20.9,1367.9,6,1,6,1,1,0,0,18044,7.2,19480,243,59,4365,2883,24.3,1804.4,red,0.33,12,16,24,red
4507786946,7,6,7,2,1,1,0,17453,7,17851,237,49,1478,483,23.7,1745.3,6,7,8,0,0,0,0,15975,7,17368,199,62,-1478,-483,19.9,1597.5,blue,2.33,2,18,38,blue
4502808348,3,15,3,0,0,0,0,15120,6.8,16829,191,56,-5023,-1374,19.1,1512,15,3,28,2,1,1,0,20143,7.2,18203,217,44,5023,1374,21.7,2014.3,red,0.4,14.33,19,22,red
4501204350,9,7,12,0,0,0,0,17491,6.6,16826,200,48,233,-1221,20,1749.1,7,9,8,0,0,0,0,17258,6.8,18047,216,45,-233,1221,21.6,1725.8,blue,3,1.67,17,74,blue
4476858063,7,4,8,0,0,0,0,16798,7,18520,225,45,916,780,22.5,1679.8,4,7,4,0,0,0,0,15882,7,17740,236,48,-916,-780,23.6,1588.2,blue,3.75,1.14,27,20,red
4516079529,1,1,1,2,1,1,0,14379,6.8,17751,247,64,-411,430,24.7,1437.9,1,1,2,0,0,0,0,14790,7,17321,228,45,411,-430,22.8,1479,blue,2,3,27,21,red
4419298949,5,9,5,0,0,0,0,15953,6.8,16466,223,51,-1047,-193,22.3,1595.3,9,5,10,1,1,0,0,17000,6.4,16659,179,68,1047,193,17.9,1700,red,1.11,3.8,19,17,blue
4500073526,7,5,5,0,0,0,0,17303,7,18048,216,43,3111,1587,21.6,1730.3,5,7,2,1,1,0,0,14192,6.6,16461,165,48,-3111,-1587,16.5,1419.2,blue,2.4,1,16,17,red
4467280497,4,3,4,1,1,0,0,16114,7,18458,233,58,1694,1199,23.3,1611.4,3,4,3,1,0,1,0,14420,6.6,17259,210,48,-1694,-1199,21,1442,blue,2.67,1.5,15,18,blue
4452298627,15,4,19,1,1,0,0,21314,7.2,19360,245,32,6950,3536,24.5,2131.4,4,15,2,0,0,0,0,14364,6.4,15824,193,37,-6950,-3536,19.3,1436.4,blue,8.5,0.4,18,17,blue
4492609650,5,4,2,2,1,1,0,15660,6.8,18225,224,53,413,947,22.4,1566,4,5,2,0,0,0,0,15247,6.8,17278,226,33,-413,-947,22.6,1524.7,blue,1.75,1.2,21,30,blue
4442298197,9,6,13,1,1,0,0,17169,6.8,17934,216,33,-92,-1411,21.6,1716.9,6,9,6,1,0,1,0,17261,7.2,19345,221,63,92,1411,22.1,1726.1,red,3.67,1.33,20,14,blue
4524775955,6,9,7,2,1,1,0,15649,6.8,17052,186,44,-2822,-1240,18.6,1564.9,9,6,9,0,0,0,0,18471,7,18292,248,32,2822,1240,24.8,1847.1,blue,1.44,3,16,15,red
4522381918,7,5,8,0,0,0,0,17088,7,18086,204,53,180,893,20.4,1708.8,5,7,9,2,1,1,0,16908,6.8,17193,230,54,-180,-893,23,1690.8,blue,3,2,114,38,blue
4499861575,7,5,8,1,1,0,0,18042,7,19223,239,68,2006,346,23.9,1804.2,5,7,4,1,0,1,0,16036,7.2,18877,222,56,-2006,-346,22.2,1603.6,blue,3,1.29,23,17,blue
4516913135,5,14,3,0,0,0,0,15424,6.8,17248,191,35,-4585,-3125,19.1,1542.4,14,5,13,2,1,1,0,20009,7.4,20373,228,56,4585,3125,22.8,2000.9,red,0.57,5.4,17,19,red
4491649164,3,4,3,0,0,0,0,15459,7,18000,230,55,-174,231,23,1545.9,4,3,5,2,1,1,0,15633,7,17769,212,48,174,-231,21.2,1563.3,blue,1.5,3,17,19,red
4521619561,14,6,12,0,0,0,0,19588,7.2,19987,217,45,3864,2988,21.7,1958.8,6,14,10,0,0,0,0,15724,6.8,16999,162,50,-3864,-2988,16.2,1572.4,blue,4.33,1.14,13,29,blue
4456065713,8,9,6,1,0,1,0,16951,7,18684,200,57,-32,-204,20,1695.1,9,8,9,1,1,0,0,16983,7,18888,216,46,32,204,21.6,1698.3,blue,1.56,2.25,13,17,blue
4512610035,4,9,3,1,1,0,0,15533,7,18431,214,56,-3728,-2079,21.4,1553.3,9,4,8,0,0,0,0,19261,7.4,20510,259,65,3728,2079,25.9,1926.1,red,0.78,4.25,17,20,red
4463081486,7,4,8,0,0,0,0,17653,7,18461,231,59,2962,2430,23.1,1765.3,4,7,5,0,0,0,0,14691,6.4,16031,210,31,-2962,-2430,21,1469.1,red,3.75,1.29,15,19,blue
4501505628,4,7,2,0,0,0,0,14811,6.6,17429,224,44,-2076,-679,22.4,1481.1,7,4,6,0,0,0,0,16887,6.8,18108,235,36,2076,679,23.5,1688.7,red,0.86,3.25,24,22,red
4453150703,3,6,3,0,0,0,0,14538,6.2,15395,177,50,-1266,-1255,17.7,1453.8,6,3,6,1,1,0,0,15804,6.4,16650,200,52,1266,1255,20,1580.4,blue,1,4,18,15,blue
4484592452,12,9,20,0,0,0,0,20188,7.2,18981,226,47,2735,1076,22.6,2018.8,9,12,19,0,0,0,0,17453,6.8,17905,198,42,-2735,-1076,19.8,1745.3,blue,3.56,2.33,22,17,blue
4522819691,5,4,3,0,0,0,0,16021,7.2,19551,216,60,-470,1524,21.6,1602.1,4,5,4,0,0,0,0,16491,6.8,18027,237,50,470,-1524,23.7,1649.1,red,2,1.6,39,17,red
4475624024,6,4,6,0,0,0,0,16112,6.8,17631,207,42,922,146,20.7,1611.2,4,6,5,2,1,1,0,15190,7,17485,199,72,-922,-146,19.9,1519,blue,3,1.5,76,27,red
4519789324,6,5,2,1,1,0,0,15967,7,18611,237,56,-999,-778,23.7,1596.7,5,6,5,1,0,1,0,16966,7.2,19389,250,54,999,778,25,1696.6,blue,1.6,1.67,16,13,red
4496561150,1,6,1,0,0,0,0,13126,6.6,17066,173,55,-3823,-2613,17.3,1312.6,6,1,3,2,1,1,0,16949,7.2,19679,234,63,3823,2613,23.4,1694.9,red,0.33,9,18,30,red
4484513545,6,2,8,2,1,1,0,17501,7.2,19153,248,52,2122,1958,24.8,1750.1,2,6,2,0,0,0,0,15379,6.6,17195,229,52,-2122,-1958,22.9,1537.9,blue,7,0.67,24,21,blue
4513177731,11,3,8,1,1,0,0,18826,7.4,20300,225,48,3988,4246,22.5,1882.6,3,11,3,1,0,1,0,14838,6.4,16054,195,55,-3988,-4246,19.5,1483.8,blue,6.33,0.55,19,19,blue
4524058240,1,6,2,1,1,0,0,14165,6.8,17829,218,59,-1963,-45,21.8,1416.5,6,1,7,0,0,0,0,16128,7,17874,205,52,1963,45,20.5,1612.8,red,0.5,13,44,21,red
4524567025,10,3,17,1,1,0,0,18110,6.8,18193,193,60,2607,657,19.3,1811,3,10,5,0,0,0,0,15503,6.6,17536,236,56,-2607,-657,23.6,1550.3,red,9,0.8,17,16,blue
4510867188,5,4,5,1,0,1,0,16731,7.4,19377,238,60,1675,2022,23.8,1673.1,4,5,2,1,1,0,0,15056,6.8,17355,218,63,-1675,-2022,21.8,1505.6,red,2.5,1.2,13,17,blue
4462493939,8,9,8,0,0,0,0,16984,7,18400,206,44,-1720,-1376,20.6,1698.4,9,8,6,1,1,0,0,18704,7.2,19776,226,52,1720,1376,22.6,1870.4,red,1.78,1.88,18,219,red
4524955367,2,6,2,1,1,0,0,14341,6.8,17715,233,52,-1929,-680,23.3,1434.1,6,2,8,0,0,0,0,16270,7,18395,233,44,1929,680,23.3,1627,blue,0.67,7,20,19,red
4520974128,8,5,10,1,1,0,0,17667,7.4,19486,237,48,2461,1779,23.7,1766.7,5,8,6,0,0,0,0,15206,6.8,17707,217,36,-2461,-1779,21.7,1520.6,blue,3.6,1.38,15,17,blue
4515361203,1,8,1,0,0,0,0,13704,6.6,16135,202,47,-5578,-2480,20.2,1370.4,8,1,9,2,1,1,1,19282,7,18615,247,64,5578,2480,24.7,1928.2,red,0.25,17,93,20,red
4469994389,6,12,11,1,1,0,0,15863,7,17107,191,49,-3479,-2205,19.1,1586.3,12,6,18,0,0,0,0,19342,7.4,19312,222,58,3479,2205,22.2,1934.2,red,1.42,5,16,15,blue
4420924071,2,12,2,0,0,0,0,14834,7,17374,198,67,-4063,-2598,19.8,1483.4,12,2,12,0,0,0,0,18897,7.4,19972,243,49,4063,2598,24.3,1889.7,red,0.33,12,23,28,red
4487468549,12,7,16,0,0,0,0,19246,7.2,19668,231,40,2861,1432,23.1,1924.6,7,12,5,0,0,0,0,16385,6.8,18236,213,55,-2861,-1432,21.3,1638.5,blue,4,1,18,17,red
4524168146,9,7,12,2,1,1,0,17091,6.8,17740,214,40,940,503,21.4,1709.1,7,9,6,0,0,0,0,16151,6.8,17237,210,48,-940,-503,21,1615.1,blue,3,1.44,14,18,blue
4498584517,2,8,3,1,1,0,0,13803,6.4,15972,181,45,-5226,-3701,18.1,1380.3,8,2,9,1,0,1,0,19029,7.2,19673,259,55,5226,3701,25.9,1902.9,red,0.62,8.5,17,17,red
4479288028,4,6,3,2,1,1,0,16485,7.2,19097,250,68,-264,315,25,1648.5,6,4,9,0,0,0,0,16749,7.2,18782,233,49,264,-315,23.3,1674.9,blue,1.17,3.75,32,41,blue
4520570200,2,4,0,0,0,0,0,14876,7,18374,218,68,-1187,-1561,21.8,1487.6,4,2,3,1,1,0,0,16063,7.4,19935,222,68,1187,1561,22.2,1606.3,red,0.5,3.5,18,15,red
4509866681,6,5,6,0,0,0,0,17594,7,18431,237,42,2264,1006,23.7,1759.4,5,6,5,0,0,0,0,15330,6.8,17425,190,55,-2264,-1006,19,1533,blue,2.4,1.67,13,23,blue
4481959018,6,11,9,0,0,0,0,16230,6.8,17275,225,51,-2725,-2117,22.5,1623,11,6,12,1,1,0,0,18955,7,19392,221,74,2725,2117,22.1,1895.5,red,1.36,3.83,19,20,red
4507366175,4,4,3,1,1,0,0,15239,7.2,18213,222,49,-251,231,22.2,1523.9,4,4,6,1,0,1,0,15490,6.8,17982,213,55,251,-231,21.3,1549,blue,1.75,2.5,18,18,blue
4513046591,8,12,7,0,0,0,0,16247,6.6,16555,189,36,-3023,-3630,18.9,1624.7,12,8,9,0,0,0,0,19270,7.6,20185,244,52,3023,3630,24.4,1927,red,1.25,2.62,17,18,blue
4517941461,4,5,4,0,0,0,0,15223,6.8,18081,216,48,-375,180,21.6,1522.3,5,4,7,1,1,0,0,15598,7.2,17901,226,48,375,-180,22.6,1559.8,red,1.6,3,20,23,blue
4501838629,5,9,2,1,1,0,0,16099,7,18159,244,50,-1367,-1526,24.4,1609.9,9,5,9,1,0,1,0,17466,7.4,19685,197,64,1367,1526,19.7,1746.6,red,0.78,3.6,46,33,blue
4500021732,9,3,8,0,0,0,0,17940,7.4,19752,224,53,3828,2549,22.4,1794,3,9,3,1,1,0,0,14112,6.8,17203,200,37,-3828,-2549,20,1411.2,blue,5.67,0.67,16,16,blue
4518154341,2,2,0,0,0,0,0,15652,7.6,19647,270,68,-194,459,27,1565.2,2,2,2,1,1,0,0,15846,7,19188,276,60,194,-459,27.6,1584.6,red,1,2,13,15,blue
4513564406,9,6,8,1,1,0,0,18161,7,19168,213,53,1926,2400,21.3,1816.1,6,9,9,0,0,0,0,16235,6.8,16768,202,29,-1926,-2400,20.2,1623.5,red,2.83,1.67,22,13,blue
4442484650,2,9,1,0,0,0,0,13569,6,14129,165,52,-3535,-3197,16.5,1356.9,9,2,11,2,1,1,0,17104,7,17326,215,44,3535,3197,21.5,1710.4,red,0.33,10,15,15,red
4476251549,8,7,9,0,0,0,0,18048,7.2,18082,242,57,1831,994,24.2,1804.8,7,8,11,2,1,1,0,16217,6.8,17088,218,40,-1831,-994,21.8,1621.7,blue,2.43,2.25,24,22,red
4498445484,6,7,2,1,1,0,1,17046,7.2,18406,197,76,-190,-576,19.7,1704.6,7,6,5,1,0,1,0,17236,7.2,18982,229,53,190,576,22.9,1723.6,red,1.14,2,20,20,red
4518938829,4,3,6,1,1,0,0,16647,7.4,19826,227,72,744,878,22.7,1664.7,3,4,2,0,0,0,0,15903,7,18948,242,56,-744,-878,24.2,1590.3,blue,3.33,1.25,20,18,red
4494818670,6,5,8,1,1,0,0,16283,7,18397,228,44,-152,71,22.8,1628.3,5,6,8,0,0,0,0,16435,6.8,18326,253,40,152,-71,25.3,1643.5,blue,2.8,2.17,20,20,blue
4516011875,15,4,16,0,0,0,1,22433,7.4,20086,230,56,7621,4647,23,2243.3,4,15,9,1,1,0,0,14812,6.4,15439,192,56,-7621,-4647,19.2,1481.2,blue,7.75,0.87,30,17,blue
4451957612,5,2,9,0,0,0,0,15429,6.8,16480,202,44,1043,-1408,20.2,1542.9,2,5,3,0,0,0,0,14386,6.8,17888,203,38,-1043,1408,20.3,1438.6,red,7,1,19,41,blue
4510563287,8,10,8,0,0,0,0,16239,7,17518,186,48,-1289,-1384,18.6,1623.9,10,8,8,1,1,0,0,17528,7,18902,204,53,1289,1384,20.4,1752.8,red,1.6,2.25,12,18,red
4476265926,10,4,11,0,0,0,0,18228,7.2,19423,250,36,3419,4709,25,1822.8,4,10,2,1,1,0,0,14809,6.2,14714,193,41,-3419,-4709,19.3,1480.9,blue,5.25,0.6,44,16,blue
4513059451,5,5,9,1,1,0,0,16983,7,18017,238,46,-851,-115,23.8,1698.3,5,5,5,1,0,1,1,17834,6.8,18132,228,59,851,115,22.8,1783.4,red,2.8,2,18,19,blue
4496593867,8,5,10,0,0,0,0,16957,7,18220,204,55,1484,469,20.4,1695.7,5,8,3,0,0,0,0,15473,6.6,17751,226,35,-1484,-469,22.6,1547.3,blue,3.6,1,19,18,red
4498547016,13,4,13,1,1,0,0,18962,7.6,20021,207,48,3833,2849,20.7,1896.2,4,13,3,1,0,1,0,15129,6.8,17172,203,43,-3833,-2849,20.3,1512.9,blue,6.5,0.54,88,22,blue
4518959670,9,5,15,1,1,0,0,16888,6.8,17236,200,48,993,783,20,1688.8,5,9,7,0,0,0,0,15895,6.4,16453,206,48,-993,-783,20.6,1589.5,red,4.8,1.33,15,14,red
4511678371,4,10,5,0,0,0,0,14993,6.4,16201,208,48,-3416,-2347,20.8,1499.3,10,4,12,1,1,0,0,18409,7.2,18548,206,64,3416,2347,20.6,1840.9,red,0.9,5.5,19,19,red
4519160523,8,9,10,1,1,0,0,16076,6.2,14942,181,42,143,-603,18.1,1607.6,9,8,18,0,0,0,0,15933,6.4,15545,178,32,-143,603,17.8,1593.3,blue,2,3.38,45,12,blue
4510758423,6,1,4,0,0,0,0,17007,7.4,19713,242,52,3332,2410,24.2,1700.7,1,6,2,1,1,0,0,13675,6.8,17303,194,68,-3332,-2410,19.4,1367.5,blue,10,0.5,20,18,blue
4522504958,6,8,7,1,1,0,0,16000,6.4,16023,212,19,-1208,-2526,21.2,1600,8,6,13,0,0,0,0,17208,7.2,18549,210,37,1208,2526,21,1720.8,red,1.62,3.5,19,19,red
4454764258,4,5,4,1,0,1,0,16021,6.8,18017,209,69,-217,571,20.9,1602.1,5,4,6,1,1,0,0,16238,6.8,17446,236,47,217,-571,23.6,1623.8,red,1.6,2.75,37,72,blue
4489645082,8,5,9,0,0,0,0,17345,7,18111,183,41,1421,-792,18.3,1734.5,5,8,4,1,1,0,0,15924,7,18903,207,68,-1421,792,20.7,1592.4,blue,3.4,1.12,51,22,red
4521106254,10,6,13,0,0,0,0,17976,7.4,18454,176,52,1642,1965,17.6,1797.6,6,10,5,1,1,0,0,16334,6.4,16489,195,46,-1642,-1965,19.5,1633.4,red,3.83,1.1,15,14,red
4480198184,6,10,9,0,0,0,0,16853,7,18059,225,44,-1590,-1867,22.5,1685.3,10,6,9,1,1,0,0,18443,7.2,19926,242,55,1590,1867,24.2,1844.3,red,1.5,3.17,19,14,red
4523348814,7,3,6,1,0,1,0,16300,7,18376,226,47,286,-12,22.6,1630,3,7,2,1,1,0,0,16014,6.8,18388,239,56,-286,12,23.9,1601.4,red,4.33,0.71,21,23,blue
4497769200,4,1,3,1,1,0,0,16417,7,18579,248,72,1930,793,24.8,1641.7,1,4,1,0,0,0,0,14487,6.8,17786,257,54,-1930,-793,25.7,1448.7,blue,7,0.5,17,15,blue
4522784053,7,5,5,1,1,0,0,17466,6.8,17536,239,61,2887,2085,23.9,1746.6,5,7,7,0,0,0,0,14579,6.2,15451,174,46,-2887,-2085,17.4,1457.9,red,2.4,1.71,22,40,blue
4481987758,14,9,13,1,1,0,0,19830,7.2,19377,217,60,2594,2485,21.7,1983,9,14,9,0,0,0,0,17236,6.6,16892,185,40,-2594,-2485,18.5,1723.6,blue,3,1.29,45,20,red
4521835528,6,4,9,0,0,0,0,16726,7,18564,234,54,897,366,23.4,1672.6,4,6,2,1,1,0,0,15829,7,18198,214,69,-897,-366,21.4,1582.9,red,3.75,1,25,19,red
4449777649,9,6,9,0,0,0,0,17162,7,18004,193,38,778,548,19.3,1716.2,6,9,14,1,1,0,0,16384,7,17456,200,53,-778,-548,20,1638.4,red,3,2.22,21,21,blue
4519324641,13,5,12,1,1,0,0,19535,7.4,19835,231,53,4778,4324,23.1,1953.5,5,13,5,0,0,0,0,14757,6.2,15511,173,51,-4778,-4324,17.3,1475.7,blue,5,0.77,34,19,blue
4505242259,4,2,4,0,0,0,0,15514,7.2,18840,235,64,-81,882,23.5,1551.4,2,4,1,0,0,0,0,15595,7,17958,261,55,81,-882,26.1,1559.5,blue,4,0.75,65,13,red
4502985762,4,1,4,0,0,0,0,16008,7.2,19253,247,45,344,1298,24.7,1600.8,1,4,2,0,0,0,0,15664,7,17955,264,52,-344,-1298,26.4,1566.4,blue,8,0.75,16,18,blue
4520683892,7,3,9,0,0,0,0,16981,7.2,19106,232,46,2483,2299,23.2,1698.1,3,7,3,1,1,0,0,14498,6.6,16807,190,52,-2483,-2299,19,1449.8,blue,5.33,0.86,20,46,blue
4524310116,4,8,4,0,0,0,0,14722,6.6,17262,190,48,-2208,-2862,19,1472.2,8,4,4,2,1,1,0,16930,7.6,20124,210,72,2208,2862,21,1693,red,1,3,20,16,red
4514199530,5,7,3,0,0,0,0,15715,7,17843,237,46,-1425,-1296,23.7,1571.5,7,5,9,0,0,0,0,17140,7.4,19139,228,60,1425,1296,22.8,1714,blue,1.14,3.2,115,13,red
4489343970,3,5,2,0,0,0,0,16102,7.2,19258,257,66,-281,110,25.7,1610.2,5,3,4,1,1,0,0,16383,7,19148,251,50,281,-110,25.1,1638.3,red,1,3,16,16,red
4431814221,5,7,1,0,0,0,0,14991,7,17681,180,64,-2000,-1473,18,1499.1,7,5,6,1,1,0,0,16991,7.2,19154,208,62,2000,1473,20.8,1699.1,red,0.86,2.6,20,19,blue
4463523266,11,7,14,0,0,0,0,19379,7,18120,215,40,3021,347,21.5,1937.9,7,11,8,0,0,0,0,16358,6.8,17773,186,52,-3021,-347,18.6,1635.8,blue,3.57,1.36,19,18,blue
4518528928,8,3,8,0,0,0,0,17101,7,17725,214,40,2294,1989,21.4,1710.1,3,8,6,2,1,1,0,14807,6.4,15736,182,48,-2294,-1989,18.2,1480.7,blue,5.33,1.12,55,21,red
4514107032,4,2,4,0,0,0,0,17186,7,19734,263,72,2478,1105,26.3,1718.6,2,4,3,2,1,1,0,14708,7,18629,209,60,-2478,-1105,20.9,1470.8,blue,4,1.25,17,22,blue
4519035027,3,4,1,1,1,0,0,15115,7.2,19609,219,72,-90,982,21.9,1511.5,4,3,1,1,0,1,0,15205,7.2,18627,213,44,90,-982,21.3,1520.5,blue,1,1.67,15,19,red
4480445150,4,5,6,2,1,1,0,16127,6.8,17245,235,55,1210,1410,23.5,1612.7,5,4,3,0,0,0,0,14917,6.4,15835,191,40,-1210,-1410,19.1,1491.7,blue,2,2,16,23,red
4490211432,6,10,9,0,0,0,0,15445,6.4,16320,188,40,-3473,-1314,18.8,1544.5,10,6,11,0,0,0,0,18918,6.8,17634,217,40,3473,1314,21.7,1891.8,blue,1.5,3.5,22,17,red
4481270727,8,7,8,0,0,0,0,16585,7,18064,207,54,-627,-998,20.7,1658.5,7,8,4,0,0,0,0,17212,7.2,19062,222,64,627,998,22.2,1721.2,red,2.29,1.38,19,15,red
4523421831,4,4,7,1,1,0,0,15788,6.8,18264,243,50,671,881,24.3,1578.8,4,4,5,0,0,0,0,15117,7,17383,228,48,-671,-881,22.8,1511.7,red,2.75,2.25,15,17,blue
4524290277,7,7,5,1,1,0,0,17400,7.4,19175,239,64,567,-8,23.9,1740,7,7,10,0,0,0,0,16833,7.2,19183,237,56,-567,8,23.7,1683.3,blue,1.71,2.43,28,67,blue
4477637530,2,9,3,1,0,1,0,14157,6.4,16183,198,48,-3421,-2978,19.8,1415.7,9,2,10,1,1,0,0,17578,7.2,19161,238,48,3421,2978,23.8,1757.8,red,0.56,9.5,39,19,blue
4516995373,2,3,5,1,0,1,0,14992,6.8,18110,226,56,-415,1224,22.6,1499.2,3,2,5,1,1,0,0,15407,6.6,16886,222,55,415,-1224,22.2,1540.7,red,2.33,4,42,22,blue
4516897705,7,5,6,1,0,1,0,17182,7.2,18530,243,50,946,357,24.3,1718.2,5,7,5,1,1,0,0,16236,7,18173,228,66,-946,-357,22.8,1623.6,red,2.6,1.43,20,78,blue
4522690291,7,5,7,1,0,1,0,16426,6.8,17766,187,46,846,-1893,18.7,1642.6,5,7,0,1,1,0,0,15580,7.4,19659,231,61,-846,1893,23.1,1558,blue,2.8,0.71,13,15,blue
4512476997,7,10,11,0,0,0,0,16135,6.8,16250,184,46,-2299,-3211,18.4,1613.5,10,7,11,2,1,1,0,18434,7.2,19461,235,59,2299,3211,23.5,1843.4,blue,1.8,3,16,20,red
4511306202,5,3,4,0,0,0,0,15833,7,17979,196,68,1284,25,19.6,1583.3,3,5,0,2,1,1,0,14549,6.8,17954,202,56,-1284,-25,20.2,1454.9,blue,3,0.6,17,14,blue
4508068609,9,4,10,2,1,1,0,18062,7.4,19711,223,51,2449,1146,22.3,1806.2,4,9,2,0,0,0,0,15613,7.2,18565,233,52,-2449,-1146,23.3,1561.3,blue,4.75,0.67,44,32,blue
4513799193,2,4,3,1,1,0,0,14318,7,17405,207,51,-2928,-110,20.7,1431.8,4,2,10,0,0,0,1,17246,7,17515,240,44,2928,110,24,1724.6,red,1.25,7,15,21,red
4524523672,4,7,4,1,1,0,0,14969,6.8,16927,195,45,-1404,-509,19.5,1496.9,7,4,6,0,0,0,0,16373,6.8,17436,206,46,1404,509,20.6,1637.3,blue,1.14,3.25,47,23,red
4426767631,7,1,8,0,0,0,0,17177,7,19119,223,40,3368,2352,22.3,1717.7,1,7,1,1,1,0,0,13809,6.6,16767,205,48,-3368,-2352,20.5,1380.9,blue,15,0.29,19,19,blue
4510972926,8,9,7,0,0,0,0,16617,7,17480,184,44,-985,-1441,18.4,1661.7,9,8,7,1,1,0,0,17602,7.2,18921,222,55,985,1441,22.2,1760.2,red,1.67,2,16,23,blue
4524982969,8,9,7,0,0,0,0,16908,7.2,18246,208,59,383,1668,20.8,1690.8,9,8,14,1,1,0,0,16525,6.6,16578,182,30,-383,-1668,18.2,1652.5,red,1.67,2.88,18,42,blue
4524074857,9,5,6,2,1,1,0,18419,7.6,19957,246,56,1773,1953,24.6,1841.9,5,9,7,0,0,0,0,16646,6.8,18004,244,50,-1773,-1953,24.4,1664.6,blue,3,1.33,84,16,red
4518664448,7,9,9,0,0,0,0,15570,6.8,15894,198,36,-2365,-1443,19.8,1557,9,7,14,0,0,0,0,17935,6.8,17337,204,44,2365,1443,20.4,1793.5,red,1.78,3.29,18,22,blue
4505204849,3,10,3,0,0,0,0,15016,6.8,17172,216,38,-2188,-1753,21.6,1501.6,10,3,11,1,1,0,0,17204,7,18925,217,35,2188,1753,21.7,1720.4,red,0.6,7,16,84,red
4495401600,2,4,2,1,1,0,0,14402,7,17604,193,64,-1506,-500,19.3,1440.2,4,2,6,0,0,0,0,15908,6.8,18104,227,52,1506,500,22.7,1590.8,blue,1,5,17,17,blue
4519133834,6,16,6,1,1,0,0,14999,6.4,15530,192,44,-6027,-3955,19.2,1499.9,16,6,24,0,0,0,0,21026,7.4,19485,228,52,6027,3955,22.8,2102.6,red,0.75,6.67,18,22,red
4498073592,4,7,4,1,1,0,0,15149,6.8,16969,217,51,-1887,-567,21.7,1514.9,7,4,9,0,0,0,0,17036,6.8,17536,241,44,1887,567,24.1,1703.6,red,1.14,4,18,18,blue
4518908419,5,6,7,1,1,0,0,15761,6.6,17003,187,56,-839,-800,18.7,1576.1,6,5,9,1,0,1,0,16600,7.2,17803,206,49,839,800,20.6,1660,blue,2,3,39,21,blue
4484535583,2,9,2,0,0,0,0,14714,6.8,17620,217,49,-2484,-1989,21.7,1471.4,9,2,7,0,0,0,0,17198,7.4,19609,232,43,2484,1989,23.2,1719.8,red,0.44,8,28,17,red
4437258310,5,3,8,0,0,0,0,15154,6.4,15685,206,28,1087,-1278,20.6,1515.4,3,5,1,0,0,0,0,14067,6.8,16963,192,43,-1087,1278,19.2,1406.7,blue,4.33,0.8,22,26,blue
4492858161,13,2,10,0,0,0,1,20998,7.2,19521,228,53,8347,5234,22.8,2099.8,2,13,0,0,0,0,0,12651,5.8,14287,181,35,-8347,-5234,18.1,1265.1,blue,11.5,0.15,22,17,blue
4516777697,9,7,7,0,0,0,0,17607,7.2,19309,212,50,716,601,21.2,1760.7,7,9,6,1,1,0,0,16891,7.2,18708,204,73,-716,-601,20.4,1689.1,blue,2.29,1.44,14,15,blue
4438426870,6,7,2,0,0,0,0,15141,6.8,17975,196,33,-770,196,19.6,1514.1,7,6,10,1,1,0,0,15911,6.8,17779,178,40,770,-196,17.8,1591.1,red,1.14,2.83,18,19,red
4519863866,16,7,12,1,1,0,0,21285,7.4,20332,229,60,5154,3837,22.9,2128.5,7,16,6,0,0,0,0,16131,6.8,16495,174,52,-5154,-3837,17.4,1613.1,blue,4,0.81,84,12,red
4525213548,9,5,7,0,0,0,0,16984,6.8,17014,214,35,1580,605,21.4,1698.4,5,9,8,0,0,0,0,15404,6.8,16409,194,40,-1580,-605,19.4,1540.4,blue,3.2,1.44,30,62,red
4495200388,3,6,2,0,0,0,0,13489,6,14875,192,20,-2345,-2959,19.2,1348.9,6,3,5,1,1,0,0,15834,6.8,17834,198,60,2345,2959,19.8,1583.4,red,0.83,3.67,18,21,red
4496800946,2,2,3,2,1,1,0,14653,7,17643,224,44,758,502,22.4,1465.3,2,2,0,0,0,0,0,13895,6.8,17141,221,50,-758,-502,22.1,1389.5,blue,2.5,1,42,21,blue
4512993311,4,12,3,0,0,0,0,15335,6.4,16838,187,71,-3983,-3676,18.7,1533.5,12,4,9,0,0,0,0,19318,7.4,20514,242,45,3983,3676,24.2,1931.8,red,0.58,5.25,17,40,red
4512141904,5,8,3,0,0,0,0,15853,7,17174,192,52,-1448,-908,19.2,1585.3,8,5,11,2,1,1,0,17301,7,18082,197,52,1448,908,19.7,1730.1,blue,1,3.8,18,17,blue
4505844973,6,10,5,0,0,0,0,15476,6.8,16691,198,50,-2199,-2258,19.8,1547.6,10,6,10,1,1,0,0,17675,7.2,18949,218,48,2199,2258,21.8,1767.5,red,1.1,3.33,16,40,red
4523297583,4,3,3,2,1,1,0,15211,7,18741,200,64,464,1520,20,1521.1,3,4,2,0,0,0,0,14747,6.8,17221,242,41,-464,-1520,24.2,1474.7,blue,2.33,1.25,43,23,blue
4456819413,5,7,8,0,0,0,0,15796,6.6,17121,184,49,-1044,-487,18.4,1579.6,7,5,11,1,1,0,0,16840,7,17608,226,49,1044,487,22.6,1684,red,1.86,3.6,32,20,red
4525070151,3,4,3,1,1,0,0,15420,7.2,18542,237,48,-136,-807,23.7,1542,4,3,2,1,0,1,0,15556,7.2,19349,237,64,136,807,23.7,1555.6,red,1.5,2,15,18,blue
4491235821,13,3,14,1,1,0,1,20961,7.6,19939,225,74,6387,3453,22.5,2096.1,3,13,2,1,0,1,0,14574,6.6,16486,182,57,-6387,-3453,18.2,1457.4,blue,9,0.38,20,17,blue
4470743478,9,10,9,1,1,0,0,17633,7,18304,218,51,-811,-410,21.8,1763.3,10,9,11,0,0,0,0,18444,7,18714,230,44,811,410,23,1844.4,red,1.8,2.33,18,26,blue
4506216514,4,2,5,1,1,0,0,16647,7.4,20048,240,84,2179,2663,24,1664.7,2,4,1,0,0,0,0,14468,6.8,17385,226,44,-2179,-2663,22.6,1446.8,blue,4.5,0.75,59,41,blue
4518410386,2,8,1,0,0,0,0,14141,6.6,16555,211,37,-2749,-800,21.1,1414.1,8,2,14,0,0,0,0,16890,6.8,17355,206,44,2749,800,20.6,1689,blue,0.38,11,39,24,red
4521025798,4,3,3,1,1,0,0,16374,7,18573,263,57,825,1066,26.3,1637.4,3,4,6,0,0,0,0,15549,6.6,17507,253,46,-825,-1066,25.3,1554.9,blue,2.33,2.25,16,20,red
4520670087,10,4,6,0,0,0,0,17125,7,17861,210,40,1294,453,21,1712.5,4,10,3,1,1,0,0,15831,7,17408,223,56,-1294,-453,22.3,1583.1,red,4,0.7,18,17,red
4489785734,4,5,6,0,0,0,0,15531,7,17609,218,44,-1814,-2306,21.8,1553.1,5,4,5,1,1,0,0,17345,7.4,19915,256,80,1814,2306,25.6,1734.5,red,2,2.5,40,17,red
4524920197,6,4,14,1,1,0,1,18529,7,18907,252,64,3048,472,25.2,1852.9,4,6,6,0,0,0,0,15481,7,18435,203,60,-3048,-472,20.3,1548.1,blue,5,1.67,19,16,blue
4509680666,4,14,2,0,0,0,0,14450,6.4,15750,186,38,-4637,-3355,18.6,1445,14,4,19,0,0,0,0,19087,7.2,19105,210,54,4637,3355,21,1908.7,red,0.43,8.25,18,19,red
4450597950,11,6,11,2,1,1,0,18185,7.4,19645,204,55,2363,2162,20.4,1818.5,6,11,7,0,0,0,0,15822,7,17483,204,44,-2363,-2162,20.4,1582.2,red,3.67,1.18,44,21,red
4502153690,3,5,2,0,0,0,0,15423,7,18346,244,56,-89,-41,24.4,1542.3,5,3,3,1,1,0,0,15512,7,18387,228,51,89,41,22.8,1551.2,red,1,2.67,17,14,red
4468198399,1,3,2,2,1,1,0,14675,7,18039,231,75,-1749,-1502,23.1,1467.5,3,1,2,0,0,0,0,16424,7.4,19541,264,60,1749,1502,26.4,1642.4,red,1,5,13,18,blue
4381127762,12,3,11,1,1,0,0,18722,7.2,18618,212,57,4246,3880,21.2,1872.2,3,12,6,0,0,0,0,14476,6,14738,176,44,-4246,-3880,17.6,1447.6,blue,7.67,0.75,18,48,blue
4469528522,2,2,1,1,0,1,0,14421,7,18228,234,40,-837,-451,23.4,1442.1,2,2,1,1,1,0,0,15258,7,18679,229,72,837,451,22.9,1525.8,red,1.5,1.5,15,90,blue
4521611697,9,8,6,0,0,0,0,17532,7.2,18592,233,44,1068,1295,23.3,1753.2,8,9,10,0,0,0,0,16464,6.8,17297,200,39,-1068,-1295,20,1646.4,blue,1.88,2,37,18,blue
4511363738,10,4,14,1,0,1,0,19271,7.2,18923,245,44,4290,1900,24.5,1927.1,4,10,7,0,0,0,0,14981,6.8,17023,193,53,-4290,-1900,19.3,1498.1,blue,6,1.1,17,14,blue
4489698898,12,12,16,1,1,0,0,18655,6.8,18368,173,51,-942,244,17.3,1865.5,12,12,15,0,0,0,0,19597,6.8,18124,226,48,942,-244,22.6,1959.7,red,2.33,2.25,23,67,blue
4492000436,2,11,2,1,0,1,0,14164,6.8,16392,202,44,-5120,-2590,20.2,1416.4,11,2,18,0,0,0,0,19284,7.2,18982,232,52,5120,2590,23.2,1928.4,red,0.36,14.5,57,49,red
4524941722,4,14,2,1,0,1,0,14476,6.4,15711,180,28,-3638,-1582,18,1447.6,14,4,13,0,0,0,0,18114,7,17293,189,40,3638,1582,18.9,1811.4,red,0.43,6.75,15,61,red
4521867073,8,7,12,1,0,1,0,18339,7.4,19803,232,74,694,1305,23.2,1833.9,7,8,10,1,1,0,0,17645,7.4,18498,245,49,-694,-1305,24.5,1764.5,blue,2.86,2.12,21,44,blue
4496662443,5,6,9,2,1,1,1,17450,6.6,17226,226,53,555,-1022,22.6,1745,6,5,12,0,0,0,0,16895,7,18248,232,50,-555,1022,23.2,1689.5,blue,2.33,3.6,19,22,red
4441924667,7,5,6,0,0,0,0,16381,7,18126,221,56,134,-1142,22.1,1638.1,5,7,3,2,1,1,0,16247,7.2,19268,231,64,-134,1142,23.1,1624.7,red,2.6,1.14,22,16,blue
4521004120,5,7,1,0,0,0,0,15446,6.6,16681,183,62,-1257,-1406,18.3,1544.6,7,5,5,1,1,0,0,16703,6.8,18087,186,56,1257,1406,18.6,1670.3,blue,0.86,2.4,19,87,blue
4525209452,3,7,1,1,1,0,0,14970,6.6,16402,208,54,-1187,-1058,20.8,1497,7,3,6,0,0,0,0,16157,6.8,17460,208,55,1187,1058,20.8,1615.7,blue,0.57,4.33,18,19,red
4461471902,2,7,3,0,0,0,0,14711,6.6,16207,221,45,-2625,-3375,22.1,1471.1,7,2,5,1,1,0,0,17336,7.6,19582,244,66,2625,3375,24.4,1733.6,red,0.71,6,20,18,blue
4500875626,8,7,8,0,0,0,0,17219,7.2,18432,212,60,-55,-298,21.2,1721.9,7,8,7,1,1,0,0,17274,7,18730,251,59,55,298,25.1,1727.4,blue,2.29,1.75,22,22,red
4524992699,7,5,9,1,0,1,0,18010,7.2,19401,239,66,2585,2288,23.9,1801,5,7,5,1,1,0,0,15425,6.6,17113,226,45,-2585,-2288,22.6,1542.5,blue,3.2,1.43,20,21,blue
4384342751,13,6,15,1,1,0,0,19708,7.2,18711,201,47,5186,2739,20.1,1970.8,6,13,4,0,0,0,0,14522,6.4,15972,170,24,-5186,-2739,17,1452.2,blue,4.67,0.77,19,19,red
4485910798,6,2,6,1,1,0,0,16825,7,18820,247,49,2492,1176,24.7,1682.5,2,6,2,0,0,0,0,14333,7,17644,205,56,-2492,-1176,20.5,1433.3,blue,6,0.67,26,46,blue
4475739252,1,0,1,1,0,1,0,14755,6.8,18264,223,59,1371,2146,22.3,1475.5,0,1,0,0,0,0,0,13384,6.2,16118,230,41,-1371,-2146,23,1338.4,blue,12.03,0,24,27,blue
4454553196,8,7,11,0,0,0,0,17592,7,18440,224,46,1635,1705,22.4,1759.2,7,8,7,0,0,0,0,15957,6.4,16735,195,42,-1635,-1705,19.5,1595.7,blue,2.71,1.75,19,18,blue
4480234530,5,10,5,0,0,0,0,15351,6.6,16664,179,53,-2885,-3602,17.9,1535.1,10,5,8,2,1,1,0,18236,7.2,20266,222,80,2885,3602,22.2,1823.6,red,1,3.6,17,17,red
4419637679,7,5,7,1,1,0,1,17787,7.2,18660,232,46,2360,1439,23.2,1778.7,5,7,6,0,0,0,0,15427,6.6,17221,161,60,-2360,-1439,16.1,1542.7,red,2.8,1.57,17,17,blue
4456001530,2,1,2,0,0,0,0,15031,6.8,17787,246,48,421,-160,24.6,1503.1,1,2,1,1,1,0,0,14610,6.8,17947,239,55,-421,160,23.9,1461,blue,4,1,20,17,red
4450023077,4,7,4,0,0,0,0,15407,6.6,16669,223,40,-1207,-2081,22.3,1540.7,7,4,4,0,0,0,0,16614,7.4,18750,226,60,1207,2081,22.6,1661.4,blue,1.14,2.75,23,21,blue
4464260583,4,5,4,0,0,0,0,14569,6.6,17180,194,49,-1195,-56,19.4,1456.9,5,4,6,1,1,0,0,15764,6.6,17236,194,54,1195,56,19.4,1576.4,red,1.6,2.75,143,16,red
4491856529,7,9,7,1,1,0,0,16452,6.8,17156,191,43,-2343,-2076,19.1,1645.2,9,7,5,1,0,1,0,18795,7.2,19232,261,44,2343,2076,26.1,1879.5,blue,1.56,2,94,26,blue
4481879494,3,4,3,1,1,0,1,17437,7.2,18302,255,59,3156,3919,25.5,1743.7,4,3,6,0,0,0,0,14281,6,14383,196,31,-3156,-3919,19.6,1428.1,blue,1.5,3.33,15,12,red
4480345116,5,8,4,0,0,0,0,14665,6.6,15242,188,32,-2277,-1804,18.8,1466.5,8,5,6,0,0,0,0,16942,6.6,17046,225,50,2277,1804,22.5,1694.2,blue,1.12,2.8,23,23,red
4462027689,6,4,8,1,1,0,1,18395,7,19241,236,52,3354,2318,23.6,1839.5,4,6,6,0,0,0,0,15041,6.8,16923,185,52,-3354,-2318,18.5,1504.1,blue,3.5,1.67,21,40,blue
4513437508,7,1,5,0,0,0,0,16961,7.2,19188,245,43,4060,3257,24.5,1696.1,1,7,1,0,0,0,0,12901,6.4,15931,176,45,-4060,-3257,17.6,1290.1,blue,12,0.29,17,16,blue
4519994537,3,7,2,0,0,0,0,14011,6.4,15027,197,33,-4043,-4142,19.7,1401.1,7,3,6,1,1,0,1,18054,7.2,19169,207,51,4043,4142,20.7,1805.4,red,0.71,4.33,19,16,red
4479665099,5,5,8,0,0,0,0,16871,7.2,18870,227,49,659,-111,22.7,1687.1,5,5,5,1,1,0,0,16212,7,18981,238,51,-659,111,23.8,1621.2,blue,2.6,2,19,15,red
4462423061,7,12,5,0,0,0,0,16125,6.8,17377,196,40,-3290,-2697,19.6,1612.5,12,7,14,0,0,0,0,19415,7.2,20074,231,47,3290,2697,23.1,1941.5,red,1,3.71,15,18,blue
4449313153,2,10,2,0,0,0,0,13773,6.6,16568,192,50,-3660,-3282,19.2,1377.3,10,2,8,1,1,0,0,17433,7.6,19850,239,49,3660,3282,23.9,1743.3,red,0.4,9,14,20,red
4518043689,9,12,15,0,0,0,0,18458,7,18924,243,42,-913,-192,24.3,1845.8,12,9,20,0,0,0,0,19371,7.2,19116,231,52,913,192,23.1,1937.1,blue,2,3.56,18,21,blue
4437580789,5,6,4,0,0,0,0,16258,7,18533,255,47,585,570,25.5,1625.8,6,5,9,0,0,0,0,15673,6.8,17963,180,52,-585,-570,18,1567.3,red,1.5,3,21,42,red
4459705547,9,5,8,1,1,0,0,16997,7.8,20958,222,52,1176,3600,22.2,1699.7,5,9,9,1,0,1,0,15821,6.8,17358,196,46,-1176,-3600,19.6,1582.1,blue,3.4,1.56,42,13,red
4516158411,3,9,3,1,0,1,0,15356,7.2,18213,186,57,-3505,-778,18.6,1535.6,9,3,10,1,1,0,1,18861,7.2,18991,247,36,3505,778,24.7,1886.1,red,0.67,6.33,15,18,red
4523428362,9,2,9,1,0,1,0,18870,7,18945,252,43,4909,2760,25.2,1887,2,9,1,1,1,0,0,13961,6.6,16185,202,47,-4909,-2760,20.2,1396.1,blue,9,0.33,19,17,blue
4502587670,5,7,6,0,0,0,0,15639,6.6,16156,196,48,-1003,-1777,19.6,1563.9,7,5,7,1,1,0,0,16642,6.8,17933,204,48,1003,1777,20.4,1664.2,red,1.57,2.8,21,20,red
4523482490,15,12,14,1,1,0,0,19632,7.6,20057,228,43,84,992,22.8,1963.2,12,15,9,0,0,0,0,19548,7.2,19065,237,40,-84,-992,23.7,1954.8,red,2.42,1.4,16,21,red
4472245505,6,7,12,1,1,0,0,16942,7.2,17991,247,43,330,-308,24.7,1694.2,7,6,6,1,0,1,0,16612,7,18299,192,59,-330,308,19.2,1661.2,red,2.57,2.17,14,23,red
4513601289,8,7,14,0,0,0,0,17077,6.6,16354,171,56,974,-1050,17.1,1707.7,7,8,4,1,1,0,0,16103,6.8,17404,200,48,-974,1050,20,1610.3,red,3.14,1.38,16,17,blue
4460567207,14,7,16,1,1,0,0,20269,7.4,20117,242,32,3331,1795,24.2,2026.9,7,14,7,0,0,0,0,16938,7,18322,192,56,-3331,-1795,19.2,1693.8,red,4.29,1,17,16,blue
4419234240,9,2,13,1,1,0,0,19079,7.4,20020,249,59,4371,2705,24.9,1907.9,2,9,2,0,0,0,0,14708,6.8,17315,237,39,-4371,-2705,23.7,1470.8,blue,11,0.44,18,22,blue
4484372363,6,10,6,1,1,0,0,15815,6.6,16869,196,43,-1754,-211,19.6,1581.5,10,6,10,0,0,0,0,17569,6.6,17080,201,40,1754,211,20.1,1756.9,blue,1.2,3.33,21,21,red
4458069984,3,6,3,1,0,1,1,16970,6.8,17789,252,64,381,108,25.2,1697,6,3,9,1,1,0,0,16589,7,17681,199,62,-381,-108,19.9,1658.9,red,1,5,26,14,blue
4525129599,9,7,10,0,0,0,0,18064,7.2,19192,252,45,2321,1274,25.2,1806.4,7,9,5,1,1,0,0,15743,6.8,17918,198,41,-2321,-1274,19.8,1574.3,blue,2.71,1.33,19,20,blue
4461165597,5,2,5,0,0,0,1,17169,7,18362,239,42,1574,1353,23.9,1716.9,2,5,3,2,1,1,0,15595,6.4,17009,252,54,-1574,-1353,25.2,1559.5,blue,5,1,23,20,red
4470712101,7,4,8,1,1,0,0,16413,6.8,16989,209,39,188,-1124,20.9,1641.3,4,7,6,0,0,0,0,16225,6.8,18113,248,47,-188,1124,24.8,1622.5,red,3.75,1.43,25,89,red
4482905439,6,3,7,1,1,0,0,15464,6.8,17053,219,32,679,-691,21.9,1546.4,3,6,2,1,0,1,0,14785,6.8,17744,220,44,-679,691,22,1478.5,blue,4.33,0.83,14,17,red
4505122785,5,5,10,1,1,0,0,15600,6.6,16815,207,45,-475,-1451,20.7,1560,5,5,4,0,0,0,0,16075,6.8,18266,233,49,475,1451,23.3,1607.5,red,3,1.8,13,14,blue
4524920095,1,9,1,0,0,0,0,13802,6.2,15859,216,56,-3276,-2790,21.6,1380.2,9,1,9,1,1,0,0,17078,7,18649,217,47,3276,2790,21.7,1707.8,red,0.22,18,24,147,red
4512153524,3,7,4,0,0,0,0,15033,6.6,16265,226,47,-1520,-613,22.6,1503.3,7,3,14,0,0,0,0,16553,6.6,16878,201,53,1520,613,20.1,1655.3,red,1,7,20,26,blue
4506115923,5,6,4,1,1,0,0,16803,7,18053,251,57,1349,924,25.1,1680.3,6,5,6,0,0,0,0,15454,6.8,17129,182,33,-1349,-924,18.2,1545.4,blue,1.5,2.4,17,18,blue
4476204295,4,2,7,1,1,0,0,15444,7,18334,215,52,-352,176,21.5,1544.4,2,4,3,0,0,0,0,15796,6.8,18158,257,55,352,-176,25.7,1579.6,red,5.5,1.25,49,22,blue
4524178693,7,11,11,0,0,0,0,17659,7,18496,244,58,-987,89,24.4,1765.9,11,7,17,2,1,1,0,18646,7.2,18407,206,49,987,-89,20.6,1864.6,blue,1.64,4,16,19,red
4499662774,10,9,18,0,0,0,0,18720,7.2,19060,232,30,520,897,23.2,1872,9,10,9,2,1,1,0,18200,7,18163,202,64,-520,-897,20.2,1820,blue,3.11,1.8,42,20,blue
4499721373,6,5,5,1,1,0,1,17639,7,17826,247,48,1181,-683,24.7,1763.9,5,6,6,1,0,1,0,16458,7.2,18509,240,55,-1181,683,24,1645.8,red,2.2,1.83,22,17,blue
4478440823,8,4,12,0,0,0,0,17307,7,18013,249,34,2516,1053,24.9,1730.7,4,8,3,1,1,0,0,14791,6.6,16960,203,54,-2516,-1053,20.3,1479.1,blue,5,0.88,23,51,blue
4502009252,4,3,6,1,1,0,0,15712,6.8,17867,241,43,66,-361,24.1,1571.2,3,4,4,0,0,0,0,15646,6.8,18228,245,51,-66,361,24.5,1564.6,blue,3.33,1.75,16,17,red
4463341783,7,2,6,1,1,0,0,17616,7,18140,243,54,2590,1018,24.3,1761.6,2,7,4,1,0,1,0,15026,6.6,17122,248,46,-2590,-1018,24.8,1502.6,blue,6.5,0.86,21,23,red
4483298051,7,3,5,0,0,0,0,17235,7.4,19915,257,57,2648,2595,25.7,1723.5,3,7,3,0,0,0,0,14587,6.8,17320,191,52,-2648,-2595,19.1,1458.7,red,4,0.86,22,20,red
4518622747,12,10,10,2,1,1,1,20065,7.2,18844,204,71,2763,3068,20.4,2006.5,10,12,11,0,0,0,0,17302,6.4,15776,168,39,-2763,-3068,16.8,1730.2,blue,2.2,1.75,18,19,blue
4522155540,2,3,2,2,1,1,0,15537,6.8,17374,244,59,1024,415,24.4,1553.7,3,2,2,0,0,0,0,14513,6.8,16959,224,45,-1024,-415,22.4,1451.3,red,1.33,2.5,16,14,red
4519771711,10,8,9,0,0,0,0,18359,6.8,17074,190,48,1462,249,19,1835.9,8,10,12,0,0,0,0,16897,6.6,16825,160,47,-1462,-249,16,1689.7,red,2.38,2,21,19,red
4442192126,4,5,3,0,0,0,0,15884,6.8,17698,251,42,739,1639,25.1,1588.4,5,4,6,1,1,0,0,15145,6.4,16059,175,54,-739,-1639,17.5,1514.5,blue,1.4,2.75,18,18,blue
4510534597,3,9,3,0,0,0,0,14512,6.6,16088,226,32,-3476,-4019,22.6,1451.2,9,3,6,2,1,1,0,17988,7.4,20107,249,55,3476,4019,24.9,1798.8,red,0.67,5,18,13,red
4497672608,5,9,7,0,0,0,0,15440,6.8,17277,175,57,-2494,-2755,17.5,1544,9,5,10,0,0,0,0,17934,7.2,20032,237,57,2494,2755,23.7,1793.4,red,1.33,3.8,37,14,blue
4522420599,7,4,6,1,1,0,0,16296,7,18093,222,48,1576,1573,22.2,1629.6,4,7,2,0,0,0,0,14720,6.6,16520,192,53,-1576,-1573,19.2,1472,blue,3.25,0.86,24,20,red
4524772917,1,6,1,0,0,0,0,14979,7,18306,232,66,-2607,59,23.2,1497.9,6,1,5,2,1,1,1,17586,6.8,18247,238,54,2607,-59,23.8,1758.6,red,0.33,11,23,21,red
4495516113,6,5,5,1,1,0,0,16364,6.8,17787,226,40,978,315,22.6,1636.4,5,6,5,0,0,0,0,15386,7,17472,194,44,-978,-315,19.4,1538.6,blue,2.2,1.67,20,20,blue
4468138311,4,13,1,0,0,0,0,14003,6.6,16419,195,24,-5945,-2122,19.5,1400.3,13,4,15,0,0,0,0,19948,7,18541,232,31,5945,2122,23.2,1994.8,red,0.38,7,17,22,red
4456177266,6,8,5,0,0,0,0,16459,7,18612,201,58,-2021,-1891,20.1,1645.9,8,6,7,0,0,0,0,18480,7.4,20503,235,80,2021,1891,23.5,1848,red,1.38,2.5,14,20,blue
4479609510,3,7,4,0,0,0,0,15361,7,17290,235,55,-1226,-2432,23.5,1536.1,7,3,5,0,0,0,0,16587,7.4,19722,221,44,1226,2432,22.1,1658.7,red,1,4,17,161,blue
4510150103,7,5,6,1,0,1,0,18345,7.4,20002,247,58,3272,3059,24.7,1834.5,5,7,8,1,1,0,0,15073,6.8,16943,183,37,-3272,-3059,18.3,1507.3,red,2.6,1.86,22,13,red
4524537915,10,5,8,1,1,0,0,18497,7.2,19069,223,54,3609,3620,22.3,1849.7,5,10,5,0,0,0,0,14888,6.4,15449,174,52,-3609,-3620,17.4,1488.8,red,3.6,1,17,15,red
4459775765,3,4,3,0,0,0,0,14642,6.6,16219,229,36,-744,-1255,22.9,1464.2,4,3,4,2,1,1,0,15386,6.8,17474,212,52,744,1255,21.2,1538.6,red,1.5,2.67,17,18,red
4512194286,3,8,1,0,0,0,0,15539,6.8,17792,214,72,-2925,-2112,21.4,1553.9,8,3,9,2,1,1,0,18464,7.2,19904,242,47,2925,2112,24.2,1846.4,red,0.5,5.67,15,23,red
4507618231,13,7,19,0,0,0,0,18781,6.8,17690,204,43,2348,1462,20.4,1878.1,7,13,12,0,0,0,0,16433,6.6,16228,191,44,-2348,-1462,19.1,1643.3,red,4.57,1.46,19,19,blue
4484715251,7,11,6,0,0,0,0,16509,6.8,17298,210,53,-1997,-2590,21,1650.9,11,7,10,0,0,0,0,18506,7.4,19888,228,67,1997,2590,22.8,1850.6,red,1.18,3,22,39,red
4460648700,3,3,3,1,1,0,0,14820,6.8,16751,215,36,-292,-127,21.5,1482,3,3,3,1,0,1,0,15112,6.6,16878,222,38,292,127,22.2,1511.2,blue,2,2,18,19,red
4471214244,4,4,5,0,0,0,0,15465,6.8,17217,217,55,-398,-763,21.7,1546.5,4,4,1,1,1,0,0,15863,6.8,17980,249,52,398,763,24.9,1586.3,red,2.25,1.25,22,15,red
4472594509,3,8,1,0,0,0,0,15241,7,18179,252,44,-1514,-1033,25.2,1524.1,8,3,8,2,1,1,0,16755,7.4,19212,224,40,1514,1033,22.4,1675.5,red,0.5,5.33,18,19,red
4520860576,4,7,8,0,0,0,0,15842,6.8,17016,211,48,-1214,-840,21.1,1584.2,7,4,11,2,1,1,0,17056,6.8,17856,198,56,1214,840,19.8,1705.6,red,1.71,4.5,20,41,red
4494516149,4,7,4,1,0,1,0,16388,7,17168,220,50,-420,-1518,22,1638.8,7,4,10,0,0,0,0,16808,7.2,18686,239,37,420,1518,23.9,1680.8,red,1.14,4.25,40,18,red
4459506875,4,2,6,2,1,1,0,15837,7,18178,226,68,425,422,22.6,1583.7,2,4,1,0,0,0,0,15412,7,17756,255,38,-425,-422,25.5,1541.2,blue,5,0.75,24,24,blue
4451870121,11,3,12,1,1,0,0,18929,7.4,19632,220,55,4175,3930,22,1892.9,3,11,3,1,0,1,0,14754,6.6,15702,201,44,-4175,-3930,20.1,1475.4,blue,7.67,0.55,40,18,red
4512523488,7,2,10,1,1,0,0,17336,7,18459,231,52,2866,1474,23.1,1733.6,2,7,0,0,0,0,0,14470,6.8,16985,198,54,-2866,-1474,19.8,1447,blue,8.5,0.29,17,51,blue
4431352109,4,13,3,0,0,0,0,15802,6.8,17403,218,58,-3645,-1801,21.8,1580.2,13,4,14,1,1,0,0,19447,7.2,19204,214,41,3645,1801,21.4,1944.7,red,0.54,6.75,20,19,red
4487337497,6,5,9,1,1,0,0,16995,7,18679,230,64,930,567,23,1699.5,5,6,3,0,0,0,0,16065,7,18112,221,43,-930,-567,22.1,1606.5,red,3,1.33,14,20,blue
4414955673,2,1,1,0,0,0,0,16528,7.4,20454,262,92,2617,3735,26.2,1652.8,1,2,1,1,1,0,0,13911,6.6,16719,231,48,-2617,-3735,23.1,1391.1,blue,3,1,23,15,blue
4517679097,7,5,8,1,1,0,0,17182,7.2,18588,233,64,1276,1161,23.3,1718.2,5,7,8,0,0,0,0,15906,6.8,17427,213,52,-1276,-1161,21.3,1590.6,red,3,1.86,16,17,red
4379951765,4,7,4,0,0,0,0,16017,6.6,17524,202,55,-1031,-570,20.2,1601.7,7,4,7,0,0,0,0,17048,7,18094,226,52,1031,570,22.6,1704.8,red,1.14,3.5,82,17,red
4521690079,6,7,4,0,0,0,0,16286,6.8,18048,230,52,-396,795,23,1628.6,7,6,3,1,1,0,0,16682,6.6,17253,229,55,396,-795,22.9,1668.2,blue,1.43,1.67,21,19,red
4521143475,9,8,7,1,0,1,1,19084,6.8,17286,225,38,2445,-81,22.5,1908.4,8,9,5,1,1,0,0,16639,6.8,17367,189,68,-2445,81,18.9,1663.9,red,2,1.44,20,31,red
4522524149,4,12,5,0,0,0,0,14899,6.8,16761,190,36,-5515,-3391,19,1489.9,12,4,19,0,0,0,0,20414,7.4,20152,239,44,5515,3391,23.9,2041.4,red,0.75,7.75,40,21,red
4481550615,9,18,8,0,0,0,0,17290,7,17418,223,48,-3502,-2187,22.3,1729,18,9,19,1,1,0,0,20792,7.4,19605,228,45,3502,2187,22.8,2079.2,red,0.94,4.11,20,20,red
4522573873,4,6,8,0,0,0,0,17569,6.8,17848,265,40,1613,80,26.5,1756.9,6,4,4,2,1,1,0,15956,6.8,17768,214,60,-1613,-80,21.4,1595.6,red,2,2.5,28,20,blue
4462344917,9,2,9,1,1,0,0,17964,7.4,19813,213,69,3311,3991,21.3,1796.4,2,9,2,0,0,0,0,14653,6.4,15822,198,51,-3311,-3991,19.8,1465.3,blue,9,0.44,43,16,red
4497982653,5,5,6,0,0,0,0,15400,7,18242,197,56,-1255,-121,19.7,1540,5,5,8,1,1,0,0,16655,7.2,18363,250,48,1255,121,25,1665.5,blue,2.2,2.6,18,17,red
4453464076,8,8,6,1,1,0,0,17761,7.2,19090,220,64,642,-3,22,1776.1,8,8,6,0,0,0,0,17119,7.2,19093,218,44,-642,3,21.8,1711.9,red,1.75,1.75,35,20,blue
4515644857,8,10,5,1,1,0,0,16480,7,17338,183,44,-1428,-1532,18.3,1648,10,8,10,0,0,0,0,17908,7.4,18870,192,56,1428,1532,19.2,1790.8,blue,1.3,2.5,18,31,blue
4502385665,8,3,6,0,0,0,0,16975,7.4,19639,238,64,1735,2029,23.8,1697.5,3,8,2,0,0,0,0,15240,6.6,17610,228,39,-1735,-2029,22.8,1524,red,4.67,0.62,17,18,blue
4523427313,5,4,7,1,1,0,0,16459,7.2,18670,222,60,785,1188,22.2,1645.9,4,5,1,0,0,0,0,15674,6.6,17482,229,64,-785,-1188,22.9,1567.4,blue,3,1,20,34,red
4517744860,7,7,7,1,1,0,0,16636,6.8,17569,207,53,-1117,-509,20.7,1663.6,7,7,4,0,0,0,0,17753,7,18078,230,54,1117,509,23,1775.3,blue,2,1.57,22,20,blue
4448404997,5,8,5,0,0,0,0,16550,6.8,17563,204,60,-748,-1865,20.4,1655,8,5,9,1,0,1,0,17298,7.2,19428,227,48,748,1865,22.7,1729.8,red,1.25,3.4,18,41,red
4479596391,8,5,10,1,1,0,0,16400,6.8,18604,181,48,-125,537,18.1,1640,5,8,2,0,0,0,0,16525,7,18067,247,53,125,-537,24.7,1652.5,blue,3.6,0.88,91,13,blue
4520555192,2,9,1,1,1,0,0,14478,6.6,16901,237,48,-3613,-1592,23.7,1447.8,9,2,9,0,0,0,0,18091,7,18493,232,52,3613,1592,23.2,1809.1,red,0.33,9,41,15,red
4469526700,12,4,12,1,1,0,0,19058,7.2,19477,214,61,3723,2815,21.4,1905.8,4,12,7,1,0,1,0,15335,6.6,16662,200,48,-3723,-2815,20,1533.5,blue,6,0.92,106,12,blue
4492870986,9,3,12,1,1,0,1,20316,7.4,18784,230,70,5073,1803,23,2031.6,3,9,3,1,0,1,0,15243,6.4,16981,224,69,-5073,-1803,22.4,1524.3,blue,7,0.67,18,12,blue
4479329999,5,6,3,0,0,0,0,17083,7.2,18817,248,60,1031,98,24.8,1708.3,6,5,6,2,1,1,0,16052,7.2,18719,220,60,-1031,-98,22,1605.2,blue,1.33,2.4,20,20,blue
4513698132,8,4,8,1,1,0,0,17613,6.8,18689,225,45,2470,1917,22.5,1761.3,4,8,3,0,0,0,0,15143,6.4,16772,199,36,-2470,-1917,19.9,1514.3,blue,4,0.88,15,21,blue
4518687922,9,3,9,1,1,0,0,17731,7,18766,252,55,2748,842,25.2,1773.1,3,9,3,0,0,0,0,14983,7,17924,214,52,-2748,-842,21.4,1498.3,blue,6,0.67,24,21,blue
4523838498,4,8,4,2,1,1,0,14312,6.6,16196,144,57,-2861,-2348,14.4,1431.2,8,4,12,0,0,0,0,17173,7.2,18544,217,56,2861,2348,21.7,1717.3,blue,1,5,15,58,red
4525110974,8,3,10,2,1,1,0,16903,7.4,19854,207,63,2524,2733,20.7,1690.3,3,8,1,0,0,0,0,14379,6.8,17121,199,40,-2524,-2733,19.9,1437.9,blue,6,0.5,16,41,blue
4521058340,7,4,8,1,1,0,0,17137,7,18628,240,45,2191,2220,24,1713.7,4,7,7,0,0,0,0,14946,6.4,16408,203,43,-2191,-2220,20.3,1494.6,blue,3.75,1.57,19,18,red
4522010330,9,3,8,0,0,0,1,18870,7,18880,232,57,5014,3238,23.2,1887,3,9,5,0,0,0,0,13856,6.2,15642,173,50,-5014,-3238,17.3,1385.6,blue,5.67,0.89,13,11,blue
4525065975,3,4,3,1,1,0,0,15279,7,18515,240,44,-1023,92,24,1527.9,4,3,4,1,0,1,0,16302,7,18423,243,48,1023,-92,24.3,1630.2,blue,1.5,2.67,19,18,red
4491158196,10,7,12,1,0,1,1,19262,7,18021,223,44,1497,1555,22.3,1926.2,7,10,7,1,1,0,1,17765,6.6,16466,211,45,-1497,-1555,21.1,1776.5,blue,3.14,1.4,21,20,blue
4521539321,5,9,8,0,0,0,0,15651,6.6,16491,211,55,-1554,-781,21.1,1565.1,9,5,10,0,0,0,0,17205,6.8,17272,203,36,1554,781,20.3,1720.5,red,1.44,3.8,107,14,blue
4513405622,10,6,7,0,0,0,0,17682,7.6,20336,201,66,2310,4456,20.1,1768.2,6,10,10,1,1,0,0,15372,6.4,15880,210,16,-2310,-4456,21,1537.2,blue,2.83,1.6,39,21,blue
4453463831,4,6,4,1,1,0,0,16209,7.2,18802,235,72,-907,-1159,23.5,1620.9,6,4,7,0,0,0,0,17116,7.2,19961,242,62,907,1159,24.2,1711.6,red,1.33,3.25,17,22,blue
4515443406,10,7,12,0,0,0,0,18996,7.2,18231,231,47,3227,1158,23.1,1899.6,7,10,5,1,1,0,0,15769,6.6,17073,175,52,-3227,-1158,17.5,1576.9,red,3.14,1.2,21,24,red
4518071306,15,8,12,1,1,0,0,20855,7.2,20164,196,46,4083,3740,19.6,2085.5,8,15,8,0,0,0,0,16772,6.6,16424,171,44,-4083,-3740,17.1,1677.2,blue,3.38,1.07,21,20,blue
4520540125,5,7,6,0,0,0,0,15485,6.8,17345,208,42,-1397,-730,20.8,1548.5,7,5,5,1,1,0,0,16882,7.2,18075,225,70,1397,730,22.5,1688.2,red,1.57,2.4,42,20,red
4451639888,5,5,6,1,1,0,0,16043,7,17912,227,43,-564,-422,22.7,1604.3,5,5,9,1,0,1,0,16607,7,18334,236,60,564,422,23.6,1660.7,red,2.2,2.8,22,24,blue
4467505832,5,11,10,0,0,0,0,16476,7,17056,215,52,-1221,-214,21.5,1647.6,11,5,18,1,1,0,0,17697,6.6,17270,186,50,1221,214,18.6,1769.7,red,1.36,5.8,16,16,red
4500469260,4,7,3,0,0,0,0,15473,6.8,17491,215,61,-1093,-449,21.5,1547.3,7,4,7,1,1,0,0,16566,7,17940,236,39,1093,449,23.6,1656.6,red,1,3.5,14,14,red
4517786912,5,7,6,2,1,1,0,15157,6.8,17194,218,38,-1301,-502,21.8,1515.7,7,5,8,0,0,0,0,16458,7,17696,209,52,1301,502,20.9,1645.8,red,1.57,3,17,16,blue
4519991680,6,10,3,0,0,0,0,14812,6.8,17359,183,36,-2393,-881,18.3,1481.2,10,6,8,0,0,0,0,17205,7,18240,214,43,2393,881,21.4,1720.5,red,0.9,3,19,16,blue
4518317987,6,5,4,0,0,0,0,15959,6.8,16675,236,40,66,-115,23.6,1595.9,5,6,5,1,1,0,0,15893,6.6,16790,187,47,-66,115,18.7,1589.3,red,2,1.67,23,24,red
4484850888,7,1,7,1,1,0,0,16850,7.2,19499,228,64,1994,1541,22.8,1685,1,7,2,1,0,1,0,14856,7,17958,224,58,-1994,-1541,22.4,1485.6,blue,14,0.43,26,45,blue
4523400286,3,3,4,0,0,0,0,14940,6.6,16977,238,44,-1131,-1921,23.8,1494,3,3,2,0,0,0,0,16071,7,18898,247,68,1131,1921,24.7,1607.1,blue,2.33,1.67,26,52,red
4497493695,8,5,8,1,0,1,0,17550,7.2,19690,218,68,1055,1659,21.8,1755,5,8,7,1,1,0,0,16495,7.2,18031,248,47,-1055,-1659,24.8,1649.5,red,3.2,1.5,22,12,red
4521993716,7,5,9,0,0,0,0,16542,6.8,17667,214,44,798,-1263,21.4,1654.2,5,7,4,1,1,0,0,15744,7.2,18930,195,76,-798,1263,19.5,1574.4,red,3.2,1.29,15,24,red
4499383739,7,5,11,1,0,1,0,17297,6.8,17523,196,46,1134,157,19.6,1729.7,5,7,4,1,1,0,0,16163,6.6,17366,238,52,-1134,-157,23.8,1616.3,blue,3.6,1.29,31,51,red
4498542919,9,7,10,1,0,1,1,19581,6.8,18509,232,44,2883,1059,23.2,1958.1,7,9,8,1,1,0,0,16698,7.2,17450,201,48,-2883,-1059,20.1,1669.8,red,2.71,1.67,15,17,red
4520618648,2,9,0,1,0,1,0,14712,6.6,17001,230,63,-3226,-2335,23,1471.2,9,2,9,1,1,0,0,17938,7.2,19336,237,52,3226,2335,23.7,1793.8,red,0.22,9,21,16,blue
4492010722,9,5,7,2,1,1,0,16587,7,17630,212,44,814,2199,21.2,1658.7,5,9,7,0,0,0,0,15773,6.4,15431,176,48,-814,-2199,17.6,1577.3,blue,3.2,1.33,18,16,blue
4519502540,8,11,9,1,0,1,0,17429,7,18630,198,55,-1209,-747,19.8,1742.9,11,8,10,0,0,0,0,18638,7.4,19377,212,48,1209,747,21.2,1863.8,blue,1.55,2.62,125,18,blue
4515979175,4,4,5,1,0,1,0,15547,7.2,17921,208,44,256,241,20.8,1554.7,4,4,2,1,1,0,0,15291,6.8,17680,222,49,-256,-241,22.2,1529.1,blue,2.25,1.5,16,28,blue
4523296034,4,12,4,0,0,0,0,14957,6.8,17705,173,63,-3881,-447,17.3,1495.7,12,4,12,0,0,0,0,18838,7,18152,223,44,3881,447,22.3,1883.8,red,0.67,6,45,20,red
4500722833,6,1,9,1,1,0,0,17450,7.2,19276,233,44,3610,2295,23.3,1745,1,6,1,0,0,0,0,13840,6.4,16981,226,39,-3610,-2295,22.6,1384,blue,15,0.33,28,14,blue
4500860380,7,2,8,1,1,0,0,17199,7.4,19353,235,68,3013,2244,23.5,1719.9,2,7,0,0,0,0,0,14186,6.6,17109,205,61,-3013,-2244,20.5,1418.6,blue,7.5,0.29,25,14,blue
4523399536,6,2,6,1,1,0,0,16610,7,18953,231,56,1353,1332,23.1,1661,2,6,2,0,0,0,0,15257,6.8,17621,236,46,-1353,-1332,23.6,1525.7,blue,6,0.67,19,24,blue
4445248435,5,8,3,1,1,0,0,14795,6.6,16454,178,52,-2914,-2683,17.8,1479.5,8,5,11,1,0,1,0,17709,7.2,19137,229,52,2914,2683,22.9,1770.9,red,1,3.8,35,22,red
4519431997,10,7,6,0,0,0,0,18269,7.2,19161,228,60,1974,861,22.8,1826.9,7,10,8,2,1,1,0,16295,7,18300,199,56,-1974,-861,19.9,1629.5,red,2.29,1.5,20,41,red
4467416577,2,7,3,1,0,1,0,13889,6.8,16427,205,47,-3012,-1300,20.5,1388.9,7,2,10,1,1,0,0,16901,7.2,17727,195,48,3012,1300,19.5,1690.1,red,0.71,8.5,19,14,red
4522306510,5,4,7,1,1,0,0,15950,7.2,17916,220,56,-30,-200,22,1595,4,5,3,1,0,1,0,15980,7,18116,238,52,30,200,23.8,1598,blue,3,1.4,40,25,red
4502862242,6,7,5,2,1,1,0,15235,6.6,16288,189,44,-1747,-1827,18.9,1523.5,7,6,9,0,0,0,0,16982,6.8,18115,223,47,1747,1827,22.3,1698.2,blue,1.57,2.67,14,75,red
4521976422,7,8,5,1,0,1,0,16697,7.4,19017,205,44,-333,1358,20.5,1669.7,8,7,8,1,1,0,0,17030,6.8,17659,222,52,333,-1358,22.2,1703,blue,1.5,2.29,18,22,red
4524846678,7,5,11,0,0,0,0,17450,7,18559,236,54,1294,213,23.6,1745,5,7,4,0,0,0,0,16156,7.2,18346,213,58,-1294,-213,21.3,1615.6,red,3.6,1.29,17,16,red
4513054868,6,9,3,0,0,0,0,15896,6.8,17492,171,67,-1773,-422,17.1,1589.6,9,6,10,1,1,0,0,17669,6.8,17914,221,48,1773,422,22.1,1766.9,red,1,3.17,12,11,blue
4514370215,4,5,5,0,0,0,0,15943,7.2,19085,239,54,-325,772,23.9,1594.3,5,4,5,1,1,0,0,16268,6.8,18313,226,44,325,-772,22.6,1626.8,red,1.8,2.5,24,17,blue
4497486422,7,10,8,1,0,1,1,18063,6.6,16794,228,48,-163,-674,22.8,1806.3,10,7,19,1,1,0,0,18226,6.8,17468,201,58,163,674,20.1,1822.6,red,1.5,4.14,27,19,blue
4515533339,5,12,6,0,0,0,0,16177,6.8,17721,214,56,-2281,-1283,21.4,1617.7,12,5,12,1,1,0,0,18458,7.2,19004,229,52,2281,1283,22.9,1845.8,blue,0.92,4.8,18,14,red
4445344090,2,6,2,1,0,1,0,14896,6.8,17066,205,48,-1243,-635,20.5,1489.6,6,2,7,1,1,0,0,16139,6.6,17701,195,60,1243,635,19.5,1613.9,red,0.67,6.5,31,44,blue
4523672469,8,4,4,1,0,1,0,16959,7,19261,215,49,1522,1737,21.5,1695.9,4,8,4,1,1,0,0,15437,6.8,17524,218,42,-1522,-1737,21.8,1543.7,red,3,1,14,16,blue
4409455091,6,3,10,1,0,1,0,16363,6.8,17356,209,44,2448,1861,20.9,1636.3,3,6,4,0,0,0,0,13915,6.4,15495,184,47,-2448,-1861,18.4,1391.5,blue,5.33,1.17,43,19,blue
4477545606,10,14,6,0,0,0,0,16665,6.8,17063,189,26,-3701,-2739,18.9,1666.5,14,10,11,1,1,0,0,20366,7.4,19802,220,54,3701,2739,22,2036.6,red,1.14,2.5,16,13,red
4468897827,2,4,1,1,1,0,0,15377,7,17617,229,56,-166,-712,22.9,1537.7,4,2,2,0,0,0,0,15543,7,18329,214,47,166,712,21.4,1554.3,blue,0.75,3,46,86,blue
4427925743,3,6,2,0,0,0,0,13977,6.6,15961,185,48,-2707,-3132,18.5,1397.7,6,3,5,2,1,1,0,16684,7.4,19093,226,64,2707,3132,22.6,1668.4,red,0.83,3.67,19,21,blue
4464955883,1,3,0,0,0,0,0,13918,7,17849,200,55,-1932,-41,20,1391.8,3,1,7,1,1,0,0,15850,6.8,17890,225,52,1932,41,22.5,1585,blue,0.33,10,17,64,red
4524434375,9,9,14,1,1,0,0,17630,7,18364,230,50,13,2012,23,1763,9,9,10,0,0,0,0,17617,6.4,16352,165,42,-13,-2012,16.5,1761.7,blue,2.56,2.11,42,17,red
4490468164,4,7,4,0,0,0,0,15777,6.8,17261,229,48,-621,-784,22.9,1577.7,7,4,14,1,1,0,0,16398,7,18045,204,56,621,784,20.4,1639.8,blue,1.14,5.25,20,58,red
4484729770,5,7,6,0,0,0,0,16043,6.8,17403,237,38,-689,-1668,23.7,1604.3,7,5,5,1,1,0,0,16732,7,19071,231,57,689,1668,23.1,1673.2,red,1.57,2.4,19,20,red
4520687203,11,6,8,0,0,0,1,19022,7,19112,217,48,3028,2524,21.7,1902.2,6,11,8,0,0,0,0,15994,6.4,16588,190,51,-3028,-2524,19,1599.4,blue,3.17,1.27,24,21,blue
4490919481,3,7,4,1,1,0,0,13957,6.4,16250,187,48,-2788,-1304,18.7,1395.7,7,3,10,0,0,0,0,16745,6.8,17554,210,48,2788,1304,21,1674.5,red,1,5.67,62,20,blue
4493993749,2,9,3,1,1,0,0,14547,6.6,16366,212,48,-5367,-3464,21.2,1454.7,9,2,9,1,0,1,1,19914,7.2,19830,238,60,5367,3464,23.8,1991.4,red,0.56,9,19,30,red
4458063255,5,6,10,1,1,0,0,15649,6.6,17165,240,40,-1209,-1184,24,1564.9,6,5,9,0,0,0,0,16858,7,18349,238,52,1209,1184,23.8,1685.8,blue,2.5,3,70,24,blue
4519247401,9,5,11,1,1,0,0,17654,7,19048,249,40,1405,2118,24.9,1765.4,5,9,6,1,0,1,0,16249,6.8,16930,204,40,-1405,-2118,20.4,1624.9,blue,4,1.22,45,19,blue
4413539086,11,9,12,1,0,1,1,19858,7.4,19501,216,54,3335,2786,21.6,1985.8,9,11,12,1,1,0,0,16523,6.4,16715,168,46,-3335,-2786,16.8,1652.3,blue,2.56,1.91,27,20,blue
4520617966,1,6,0,0,0,0,0,13517,6.2,16278,222,44,-3700,-2130,22.2,1351.7,6,1,10,1,1,0,0,17217,7.2,18408,247,60,3700,2130,24.7,1721.7,red,0.17,16,18,20,red
4522601125,7,3,12,2,1,1,0,17791,7.2,18557,250,48,2763,1017,25,1779.1,3,7,5,0,0,0,0,15028,6.8,17540,200,55,-2763,-1017,20,1502.8,blue,6.33,1.14,20,19,blue
4524776788,7,6,5,1,1,0,0,16817,6.8,17889,208,63,1060,952,20.8,1681.7,6,7,5,1,0,1,0,15757,6.4,16937,185,40,-1060,-952,18.5,1575.7,blue,2,1.57,55,17,blue
4520562055,3,6,4,1,0,1,0,14920,6.8,17487,217,50,-1959,-630,21.7,1492,6,3,6,1,1,0,0,16879,7,18117,242,43,1959,630,24.2,1687.9,blue,1.17,4,19,24,red
4520956712,7,5,8,0,0,0,0,17160,7,18450,221,42,2613,1450,22.1,1716,5,7,3,1,1,0,0,14547,6.4,17000,213,36,-2613,-1450,21.3,1454.7,red,3,1.14,14,16,red
4523657645,5,4,5,1,0,1,0,15436,7,18911,220,48,-684,-742,22,1543.6,4,5,6,1,1,0,0,16120,7.2,19653,267,53,684,742,26.7,1612,blue,2.5,2,21,44,red
4492509344,4,3,3,1,1,0,0,15442,7.2,18590,220,64,-79,-815,22,1544.2,3,4,4,1,0,1,0,15521,7.2,19405,217,72,79,815,21.7,1552.1,blue,2.33,1.75,21,54,red
4502134010,4,7,1,0,0,0,0,15764,6.8,17960,237,53,-1929,-655,23.7,1576.4,7,4,6,1,0,1,0,17693,7.2,18615,236,40,1929,655,23.6,1769.3,blue,0.71,3.25,18,24,blue
4491104040,6,6,8,1,1,0,0,16744,6.8,18061,231,59,-615,-150,23.1,1674.4,6,6,7,0,0,0,0,17359,7,18211,237,48,615,150,23.7,1735.9,red,2.33,2.17,17,24,red
4493057700,13,4,16,1,1,0,2,20308,7,18069,216,52,5058,1536,21.6,2030.8,4,13,3,0,0,0,0,15250,6.6,16533,197,64,-5058,-1536,19.7,1525,blue,7.25,0.54,60,19,blue
4512198304,9,8,8,1,0,1,1,18731,6.8,18892,191,57,1601,459,19.1,1873.1,8,9,6,1,1,0,0,17130,7.2,18433,240,44,-1601,-459,24,1713,blue,2.12,1.56,10,15,blue
4518092454,5,9,5,0,0,0,0,15529,6.8,17544,200,52,-2347,-1346,20,1552.9,9,5,9,1,0,1,0,17876,7.2,18890,229,55,2347,1346,22.9,1787.6,red,1.11,3.6,18,16,red
4476242451,4,4,1,0,0,0,0,15169,6.8,18276,208,70,585,2037,20.8,1516.9,4,4,5,0,0,0,0,14584,6.4,16239,196,43,-585,-2037,19.6,1458.4,blue,1.25,2.25,14,61,red
4467262571,7,9,4,1,0,1,0,17075,6.8,17991,218,54,-372,177,21.8,1707.5,9,7,11,0,0,0,0,17447,7,17814,217,36,372,-177,21.7,1744.7,blue,1.22,2.86,12,47,red
4442489042,5,1,5,0,0,0,0,17467,7.4,20584,245,76,3407,3210,24.5,1746.7,1,5,3,0,0,0,0,14060,6.8,17374,214,59,-3407,-3210,21.4,1406,blue,10,0.8,12,85,blue
4445983241,6,2,5,1,1,0,0,17259,7.4,19920,249,64,2452,1600,24.9,1725.9,2,6,5,0,0,0,0,14807,7,18320,221,52,-2452,-1600,22.1,1480.7,blue,5.5,1.17,17,41,blue
4496639377,10,4,9,0,0,0,0,17979,7,18648,214,55,2507,2680,21.4,1797.9,4,10,6,1,1,0,0,15472,6.4,15968,214,56,-2507,-2680,21.4,1547.2,blue,4.75,1,22,32,red
4477234655,2,7,3,0,0,0,0,14269,6.6,16548,196,58,-2153,-1519,19.6,1426.9,7,2,8,0,0,0,0,16422,7,18067,211,39,2153,1519,21.1,1642.2,red,0.71,7.5,21,20,blue
4466182344,9,3,11,1,1,0,0,18309,7.6,20268,234,56,3039,2335,23.4,1830.9,3,9,3,0,0,0,0,15270,7,17933,223,46,-3039,-2335,22.3,1527,blue,6.67,0.67,46,20,blue
4455048009,7,6,9,1,1,0,0,17116,7.4,19586,246,48,286,786,24.6,1711.6,6,7,5,0,0,0,0,16830,7.2,18800,219,60,-286,-786,21.9,1683,red,2.67,1.57,23,23,red
4510666466,7,7,8,1,1,0,0,15970,6.8,17491,200,44,-336,-681,20,1597,7,7,4,0,0,0,0,16306,7,18172,220,40,336,681,22,1630.6,red,2.14,1.57,17,21,blue
4492216281,6,10,4,0,0,0,0,14626,6.4,16067,154,43,-4726,-2067,15.4,1462.6,10,6,11,1,1,0,1,19352,7,18134,224,52,4726,2067,22.4,1935.2,red,1,3.5,20,14,red
4508364030,8,10,7,0,0,0,0,16427,6.8,17468,191,43,-3441,-1876,19.1,1642.7,10,8,15,0,0,0,0,19868,7.2,19344,259,40,3441,1876,25.9,1986.8,blue,1.5,3.12,17,14,blue
4468130569,3,13,4,1,1,0,0,14676,6.2,14842,191,42,-4489,-4047,19.1,1467.6,13,3,13,0,0,0,0,19165,7,18889,224,49,4489,4047,22.4,1916.5,red,0.54,8.67,17,62,red
4524546910,1,11,1,0,0,0,0,13943,6.2,16274,204,56,-5302,-3981,20.4,1394.3,11,1,13,0,0,0,0,19245,7.4,20255,238,64,5302,3981,23.8,1924.5,red,0.18,24,146,53,red
4419367000,4,17,4,0,0,0,0,15488,6.6,16539,184,47,-4903,-3146,18.4,1548.8,17,4,16,1,1,0,0,20391,7.4,19685,204,48,4903,3146,20.4,2039.1,blue,0.47,8.25,44,29,red
4519318813,6,4,6,1,1,0,0,15437,6.6,16652,198,52,-152,-901,19.8,1543.7,4,6,6,1,0,1,0,15589,7,17553,220,49,152,901,22,1558.9,red,3,1.67,12,20,blue
4441403793,6,2,7,0,0,0,0,17083,7.2,19485,241,60,2263,1666,24.1,1708.3,2,6,1,1,1,0,0,14820,7,17819,250,48,-2263,-1666,25,1482,red,6.5,0.5,20,29,blue
4519990070,2,10,3,1,0,1,0,14825,6.8,17113,236,51,-3103,-2355,23.6,1482.5,10,2,16,1,1,0,0,17928,7.2,19468,230,52,3103,2355,23,1792.8,red,0.5,13,24,22,red
4473315873,12,3,10,1,1,0,0,19402,7.4,19955,242,44,5650,4520,24.2,1940.2,3,12,4,0,0,0,0,13752,6.4,15435,188,40,-5650,-4520,18.8,1375.2,blue,7.33,0.58,13,15,blue
4524447556,4,5,4,1,1,0,0,15129,7,17887,197,61,-1330,-639,19.7,1512.9,5,4,4,0,0,0,0,16459,7,18526,241,56,1330,639,24.1,1645.9,red,1.6,2.25,19,18,red
4520827057,2,5,3,0,0,0,0,15053,6.8,17983,248,53,-3526,-1273,24.8,1505.3,5,2,9,0,0,0,0,18579,7.2,19256,234,53,3526,1273,23.4,1857.9,red,1,7,19,40,blue
4522502236,2,5,2,0,0,0,0,14672,6.6,16400,229,55,-1209,-2033,22.9,1467.2,5,2,2,1,1,0,0,15881,7,18433,252,53,1209,2033,25.2,1588.1,red,0.8,3.5,17,24,blue
4460122479,10,6,8,1,1,0,0,18280,7.4,19939,241,48,2171,1839,24.1,1828,6,10,4,0,0,0,0,16109,7,18100,196,48,-2171,-1839,19.6,1610.9,red,3,1,24,42,blue
4506183108,4,8,4,1,1,0,0,15290,6.6,17203,219,55,-2387,-2353,21.9,1529,8,4,6,0,0,0,0,17677,7.4,19556,242,48,2387,2353,24.2,1767.7,red,1,3.5,17,20,red
4495582337,9,1,13,1,0,1,0,17329,7,18182,189,56,2252,1086,18.9,1732.9,1,9,2,0,0,0,0,15077,7,17096,244,58,-2252,-1086,24.4,1507.7,blue,22,0.33,12,19,red
4518442366,6,4,3,1,1,0,0,16409,6.8,18420,232,43,596,486,23.2,1640.9,4,6,4,0,0,0,0,15813,7,17934,202,68,-596,-486,20.2,1581.3,blue,2.25,1.33,18,14,red
4467981904,10,11,8,1,0,1,0,18237,6.6,17871,235,44,206,257,23.5,1823.7,11,10,14,0,0,0,0,18031,6.8,17614,175,36,-206,-257,17.5,1803.1,blue,1.64,2.5,19,19,blue
4474786216,9,2,11,2,1,1,0,17259,7,18091,214,52,3146,2257,21.4,1725.9,2,9,1,0,0,0,0,14113,6.4,15834,221,33,-3146,-2257,22.1,1411.3,blue,10,0.33,19,16,red
4519593233,8,6,10,1,0,1,0,17816,7,18186,226,47,1789,244,22.6,1781.6,6,8,11,1,1,0,0,16027,6.8,17942,210,60,-1789,-244,21,1602.7,blue,3,2.12,148,20,blue
4503699941,8,7,11,1,1,0,0,16465,6.6,17106,215,28,84,-1185,21.5,1646.5,7,8,5,0,0,0,0,16381,7.2,18291,203,51,-84,1185,20.3,1638.1,red,2.71,1.5,19,21,blue
4523089267,10,11,9,0,0,0,0,19029,7.4,19459,234,49,340,1086,23.4,1902.9,11,10,14,0,0,0,0,18689,7.2,18373,182,40,-340,-1086,18.2,1868.9,red,1.73,2.5,18,14,blue
4521886990,7,2,13,1,1,0,0,17075,6.8,17444,202,56,1531,-222,20.2,1707.5,2,7,2,0,0,0,0,15544,6.8,17666,252,48,-1531,222,25.2,1554.4,blue,10,0.57,23,20,blue
4519603672,6,4,7,0,0,0,0,16689,7.4,19570,233,48,-177,-38,23.3,1668.9,4,6,4,0,0,0,0,16866,7.2,19608,236,71,177,38,23.6,1686.6,blue,3.25,1.33,17,19,blue
4501447640,1,2,2,0,0,0,0,14402,6.6,17052,233,52,-688,-577,23.3,1440.2,2,1,3,1,1,0,0,15090,6.8,17629,258,54,688,577,25.8,1509,blue,1.5,5,18,16,red
4519106569,5,3,4,1,1,0,0,16379,6.8,18268,240,44,1429,1224,24,1637.9,3,5,4,0,0,0,0,14950,6.8,17044,226,52,-1429,-1224,22.6,1495,red,3,1.4,24,24,blue
4487326778,3,11,3,0,0,0,0,14579,6.6,15951,227,35,-3603,-3793,22.7,1457.9,11,3,9,0,0,0,0,18182,7.2,19744,232,49,3603,3793,23.2,1818.2,red,0.55,6.67,18,19,red
4522165350,6,5,8,0,0,0,0,16455,7.2,18248,214,50,-614,-1330,21.4,1645.5,5,6,5,2,1,1,0,17069,7.4,19578,243,73,614,1330,24.3,1706.9,red,2.8,1.67,14,40,blue
4494015371,3,5,4,1,1,0,0,13770,6.4,15846,192,33,-2374,-2316,19.2,1377,5,3,5,0,0,0,0,16144,7,18162,239,36,2374,2316,23.9,1614.4,red,1.4,3.33,12,16,red
4522134991,6,9,5,1,1,0,0,16042,6.8,17983,218,56,-1416,-362,21.8,1604.2,9,6,6,0,0,0,0,17458,7.2,18345,243,47,1416,362,24.3,1745.8,blue,1.22,2.5,20,23,red
4503355940,2,4,2,1,1,0,0,14905,6.8,18468,244,56,-1090,522,24.4,1490.5,4,2,4,0,0,0,0,15995,6.8,17946,243,51,1090,-522,24.3,1599.5,blue,1,4,16,20,red
4519054552,11,4,12,0,0,0,0,18733,7.4,19592,201,62,3925,4105,20.1,1873.3,4,11,9,1,1,0,0,14808,6.4,15487,179,44,-3925,-4105,17.9,1480.8,blue,5.75,1.18,19,15,red
4522604950,9,14,11,0,0,0,0,17496,6.8,17522,185,51,-2574,-2554,18.5,1749.6,14,9,13,1,1,0,0,20070,7.4,20076,198,56,2574,2554,19.8,2007,red,1.43,3,17,17,blue
4523502630,11,7,7,2,1,1,0,18303,7,18032,202,54,2667,1951,20.2,1830.3,7,11,5,0,0,0,0,15636,6.4,16081,174,49,-2667,-1951,17.4,1563.6,blue,2.57,1.09,22,23,blue
4514255015,4,9,5,1,1,0,0,15395,6.6,17472,221,44,-1421,-1367,22.1,1539.5,9,4,6,1,0,1,0,16816,7,18839,212,60,1421,1367,21.2,1681.6,red,1,3.75,21,17,red
4524176284,6,4,4,1,1,0,0,16540,6.8,18026,230,60,-41,307,23,1654,4,6,5,1,0,1,0,16581,6.6,17719,254,42,41,-307,25.4,1658.1,blue,2.5,1.5,17,17,blue
4516104541,7,7,9,1,0,1,0,16342,6.8,17877,211,40,-2579,-1094,21.1,1634.2,7,7,6,1,1,0,1,18921,7.2,18971,238,81,2579,1094,23.8,1892.1,red,2.29,1.86,47,38,blue
4499761953,4,6,6,0,0,0,0,15540,6.8,17724,236,54,-468,-581,23.6,1554,6,4,5,2,1,1,0,16008,7,18305,234,50,468,581,23.4,1600.8,red,1.67,2.75,20,17,red
4518832896,4,11,2,0,0,0,0,14993,6.6,17460,208,47,-2884,-2378,20.8,1499.3,11,4,8,1,1,0,0,17877,7.4,19838,226,38,2884,2378,22.6,1787.7,red,0.55,4.75,13,15,red
4419533623,6,5,9,0,0,0,0,16022,6.8,17931,227,48,318,370,22.7,1602.2,5,6,4,1,1,0,0,15704,6.8,17561,210,56,-318,-370,21,1570.4,red,3,1.5,21,191,blue
4470191400,7,4,10,1,1,0,0,17978,7.4,18771,216,66,2604,432,21.6,1797.8,4,7,0,0,0,0,0,15374,7,18339,220,51,-2604,-432,22,1537.4,blue,4.25,0.57,17,19,red
4522564019,9,6,12,0,0,0,0,17898,6.8,18357,215,58,1388,441,21.5,1789.8,6,9,10,1,1,0,0,16510,7,17916,212,48,-1388,-441,21.2,1651,red,3.5,1.78,23,45,blue
4523807202,2,12,1,0,0,0,0,13170,6.2,15312,162,57,-5455,-2144,16.2,1317,12,2,10,0,0,0,0,18625,6.8,17456,211,34,5455,2144,21.1,1862.5,red,0.25,11,18,20,red
4477060044,3,6,2,0,0,0,0,14364,7,17602,190,56,-3333,-1389,19,1436.4,6,3,6,1,1,0,0,17697,7.2,18991,251,45,3333,1389,25.1,1769.7,red,0.83,4,18,22,red
4515522584,9,5,10,1,0,1,1,19294,7,18363,234,54,4570,2205,23.4,1929.4,5,9,8,0,0,0,0,14724,6.6,16158,162,46,-4570,-2205,16.2,1472.4,blue,3.8,1.44,20,17,blue
4456434155,11,7,15,0,0,0,0,17446,7,18714,186,49,900,1093,18.6,1744.6,7,11,8,1,1,0,0,16546,6.8,17621,220,58,-900,-1093,22,1654.6,blue,3.71,1.36,22,15,blue
4515247521,11,6,5,1,1,0,0,17943,6.8,18261,220,60,1493,33,22,1794.3,6,11,2,0,0,0,0,16450,7,18228,197,60,-1493,-33,19.7,1645,blue,2.67,0.73,19,18,blue
4503948096,7,3,4,1,1,0,0,16656,6.8,17435,214,67,1786,-261,21.4,1665.6,3,7,3,0,0,0,0,14870,6.8,17696,206,49,-1786,261,20.6,1487,blue,3.67,0.86,17,16,blue
4518760937,6,2,6,2,1,1,0,16149,6.8,18239,220,45,1819,1262,22,1614.9,2,6,1,0,0,0,0,14330,6.6,16977,206,54,-1819,-1262,20.6,1433,blue,6,0.5,44,17,blue
4523425333,4,5,4,0,0,0,0,15564,6.8,17895,216,59,-433,445,21.6,1556.4,5,4,7,1,1,0,0,15997,6.8,17450,225,52,433,-445,22.5,1599.7,red,1.6,3,26,21,red
4504146901,2,5,3,0,0,0,0,15128,7,17938,251,53,-860,-334,25.1,1512.8,5,2,9,1,1,0,0,15988,7,18272,226,52,860,334,22.6,1598.8,red,1,7,16,19,red
4473400880,4,4,3,1,0,1,0,15551,6.8,17278,206,56,43,-1092,20.6,1555.1,4,4,2,1,1,0,0,15508,6.8,18370,218,65,-43,1092,21.8,1550.8,blue,1.75,1.5,27,22,red
4516264231,5,9,8,0,0,0,0,16426,7,18382,231,60,-642,-397,23.1,1642.6,9,5,6,1,1,0,0,17068,7,18779,193,59,642,397,19.3,1706.8,blue,1.44,3,21,19,blue
4519787212,5,6,5,2,1,1,0,15594,7,18180,201,56,-1328,333,20.1,1559.4,6,5,7,0,0,0,0,16922,6.8,17847,227,60,1328,-333,22.7,1692.2,blue,1.67,2.6,21,27,red
4523328817,5,7,8,2,1,1,0,15674,6.6,17096,215,52,-622,59,21.5,1567.4,7,5,8,0,0,0,0,16296,6.8,17037,189,35,622,-59,18.9,1629.6,red,1.86,3,22,24,blue
4522146436,12,8,11,0,0,0,0,18444,7.2,19294,196,40,1903,2160,19.6,1844.4,8,12,4,1,1,0,0,16541,6.6,17134,173,32,-1903,-2160,17.3,1654.1,blue,2.88,1,28,17,red
4506599171,10,6,5,1,1,0,0,16929,7.2,19809,222,51,580,2959,22.2,1692.9,6,10,11,0,0,0,0,16349,6.8,16850,192,43,-580,-2959,19.2,1634.9,blue,2.5,1.7,140,15,blue
4444970542,8,3,11,1,1,0,0,17701,7.2,19075,246,52,2252,1577,24.6,1770.1,3,8,3,0,0,0,0,15449,6.8,17498,228,46,-2252,-1577,22.8,1544.9,blue,6.33,0.75,63,16,red
4513456323,5,2,5,2,1,1,0,17020,7.2,19853,238,52,1686,2152,23.8,1702,2,5,3,0,0,0,0,15334,7,17701,253,56,-1686,-2152,25.3,1533.4,blue,5,1,17,19,red
4519231725,12,9,11,1,1,0,0,18395,7.2,18790,193,36,718,1313,19.3,1839.5,9,12,9,0,0,0,0,17677,7,17477,206,48,-718,-1313,20.6,1767.7,blue,2.56,1.5,44,15,red
4523093553,9,4,8,1,1,0,0,18646,7.6,19823,253,43,3767,3277,25.3,1864.6,4,9,6,0,0,0,0,14879,6.6,16546,195,36,-3767,-3277,19.5,1487.9,blue,4.25,1.11,20,13,blue
4489785292,6,11,8,0,0,0,0,15887,6.4,16048,191,48,-2596,-2891,19.1,1588.7,11,6,13,0,0,0,0,18483,7.2,18939,220,51,2596,2891,22,1848.3,red,1.27,4,23,20,red
4523459818,3,5,2,1,1,0,0,14098,6.2,14987,198,49,-2511,-2288,19.8,1409.8,5,3,6,0,0,0,0,16609,6.8,17275,216,40,2511,2288,21.6,1660.9,red,1,3.67,21,21,blue
4517889362,6,5,10,1,1,0,0,15521,6.2,15093,146,42,189,-2888,14.6,1552.1,5,6,1,1,0,1,0,15332,6.8,17981,193,54,-189,2888,19.3,1533.2,red,3.2,1,45,45,red
4482389592,7,5,9,1,1,0,0,16460,7,18782,222,52,192,616,22.2,1646,5,7,8,0,0,0,0,16268,7.2,18166,236,46,-192,-616,23.6,1626.8,blue,3.2,1.86,19,53,red
4502375792,6,14,5,1,0,1,1,16749,6.2,15390,203,23,-3586,-2840,20.3,1674.9,14,6,25,1,1,0,1,20335,7.2,18230,194,39,3586,2840,19.4,2033.5,red,0.79,6.5,14,69,red
4509699185,8,7,5,1,0,1,0,17329,7.4,19915,226,64,881,2559,22.6,1732.9,7,8,7,0,0,0,0,16448,6.8,17356,199,40,-881,-2559,19.9,1644.8,blue,1.86,1.75,41,19,blue
4494396355,7,6,12,0,0,0,0,16582,6.4,15066,203,42,-157,-2594,20.3,1658.2,6,7,8,2,1,1,0,16739,7,17660,219,59,157,2594,21.9,1673.9,red,3.17,2,17,13,red
4510530318,1,11,0,0,0,0,0,13206,6.6,15553,195,36,-6001,-5404,19.5,1320.6,11,1,6,1,1,0,0,19207,7.4,20957,244,64,6001,5404,24.4,1920.7,red,0.09,17,18,26,red
4517200256,7,8,6,0,0,0,0,16423,7.2,18901,212,60,-859,919,21.2,1642.3,8,7,6,0,0,0,0,17282,7,17982,226,43,859,-919,22.6,1728.2,red,1.62,2,23,20,red
4525192635,6,6,7,2,1,1,0,17074,7.2,17874,214,56,949,591,21.4,1707.4,6,6,6,0,0,0,0,16125,6.8,17283,225,48,-949,-591,22.5,1612.5,blue,2.17,2,17,53,red
4502349733,1,2,1,0,0,0,0,13449,6.6,16803,189,48,-1641,-500,18.9,1344.9,2,1,4,0,0,0,0,15090,7,17303,224,52,1641,500,22.4,1509,red,1,6,21,16,red
4520754348,6,5,10,2,1,1,0,17466,7.4,18793,246,48,1499,2469,24.6,1746.6,5,6,8,0,0,0,0,15967,6.6,16324,215,56,-1499,-2469,21.5,1596.7,blue,3.2,2.17,20,21,blue
4467471076,6,3,5,2,1,1,0,16941,7,18581,229,47,2104,1643,22.9,1694.1,3,6,3,0,0,0,0,14837,7,16938,213,44,-2104,-1643,21.3,1483.7,blue,3.67,1,44,24,red
4523728441,9,11,10,1,1,0,0,18601,7,18627,220,63,1939,166,22,1860.1,11,9,7,0,0,0,0,16662,7,18461,174,44,-1939,-166,17.4,1666.2,blue,1.73,2,7,14,blue
4396684519,8,6,13,1,1,0,0,17003,6.8,17843,222,43,253,-1300,22.2,1700.3,6,8,7,0,0,0,0,16750,7.2,19143,218,75,-253,1300,21.8,1675,red,3.5,1.62,19,21,red
4469837233,1,6,1,0,0,0,0,14577,6.8,17474,263,43,-1742,-1210,26.3,1457.7,6,1,6,1,1,0,0,16319,7,18684,234,52,1742,1210,23.4,1631.9,blue,0.33,12,13,17,blue
4477518558,9,8,13,1,1,0,0,17813,6.8,17461,202,66,986,549,20.2,1781.3,8,9,13,0,0,0,0,16827,6.6,16912,216,39,-986,-549,21.6,1682.7,blue,2.75,2.33,20,17,red
4508759067,5,6,1,1,0,1,0,15332,7,18496,215,44,-1442,-1048,21.5,1533.2,6,5,9,1,1,0,0,16774,7.2,19544,220,68,1442,1048,22,1677.4,red,1,3,53,18,blue
4457032161,2,3,5,1,1,0,0,14627,6.8,16759,214,64,-1113,-1417,21.4,1462.7,3,2,5,0,0,0,0,15740,7,18176,235,68,1113,1417,23.5,1574,blue,2.33,4,20,21,red
4524424120,9,8,11,0,0,0,0,16187,6.2,15234,156,30,-229,-487,15.6,1618.7,8,9,11,1,1,0,0,16416,6.2,15721,169,33,229,487,16.9,1641.6,red,2.5,2.11,14,18,blue
4521875899,11,5,12,2,1,1,0,19787,7.2,19493,242,51,4284,2585,24.2,1978.7,5,11,6,0,0,0,0,15503,6.8,16908,205,52,-4284,-2585,20.5,1550.3,blue,4.6,1,19,20,blue
4515916030,12,4,15,0,0,0,0,18596,7.2,18850,188,55,3378,3168,18.8,1859.6,4,12,6,1,1,0,0,15218,6.4,15682,207,43,-3378,-3168,20.7,1521.8,blue,6.75,0.83,90,18,red
4523410225,6,5,10,0,0,0,0,16233,7,17076,223,38,70,-928,22.3,1623.3,5,6,7,2,1,1,0,16163,7,18004,225,76,-70,928,22.5,1616.3,red,3.2,2,17,21,blue
4481909469,5,9,5,0,0,0,0,15468,7,17872,203,52,-2507,-1473,20.3,1546.8,9,5,7,1,1,0,0,17975,7.4,19345,243,48,2507,1473,24.3,1797.5,red,1.11,3.2,21,19,red
4522518445,8,7,8,0,0,0,0,16699,7,17881,240,40,320,-743,24,1669.9,7,8,6,1,1,0,0,16379,7.2,18624,216,48,-320,743,21.6,1637.9,red,2.29,1.62,48,51,red
4524031619,3,7,4,1,1,0,0,15311,6.8,16384,234,46,-1768,-963,23.4,1531.1,7,3,12,1,0,1,0,17079,6.6,17347,217,44,1768,963,21.7,1707.9,red,1,6.33,24,18,blue
4492870605,7,2,6,1,1,0,0,16580,7.4,19213,210,48,1586,1273,21,1658,2,7,1,0,0,0,0,14994,7,17940,232,68,-1586,-1273,23.2,1499.4,blue,6.5,0.43,19,31,blue
4475336164,6,8,6,0,0,0,0,16450,6.6,17381,224,40,-57,-1339,22.4,1645,8,6,5,0,0,0,0,16507,7.2,18720,220,44,57,1339,22,1650.7,blue,1.5,2.17,18,18,blue
4522772172,6,14,6,0,0,0,0,16197,6.4,15405,203,40,-2941,-3143,20.3,1619.7,14,6,16,1,1,0,0,19138,7,18548,194,54,2941,3143,19.4,1913.8,red,0.86,5,16,84,blue
4520718276,4,10,4,1,0,1,0,15773,6.6,16701,216,44,-2175,-2305,21.6,1577.3,10,4,12,1,1,0,0,17948,7.2,19006,216,42,2175,2305,21.6,1794.8,red,0.8,5.5,19,26,blue
4508973225,5,19,4,0,0,0,0,14815,6.2,14755,183,48,-7866,-5377,18.3,1481.5,19,5,23,2,1,1,1,22681,7.4,20132,219,48,7866,5377,21.9,2268.1,red,0.47,8.4,16,17,red
4497712537,6,6,11,1,1,0,0,17731,7.2,18498,257,59,1870,1167,25.7,1773.1,6,6,6,1,0,1,0,15861,6.8,17331,216,42,-1870,-1167,21.6,1586.1,blue,2.83,2,21,21,blue
4464939561,3,6,1,0,0,0,0,13952,6.6,17089,197,44,-2729,-1427,19.7,1395.2,6,3,4,1,1,0,0,16681,7,18516,252,56,2729,1427,25.2,1668.1,blue,0.67,3.33,20,17,red
4495155088,11,7,6,1,0,1,0,18504,7.2,19037,212,61,2842,1125,21.2,1850.4,7,11,3,1,1,0,0,15662,7,17912,192,40,-2842,-1125,19.2,1566.2,blue,2.43,0.91,18,18,blue
4516493520,2,5,3,0,0,0,0,14777,6.8,17450,215,51,-1276,-1016,21.5,1477.7,5,2,1,2,1,1,0,16053,7.2,18466,241,55,1276,1016,24.1,1605.3,red,1,3,15,15,red
4524035367,1,1,1,0,0,0,0,14018,7,16730,233,51,152,-1124,23.3,1401.8,1,1,1,1,1,0,0,13866,7.2,17854,220,56,-152,1124,22,1386.6,red,2,2,21,44,red
4419578933,6,6,8,0,0,0,0,16140,7,17727,211,47,556,879,21.1,1614,6,6,3,1,1,0,0,15584,6.6,16848,215,48,-556,-879,21.5,1558.4,blue,2.33,1.5,21,19,red
4524120513,6,5,5,0,0,0,0,16246,7.2,18652,199,56,750,786,19.9,1624.6,5,6,6,0,0,0,0,15496,6.8,17866,199,50,-750,-786,19.9,1549.6,blue,2.2,1.83,47,15,blue
4505709089,7,8,8,1,1,0,0,16122,7,17866,186,56,-1782,-308,18.6,1612.2,8,7,10,1,0,1,0,17904,7,18174,253,41,1782,308,25.3,1790.4,red,1.88,2.57,44,36,red
4523375871,5,8,3,0,0,0,0,15429,6.8,17256,198,55,-2375,-2008,19.8,1542.9,8,5,11,1,1,0,0,17804,7.2,19264,222,46,2375,2008,22.2,1780.4,red,1,3.8,22,21,red
4497277699,1,4,2,0,0,0,0,14270,6.6,16394,230,43,-1103,-2692,23,1427,4,1,3,1,1,0,0,15373,7,19086,244,52,1103,2692,24.4,1537.3,red,0.75,7,22,17,blue
4481738259,4,1,7,0,0,0,0,16327,7.4,19683,240,73,2246,2898,24,1632.7,1,4,2,0,0,0,0,14081,7,16785,235,42,-2246,-2898,23.5,1408.1,blue,11,0.75,17,16,blue
4521725362,8,5,7,0,0,0,0,18225,7.2,18898,236,47,1868,726,23.6,1822.5,5,8,5,0,0,0,0,16357,6.8,18172,223,56,-1868,-726,22.3,1635.7,blue,3,1.25,22,17,blue
4493178724,9,12,8,1,0,1,0,17778,7,18403,204,48,-628,-864,20.4,1777.8,12,9,12,1,1,0,0,18406,7.2,19267,197,54,628,864,19.7,1840.6,blue,1.42,2.67,13,21,blue
4513390810,5,4,7,2,1,1,0,16680,7.2,19095,247,62,899,969,24.7,1668,4,5,4,0,0,0,0,15781,6.8,18126,209,56,-899,-969,20.9,1578.1,blue,3,1.6,54,17,red
4523812506,6,6,12,1,1,0,0,16434,6.8,18059,214,58,428,-939,21.4,1643.4,6,6,2,1,0,1,0,16006,7.2,18998,184,63,-428,939,18.4,1600.6,red,3,1.33,15,14,blue
4448316334,13,8,22,0,0,0,0,18721,7.4,18774,164,44,1721,1678,16.4,1872.1,8,13,9,2,1,1,0,17000,6.8,17096,195,43,-1721,-1678,19.5,1700,blue,4.38,1.31,42,15,red
4461174959,5,8,6,1,1,0,0,15107,6.8,17606,187,44,-2607,-2365,18.7,1510.7,8,5,8,0,0,0,0,17714,7.4,19971,238,56,2607,2365,23.8,1771.4,red,1.38,3.2,42,20,blue
4518345906,7,0,4,1,1,0,0,16897,7.6,20576,240,67,3084,3352,24,1689.7,0,7,0,0,0,0,0,13813,6.6,17224,219,60,-3084,-3352,21.9,1381.3,blue,12.03,0,42,16,blue
4452185923,6,9,10,0,0,0,0,17013,7,17832,246,42,-941,-1717,24.6,1701.3,9,6,7,0,0,0,0,17954,7.4,19549,240,40,941,1717,24,1795.4,blue,1.78,2.67,20,18,red
4481608154,7,5,5,0,0,0,0,18047,7.2,18160,239,59,2175,506,23.9,1804.7,5,7,4,1,1,0,0,15872,6.8,17654,229,60,-2175,-506,22.9,1587.2,blue,2.4,1.29,25,26,blue
4522504753,3,5,2,1,1,0,0,15175,7,18100,232,62,-1243,-425,23.2,1517.5,5,3,6,0,0,0,0,16418,7.2,18525,219,49,1243,425,21.9,1641.8,red,1,3.67,44,32,red
4438432164,8,10,9,0,0,0,0,16722,6.6,16113,190,47,-978,-1232,19,1672.2,10,8,14,1,1,0,0,17700,6.8,17345,200,41,978,1232,20,1770,red,1.7,3,17,21,red
4524458385,5,5,5,0,0,0,0,15722,6.8,16349,222,34,679,471,22.2,1572.2,5,5,5,0,0,0,0,15043,6.4,15878,181,48,-679,-471,18.1,1504.3,blue,2,2,23,19,blue
4465803971,6,9,7,1,0,1,1,17077,6.8,16829,175,49,-995,-1497,17.5,1707.7,9,6,10,1,1,0,0,18072,7.2,18326,228,40,995,1497,22.8,1807.2,red,1.44,3.17,18,17,blue
4503065497,6,1,4,2,1,1,0,17016,7.2,19237,214,55,3266,1337,21.4,1701.6,1,6,0,0,0,0,0,13750,6.8,17900,218,56,-3266,-1337,21.8,1375,red,10,0.17,94,14,blue
4500545106,5,9,5,2,1,1,1,17231,6.8,17227,175,59,792,-474,17.5,1723.1,9,5,10,0,0,0,0,16439,7,17701,177,49,-792,474,17.7,1643.9,red,1.11,3.8,13,17,blue
4472209518,7,2,7,2,1,1,0,17039,7.2,18656,220,64,3032,2096,22,1703.9,2,7,0,0,0,0,0,14007,6.6,16560,185,54,-3032,-2096,18.5,1400.7,blue,7,0.29,23,22,blue
4451696991,11,4,11,1,1,0,0,17596,7.2,19377,203,57,3252,3377,20.3,1759.6,4,11,2,0,0,0,0,14344,6.8,16000,171,54,-3252,-3377,17.1,1434.4,blue,5.5,0.55,38,19,red
4481210597,7,4,8,0,0,0,0,16887,7,17187,215,40,1270,-1625,21.5,1688.7,4,7,4,1,1,0,0,15617,7,18812,212,66,-1270,1625,21.2,1561.7,red,3.75,1.14,19,16,red
4522445853,4,6,3,0,0,0,0,15157,6.8,17482,241,24,-549,-805,24.1,1515.7,6,4,3,2,1,1,0,15706,7,18287,223,56,549,805,22.3,1570.6,blue,1.17,2.25,20,16,red
4449074537,11,3,10,2,1,1,1,20259,7,19498,238,52,6210,3599,23.8,2025.9,3,11,4,0,0,0,0,14049,6.6,15899,180,52,-6210,-3599,18,1404.9,blue,7,0.64,20,39,blue
4481839538,6,9,5,1,1,0,0,16388,6.8,17753,213,40,-1436,-1406,21.3,1638.8,9,6,8,0,0,0,0,17824,7.2,19159,220,52,1436,1406,22,1782.4,red,1.22,2.83,13,19,blue
4514455389,9,8,6,0,0,0,0,17269,7,18087,209,42,8,84,20.9,1726.9,8,9,8,2,1,1,0,17261,7,18003,216,47,-8,-84,21.6,1726.1,blue,1.88,1.78,22,16,blue
4439417196,8,5,9,1,1,0,0,17389,6.8,18252,198,57,836,883,19.8,1738.9,5,8,10,0,0,0,0,16553,6.6,17369,237,56,-836,-883,23.7,1655.3,blue,3.4,1.88,24,20,blue
4489200768,7,5,7,0,0,0,0,17622,7.2,18672,247,50,2077,986,24.7,1762.2,5,7,5,1,1,0,0,15545,6.8,17686,226,47,-2077,-986,22.6,1554.5,red,2.8,1.43,24,21,blue
4523645725,3,6,3,0,0,0,0,15736,6.8,18798,232,72,-259,555,23.2,1573.6,6,3,5,2,1,1,0,15995,6.8,18243,220,48,259,-555,22,1599.5,blue,1,3.67,18,17,red
4513364103,10,8,11,1,0,1,0,17965,7.2,19735,219,60,-195,646,21.9,1796.5,8,10,3,1,1,0,0,18160,7,19089,244,50,195,-646,24.4,1816,blue,2.62,1.1,15,15,blue
4521769577,4,9,2,0,0,0,0,15067,6.6,17556,223,56,-3456,-1621,22.3,1506.7,9,4,7,1,1,0,0,18523,7.2,19177,235,52,3456,1621,23.5,1852.3,red,0.67,4,52,20,red
4523466253,2,10,3,0,0,0,0,13855,6.4,15500,215,35,-5043,-4627,21.5,1385.5,10,2,9,1,1,0,0,18898,7.2,20127,244,60,5043,4627,24.4,1889.8,red,0.5,9.5,21,41,red
4432850060,9,6,11,0,0,0,0,17561,7,19152,207,68,2134,1500,20.7,1756.1,6,9,2,1,1,0,0,15427,7,17652,204,48,-2134,-1500,20.4,1542.7,blue,3.33,0.89,22,19,blue
4518066287,6,14,9,0,0,0,0,16284,6.6,16793,208,52,-3235,-2207,20.8,1628.4,14,6,11,2,1,1,0,19519,6.8,19000,215,44,3235,2207,21.5,1951.9,blue,1.07,4.17,15,23,red
4509882748,7,6,9,0,0,0,0,17048,6.6,16378,227,52,1453,-254,22.7,1704.8,6,7,4,0,0,0,0,15595,6.6,16632,188,53,-1453,254,18.8,1559.5,red,2.67,1.43,17,19,blue
4525216549,5,3,8,1,1,0,0,16294,7.2,18718,218,60,613,323,21.8,1629.4,3,5,3,0,0,0,0,15681,7.2,18395,232,64,-613,-323,23.2,1568.1,red,4.33,1.2,15,17,red
4518394707,6,8,7,1,1,0,0,16877,7.4,19179,225,52,-772,-545,22.5,1687.7,8,6,11,0,0,0,0,17649,7.4,19724,226,59,772,545,22.6,1764.9,red,1.62,3.17,39,14,red
4493025099,6,8,6,0,0,0,0,15222,6.2,15621,178,31,-1262,-1379,17.8,1522.2,8,6,7,0,0,0,0,16484,6.6,17000,178,36,1262,1379,17.8,1648.4,red,1.5,2.5,19,19,red
4477115596,6,9,6,1,0,1,0,17245,7.2,18890,236,52,-862,1054,23.6,1724.5,9,6,13,1,1,0,0,18107,6.8,17836,219,40,862,-1054,21.9,1810.7,red,1.33,3.67,23,20,red
4522394402,9,9,12,1,1,0,0,17187,7,17605,197,38,-1675,-1382,19.7,1718.7,9,9,11,1,0,1,0,18862,7.2,18987,206,40,1675,1382,20.6,1886.2,red,2.33,2.22,21,17,blue
4478470273,5,10,8,2,1,1,0,15156,6.4,16017,156,53,-2997,-3052,15.6,1515.6,10,5,5,0,0,0,0,18153,7,19069,222,49,2997,3052,22.2,1815.3,red,1.3,3,24,36,blue
4489371310,1,6,0,0,0,0,0,13977,6.6,17736,208,60,-4097,-1658,20.8,1397.7,6,1,7,0,0,0,0,18074,7.2,19394,226,72,4097,1658,22.6,1807.4,red,0.17,13,12,32,red
4447454606,6,2,4,0,0,0,0,16383,7,18625,258,33,1678,1155,25.8,1638.3,2,6,1,1,1,0,0,14705,7,17470,216,59,-1678,-1155,21.6,1470.5,red,5,0.5,19,28,blue
4494944051,3,7,4,0,0,0,0,15392,6.8,17234,240,44,-1445,-694,24,1539.2,7,3,9,0,0,0,0,16837,6.8,17928,225,50,1445,694,22.5,1683.7,red,1,5.33,18,18,blue
4441887841,5,2,3,1,1,0,0,15397,6.8,18585,204,68,1516,709,20.4,1539.7,2,5,1,0,0,0,0,13881,7,17876,196,44,-1516,-709,19.6,1388.1,blue,4,0.6,13,36,blue
4523081762,6,8,4,0,0,0,0,16142,7,18299,191,66,-1769,-1209,19.1,1614.2,8,6,6,1,1,0,0,17911,7.4,19508,264,56,1769,1209,26.4,1791.1,red,1.25,2.33,20,17,red
4518606893,9,6,13,0,0,0,0,17855,7.2,19265,200,51,2063,2131,20,1785.5,6,9,10,1,1,0,0,15792,7,17134,182,42,-2063,-2131,18.2,1579.2,blue,3.67,1.78,18,41,blue
4515490352,2,8,2,0,0,0,0,13956,6.6,16492,210,50,-3535,-1720,21,1395.6,8,2,12,1,1,0,0,17491,7,18212,203,63,3535,1720,20.3,1749.1,red,0.5,10,16,18,red
4524165991,6,8,7,1,1,0,0,15753,6.8,16744,203,45,-1964,-1415,20.3,1575.3,8,6,7,1,0,1,0,17717,7,18159,238,48,1964,1415,23.8,1771.7,red,1.62,2.5,55,19,red
4519998641,8,9,7,0,0,0,0,16272,6.6,16687,179,41,-1117,-1207,17.9,1627.2,9,8,7,1,1,0,0,17389,6.8,17894,223,52,1117,1207,22.3,1738.9,red,1.67,2,44,20,red
4439155186,7,6,9,0,0,0,0,16869,7.2,18297,230,55,713,-58,23,1686.9,6,7,9,1,1,0,0,16156,6.8,18355,213,48,-713,58,21.3,1615.6,blue,2.67,2.14,20,21,red
4451884884,9,10,12,0,0,0,0,16990,6.8,17317,198,29,-1534,-1073,19.8,1699,10,9,11,0,0,0,0,18524,6.8,18390,218,44,1534,1073,21.8,1852.4,red,2.1,2.33,21,20,blue
4522238390,9,4,8,0,0,0,0,17991,7.4,20130,219,59,1350,2355,21.9,1799.1,4,9,6,2,1,1,1,16641,6.8,17775,208,49,-1350,-2355,20.8,1664.1,red,4.25,1.11,54,14,red
4513491356,2,3,2,0,0,0,0,15143,7,18397,239,60,129,200,23.9,1514.3,3,2,4,1,1,0,0,15014,7,18197,224,56,-129,-200,22.4,1501.4,red,1.33,3.5,25,21,red
4457622951,8,5,7,1,1,0,0,16735,6.8,17862,215,49,926,967,21.5,1673.5,5,8,7,0,0,0,0,15809,6.6,16895,188,56,-926,-967,18.8,1580.9,blue,3,1.5,19,78,blue
4476709038,4,4,4,1,0,1,0,15971,6.8,17247,241,53,603,-932,24.1,1597.1,4,4,5,0,0,0,0,15368,6.8,18179,215,50,-603,932,21.5,1536.8,blue,2,2.25,22,52,red
4463528314,9,6,12,0,0,0,0,17752,7,18405,212,47,1512,447,21.2,1775.2,6,9,6,1,1,0,0,16240,7,17958,219,52,-1512,-447,21.9,1624,blue,3.5,1.33,18,18,red
4510779224,3,7,1,0,0,0,0,15023,7,17982,222,60,-2942,-2574,22.2,1502.3,7,3,8,1,1,0,0,17965,7.6,20556,228,72,2942,2574,22.8,1796.5,red,0.57,5,16,20,blue
4524310829,5,3,6,2,1,1,0,16007,6.8,17370,202,45,701,-628,20.2,1600.7,3,5,2,0,0,0,0,15306,7,17998,236,62,-701,628,23.6,1530.6,blue,3.67,1,27,25,blue
4523031223,4,6,5,0,0,0,0,15454,6.8,17256,199,45,-1648,-1354,19.9,1545.4,6,4,3,2,1,1,1,17102,7,18610,217,52,1648,1354,21.7,1710.2,blue,1.5,2.25,24,20,blue
4495034675,8,3,4,0,0,0,0,17058,6.8,16737,207,40,2559,806,20.7,1705.8,3,8,4,0,0,0,0,14499,6.4,15931,196,51,-2559,-806,19.6,1449.9,blue,4,0.88,22,19,blue
4520391395,8,10,9,1,0,1,1,18374,7.2,18219,218,54,1142,969,21.8,1837.4,10,8,14,0,0,0,0,17232,6.8,17250,188,50,-1142,-969,18.8,1723.2,red,1.7,3,18,14,blue
4517934356,5,9,3,0,0,0,0,16259,6.4,16804,224,43,-1501,-2063,22.4,1625.9,9,5,7,1,1,0,0,17760,7.2,18867,240,60,1501,2063,24,1776,red,0.89,3.2,87,43,blue
4524880851,5,2,6,1,0,1,0,15894,6.8,18026,222,61,409,1405,22.2,1589.4,2,5,3,1,1,0,0,15485,6.8,16621,241,56,-409,-1405,24.1,1548.5,red,5.5,1,17,21,red
4476038312,4,8,5,1,1,0,0,15524,6.6,17508,214,60,-2752,-2170,21.4,1552.4,8,4,9,0,0,0,0,18276,7.4,19678,252,63,2752,2170,25.2,1827.6,red,1.12,4.25,22,19,blue
4521922174,11,5,8,0,0,0,0,18956,7.2,19208,243,47,3415,1887,24.3,1895.6,5,11,6,1,1,0,0,15541,6.8,17321,192,52,-3415,-1887,19.2,1554.1,red,3.8,1,18,207,blue
4521632653,9,5,12,1,1,0,0,17881,7.2,19236,238,43,1867,1838,23.8,1788.1,5,9,4,0,0,0,0,16014,6.6,17398,205,72,-1867,-1838,20.5,1601.4,blue,4.2,1,14,16,red
4478513496,7,6,5,0,0,0,0,17131,7.2,19074,229,59,1692,205,22.9,1713.1,6,7,4,1,1,0,0,15439,7,18869,186,52,-1692,-205,18.6,1543.9,blue,2,1.43,15,14,blue
4523814750,7,3,4,1,0,1,0,17666,7,18167,240,41,3198,1428,24,1766.6,3,7,7,1,1,0,0,14468,6.6,16739,201,40,-3198,-1428,20.1,1446.8,blue,3.67,1.43,21,20,blue
4523383919,7,5,5,2,1,1,0,17538,7.4,19556,229,71,1652,1714,22.9,1753.8,5,7,4,0,0,0,0,15886,6.8,17842,209,48,-1652,-1714,20.9,1588.6,blue,2.4,1.29,36,16,blue
4523492555,4,1,5,1,1,0,0,16942,7.6,20255,261,72,2875,3035,26.1,1694.2,1,4,1,0,0,0,0,14067,6.8,17220,222,56,-2875,-3035,22.2,1406.7,blue,9,0.5,16,17,blue
4484301956,10,4,10,0,0,0,0,18224,7.4,19875,225,43,2978,3229,22.5,1822.4,4,10,5,0,0,0,0,15246,6.8,16646,224,42,-2978,-3229,22.4,1524.6,red,5,0.9,15,18,blue
4518225344,5,5,6,1,1,0,0,16345,6.8,17499,246,45,134,-1022,24.6,1634.5,5,5,5,0,0,0,0,16211,7.2,18521,239,58,-134,1022,23.9,1621.1,blue,2.2,2,20,20,blue
4523992851,4,6,4,0,0,0,0,15865,7,18437,238,59,-418,34,23.8,1586.5,6,4,8,1,1,0,0,16283,7,18403,231,52,418,-34,23.1,1628.3,red,1.33,3.5,16,17,blue
4434531631,5,10,3,0,0,0,0,15266,6.6,17065,209,51,-3446,-1168,20.9,1526.6,10,5,13,1,1,0,0,18712,7,18233,222,68,3446,1168,22.2,1871.2,red,0.8,4.6,20,16,blue
4494865668,4,3,1,1,0,1,0,15454,6.6,17213,226,49,957,406,22.6,1545.4,3,4,3,0,0,0,0,14497,6.8,16807,215,50,-957,-406,21.5,1449.7,red,1.67,1.5,23,19,blue
4481846502,5,1,2,1,1,0,0,17051,7.6,20109,259,81,2358,2590,25.9,1705.1,1,5,0,0,0,0,0,14693,6.8,17519,248,57,-2358,-2590,24.8,1469.3,blue,7,0.2,24,21,red
4522521033,8,13,6,0,0,0,0,17705,6.8,17690,201,44,-1291,-1067,20.1,1770.5,13,8,16,0,0,0,0,18996,7.2,18757,213,31,1291,1067,21.3,1899.6,red,1.08,3.62,19,22,blue
4504894173,8,1,9,0,0,0,0,16763,6.6,17181,209,36,3371,1173,20.9,1676.3,1,8,2,0,0,0,0,13392,6.4,16008,195,50,-3371,-1173,19.5,1339.2,red,17,0.38,18,19,blue
4457422227,7,8,10,0,0,0,0,16808,6.8,17371,189,60,-400,-539,18.9,1680.8,8,7,5,1,1,0,0,17208,7.2,17910,194,61,400,539,19.4,1720.8,red,2.12,1.86,18,18,red
4516273622,4,12,3,0,0,0,0,15111,6.6,16978,218,41,-4189,-3388,21.8,1511.1,12,4,10,2,1,1,0,19300,7.4,20366,249,46,4189,3388,24.9,1930,red,0.58,5.5,19,16,red
4508498519,5,11,6,1,1,0,0,14998,6.4,15823,199,60,-4011,-3207,19.9,1499.8,11,5,19,0,0,0,0,19009,7.2,19030,233,64,4011,3207,23.3,1900.9,red,1,6,27,19,blue
4462114577,5,9,7,0,0,0,0,16942,7,17624,227,63,9,-1196,22.7,1694.2,9,5,9,1,1,0,0,16933,6.8,18820,215,47,-9,1196,21.5,1693.3,red,1.33,3.6,40,17,blue
4464934797,6,8,7,0,0,0,0,15270,6.4,17079,181,49,-2630,-2204,18.1,1527,8,6,6,1,1,0,0,17900,7.2,19283,238,50,2630,2204,23.8,1790,red,1.62,2.33,52,22,red
4515832303,3,5,4,0,0,0,0,14586,6.6,16499,194,49,-1494,-700,19.4,1458.6,5,3,5,0,0,0,0,16080,6.6,17199,231,45,1494,700,23.1,1608,red,1.4,3.33,53,17,red
4497740999,8,4,12,1,1,0,0,18232,7.2,18215,228,52,2655,2106,22.8,1823.2,4,8,3,0,0,0,0,15577,6.4,16109,226,36,-2655,-2106,22.6,1557.7,blue,5,0.88,28,21,red
4489000836,9,8,13,0,0,0,0,17190,6.8,16876,204,36,329,-298,20.4,1719,8,9,10,1,1,0,0,16861,7,17174,206,44,-329,298,20.6,1686.1,blue,2.75,2,15,18,red
4511823167,4,2,3,0,0,0,0,15008,6.8,17416,225,40,1219,1558,22.5,1500.8,2,4,1,1,1,0,0,13789,6.6,15858,193,44,-1219,-1558,19.3,1378.9,red,3.5,0.75,33,33,red
4518026363,15,7,15,1,1,0,1,21755,7.2,18071,191,48,5494,1987,19.1,2175.5,7,15,7,0,0,0,0,16261,6.4,16084,168,44,-5494,-1987,16.8,1626.1,blue,4.29,0.93,17,12,blue
4474905504,4,1,8,1,1,0,0,15787,7.2,19141,223,70,1259,2317,22.3,1578.7,1,4,0,0,0,0,0,14528,6.4,16824,236,47,-1259,-2317,23.6,1452.8,blue,12,0.25,21,20,blue
4490887510,6,7,6,0,0,0,0,16404,6.8,18840,245,48,-919,47,24.5,1640.4,7,6,10,0,0,0,0,17323,7.2,18793,219,50,919,-47,21.9,1732.3,red,1.71,2.83,17,115,red
4522673306,7,4,13,1,1,0,0,17878,7.6,20464,232,62,2566,3097,23.2,1787.8,4,7,4,0,0,0,0,15312,7,17367,235,47,-2566,-3097,23.5,1531.2,blue,5,1.14,31,27,red
4483893838,8,9,14,2,1,1,0,18532,7.2,18460,240,55,1428,295,24,1853.2,9,8,9,0,0,0,0,17104,7,18165,201,48,-1428,-295,20.1,1710.4,blue,2.44,2.25,17,18,blue
4496570005,8,10,7,1,0,1,0,16901,6.4,16288,176,52,-763,-450,17.6,1690.1,10,8,14,0,0,0,0,17664,6.6,16738,204,27,763,450,20.4,1766.4,red,1.5,3,19,22,blue
4519431177,7,10,7,0,0,0,0,17563,7,17585,199,41,-1360,-1561,19.9,1756.3,10,7,11,1,1,0,0,18923,7.2,19146,244,54,1360,1561,24.4,1892.3,red,1.4,3,9,15,red
4480275637,4,4,4,0,0,0,0,15967,7,17892,225,62,-553,284,22.5,1596.7,4,4,4,2,1,1,1,16520,6.8,17608,217,44,553,-284,21.7,1652,blue,2,2,21,19,blue
4515764294,4,12,4,0,0,0,0,16280,6.8,17372,223,54,-3279,-1466,22.3,1628,12,4,15,1,1,0,0,19559,7.2,18838,252,59,3279,1466,25.2,1955.9,red,0.67,6.75,17,17,red
4445163609,8,5,6,1,0,1,0,17142,7,18245,221,38,2301,2562,22.1,1714.2,5,8,8,1,1,0,0,14841,6.4,15683,177,50,-2301,-2562,17.7,1484.1,blue,2.8,1.62,24,17,blue
4492054165,4,8,1,0,0,0,0,14807,6.8,17294,201,56,-2462,-1894,20.1,1480.7,8,4,6,0,0,0,0,17269,7.4,19188,229,56,2462,1894,22.9,1726.9,red,0.62,3.5,60,17,blue
4471038751,10,13,14,0,0,0,1,18697,6.8,17238,213,24,-198,-1159,21.3,1869.7,13,10,9,1,0,1,1,18895,6.8,18397,188,64,198,1159,18.8,1889.5,blue,1.85,2.2,18,20,blue
4478447096,8,8,9,0,0,0,0,17057,6.6,17009,190,48,240,-903,19,1705.7,8,8,9,0,0,0,0,16817,7,17912,197,51,-240,903,19.7,1681.7,red,2.12,2.12,17,19,blue
4523715686,5,3,3,1,1,0,0,16487,6.8,18581,235,42,1780,1010,23.5,1648.7,3,5,1,0,0,0,0,14707,6.8,17571,218,48,-1780,-1010,21.8,1470.7,blue,2.67,0.8,19,16,red
4459332063,5,3,6,0,0,0,0,15721,6.6,17087,210,48,435,-1039,21,1572.1,3,5,3,0,0,0,0,15286,6.8,18126,229,55,-435,1039,22.9,1528.6,blue,3.67,1.2,17,18,blue
4439604541,5,3,7,1,1,0,0,17182,7.4,19944,246,71,1591,1778,24.6,1718.2,3,5,4,0,0,0,0,15591,6.8,18166,257,47,-1591,-1778,25.7,1559.1,blue,4,1.4,18,15,red
4465004748,8,4,10,2,1,1,0,16993,7.2,18608,212,48,937,530,21.2,1699.3,4,8,3,0,0,0,0,16056,7,18078,205,66,-937,-530,20.5,1605.6,blue,4.5,0.88,19,22,red
4450387625,5,8,4,0,0,0,0,15710,7,17847,223,45,-2320,-2276,22.3,1571,8,5,7,1,1,0,0,18030,7.6,20123,237,68,2320,2276,23.7,1803,blue,1.12,3,16,18,red
4524555645,10,8,10,1,0,1,0,17793,7,18327,193,55,496,187,19.3,1779.3,8,10,7,1,1,0,0,17297,6.8,18140,220,44,-496,-187,22,1729.7,blue,2.5,1.5,15,14,red
4515575207,13,2,11,1,1,0,0,19867,7,19401,236,58,6977,5303,23.6,1986.7,2,13,4,0,0,0,0,12890,5.8,14098,168,33,-6977,-5303,16.8,1289,blue,12,0.46,19,14,blue
4459482248,10,5,10,0,0,0,0,18538,7.4,19307,225,47,2832,2861,22.5,1853.8,5,10,7,0,0,0,0,15706,6.6,16446,214,52,-2832,-2861,21.4,1570.6,blue,4,1.2,21,18,blue
4473219788,3,9,2,0,0,0,0,14624,6.6,16231,211,32,-4073,-2595,21.1,1462.4,9,3,7,1,0,1,0,18697,7.2,18826,226,60,4073,2595,22.6,1869.7,red,0.56,5.33,18,23,blue
4524703724,5,4,4,0,0,0,0,16005,7,17430,228,38,1561,621,22.8,1600.5,4,5,6,1,1,0,0,14444,6.6,16809,187,47,-1561,-621,18.7,1444.4,blue,2.25,2,25,22,blue
4519580848,4,8,4,0,0,0,0,15194,6.8,17750,220,41,-2143,-1251,22,1519.4,8,4,6,1,0,1,0,17337,7.2,19001,205,48,2143,1251,20.5,1733.7,red,1,3.5,48,21,red
4465044945,13,3,13,1,0,1,0,20943,7.6,21575,235,64,6081,4748,23.5,2094.3,3,13,5,1,1,0,0,14862,6.6,16827,197,48,-6081,-4748,19.7,1486.2,blue,8.67,0.62,17,14,red
4477827801,6,4,5,0,0,0,0,15983,7.2,19092,218,48,515,1403,21.8,1598.3,4,6,5,1,1,0,0,15468,6.8,17689,194,60,-515,-1403,19.4,1546.8,blue,2.75,1.5,24,40,blue
4521920198,1,7,1,0,0,0,0,14513,6.6,17238,218,48,-2382,-2219,21.8,1451.3,7,1,5,1,1,0,0,16895,7.2,19457,248,56,2382,2219,24.8,1689.5,red,0.29,12,18,19,red
4521483085,6,3,6,1,1,0,0,17536,7,19253,266,48,2880,2785,26.6,1753.6,3,6,5,0,0,0,0,14656,6.6,16468,197,48,-2880,-2785,19.7,1465.6,blue,4,1.33,20,60,blue
4524144661,4,3,7,1,1,0,0,15796,6.8,16848,221,54,724,-1747,22.1,1579.6,3,4,3,0,0,0,0,15072,7.2,18595,209,56,-724,1747,20.9,1507.2,red,3.67,1.5,21,12,blue
4525093722,15,7,19,1,1,0,0,20833,7.6,20278,231,36,4882,2906,23.1,2083.3,7,15,5,0,0,0,0,15951,6.8,17372,202,44,-4882,-2906,20.2,1595.1,blue,4.86,0.8,19,17,blue
4525118904,7,2,8,1,1,0,0,18650,7.4,20329,248,60,3877,1762,24.8,1865,2,7,3,0,0,0,0,14773,7.2,18567,220,61,-3877,-1762,22,1477.3,blue,7.5,0.71,17,52,blue
4522214427,4,6,2,1,1,0,0,15044,7,17888,214,48,-2127,-997,21.4,1504.4,6,4,8,0,0,0,0,17171,7.2,18885,228,59,2127,997,22.8,1717.1,red,1,3.5,47,38,red
4518315271,4,4,6,1,1,0,0,15811,7,17771,212,63,161,-97,21.2,1581.1,4,4,6,0,0,0,0,15650,6.6,17868,222,45,-161,97,22.2,1565,red,2.5,2.5,41,37,blue
4511251323,4,4,2,0,0,0,0,15612,6.8,17757,228,41,608,362,22.8,1561.2,4,4,2,1,1,0,0,15004,7,17395,208,60,-608,-362,20.8,1500.4,red,1.5,1.5,104,46,blue
4523593666,5,13,3,1,1,0,0,15151,6.6,16565,204,56,-4570,-3352,20.4,1515.1,13,5,18,1,0,1,0,19721,7.4,19917,207,68,4570,3352,20.7,1972.1,red,0.62,6.2,17,33,red
4474783005,6,5,6,0,0,0,0,16496,7,18365,244,48,120,1543,24.4,1649.6,5,6,14,1,1,0,0,16376,6.6,16822,206,70,-120,-1543,20.6,1637.6,red,2.4,3.17,18,19,red
4477491383,8,7,9,0,0,0,0,16059,7,17499,190,36,-1073,-657,19,1605.9,7,8,7,1,0,1,0,17132,6.8,18156,232,43,1073,657,23.2,1713.2,red,2.43,1.75,19,22,blue
4521242429,4,11,4,0,0,0,0,15120,6.4,16083,189,44,-3181,-2898,18.9,1512,11,4,14,0,0,0,0,18301,7.4,18981,214,48,3181,2898,21.4,1830.1,blue,0.73,6.25,20,59,red
4516825936,5,5,4,1,0,1,0,16185,6.8,17330,212,52,-226,-262,21.2,1618.5,5,5,10,1,1,0,0,16411,6.8,17592,228,60,226,262,22.8,1641.1,blue,1.8,3,13,16,blue
4522444254,3,8,2,0,0,0,0,15404,6.8,17439,240,56,-3096,-3752,24,1540.4,8,3,11,1,1,0,0,18500,7.6,21191,256,76,3096,3752,25.6,1850,red,0.62,6.33,14,43,blue
4450477657,8,6,5,0,0,0,1,17952,7,18161,210,32,2123,2563,21,1795.2,6,8,8,1,1,0,0,15829,6.2,15598,192,32,-2123,-2563,19.2,1582.9,blue,2.17,1.75,15,18,blue
4490512919,5,13,7,0,0,0,0,14776,6.2,15469,161,40,-5760,-4168,16.1,1477.6,13,5,12,1,0,1,1,20536,7.4,19637,235,49,5760,4168,23.5,2053.6,red,0.92,5,48,54,blue
4509823937,4,10,2,0,0,0,0,16183,7,17767,251,44,-2155,-2249,25.1,1618.3,10,4,10,1,1,0,0,18338,7.2,20016,219,60,2155,2249,21.9,1833.8,red,0.6,5,21,16,red
4523432307,4,7,6,0,0,0,0,16037,7,18122,231,58,-519,1292,23.1,1603.7,7,4,10,0,0,0,0,16556,6.6,16830,213,36,519,-1292,21.3,1655.6,blue,1.43,4.25,17,21,red
4510843873,5,9,5,2,1,1,1,18041,7,18637,221,60,786,1049,22.1,1804.1,9,5,14,0,0,0,0,17255,6.8,17588,213,33,-786,-1049,21.3,1725.5,blue,1.11,4.6,17,18,red
4513110398,5,6,3,1,1,0,0,14820,6.4,16224,167,47,-1671,-1100,16.7,1482,6,5,10,0,0,0,0,16491,6.8,17324,223,52,1671,1100,22.3,1649.1,blue,1.33,3.2,20,21,red
4523593129,1,5,0,0,0,0,0,13943,6.8,17294,230,55,-4036,-1844,23,1394.3,5,1,5,1,1,0,1,17979,7.2,19138,231,65,4036,1844,23.1,1797.9,red,0.2,10,19,18,red
4463171259,7,10,4,2,1,1,1,17023,6.4,16951,201,44,-1148,-2197,20.1,1702.3,10,7,8,0,0,0,0,18171,7.2,19148,226,43,1148,2197,22.6,1817.1,red,1.1,2.57,17,19,red
4520634321,2,5,2,0,0,0,0,15011,7,17250,223,60,-1399,-763,22.3,1501.1,5,2,7,1,1,0,0,16410,7,18013,208,60,1399,763,20.8,1641,blue,0.8,6,20,26,blue
4488366121,13,5,13,0,0,0,0,20067,7.4,20095,229,36,4409,4503,22.9,2006.7,5,13,5,1,1,0,0,15658,6.2,15592,182,48,-4409,-4503,18.2,1565.8,blue,5.2,0.77,21,18,red
4450463200,6,7,4,1,1,0,1,17149,6.8,17815,196,54,770,-46,19.6,1714.9,7,6,7,0,0,0,0,16379,7,17861,202,34,-770,46,20.2,1637.9,blue,1.43,2.33,13,11,blue
4468727943,3,7,4,1,1,0,0,14688,6.8,16866,199,52,-2193,-1574,19.9,1468.8,7,3,10,0,0,0,0,16881,7,18440,217,44,2193,1574,21.7,1688.1,red,1,5.67,12,13,blue
4522652739,4,2,3,2,1,1,0,16125,7.2,19055,235,56,1236,144,23.5,1612.5,2,4,2,0,0,0,0,14889,7.4,18911,249,60,-1236,-144,24.9,1488.9,red,3.5,1,20,32,blue
4523041971,1,5,2,1,0,1,0,14197,6.8,17212,225,48,-2144,-2451,22.5,1419.7,5,1,3,1,1,0,0,16341,7.2,19663,246,52,2144,2451,24.6,1634.1,red,0.6,8,34,33,blue
4507364273,12,2,8,1,0,1,0,18863,7.6,20134,238,52,4785,4475,23.8,1886.3,2,12,2,0,0,0,0,14078,6.4,15659,206,42,-4785,-4475,20.6,1407.8,blue,10,0.33,15,14,blue
4523621040,4,4,2,1,1,0,0,15488,7.2,18538,240,51,-344,1361,24,1548.8,4,4,4,0,0,0,0,15832,6.6,17177,241,48,344,-1361,24.1,1583.2,blue,1.5,2,16,17,red
4516905603,7,8,8,0,0,0,1,18283,7,18662,209,60,905,312,20.9,1828.3,8,7,6,1,1,0,0,17378,7,18350,206,61,-905,-312,20.6,1737.8,blue,1.88,2,16,18,red
4510127229,10,5,14,0,0,0,0,18538,7.2,19030,247,44,1806,632,24.7,1853.8,5,10,5,1,1,0,0,16732,7,18398,216,64,-1806,-632,21.6,1673.2,blue,4.8,1,20,18,blue
4513511494,8,5,5,1,0,1,0,17875,7.2,20182,206,80,2095,1664,20.6,1787.5,5,8,3,1,1,0,0,15780,7,18518,215,60,-2095,-1664,21.5,1578,blue,2.6,1,11,13,red
4520610371,9,3,11,0,0,0,0,16954,6.8,17771,221,32,2589,2509,22.1,1695.4,3,9,4,1,1,0,0,14365,6.4,15262,187,46,-2589,-2509,18.7,1436.5,blue,6.67,0.78,20,36,red
4455149960,3,5,2,2,1,1,0,15073,6.8,16649,234,44,-745,-1826,23.4,1507.3,5,3,3,0,0,0,0,15818,7,18475,200,66,745,1826,20,1581.8,red,1,2.67,19,44,red
4450950525,5,6,3,0,0,0,0,16038,7,18686,219,60,329,1704,21.9,1603.8,6,5,3,1,1,0,0,15709,6.8,16982,208,56,-329,-1704,20.8,1570.9,blue,1.33,1.8,22,15,blue
4500650669,5,6,3,0,0,0,0,16032,7,18159,229,58,-478,-389,22.9,1603.2,6,5,6,1,1,0,0,16510,7,18548,221,48,478,389,22.1,1651,red,1.33,2.4,19,26,red
4519229533,4,3,7,1,1,0,0,15669,7,17654,223,57,273,-1110,22.3,1566.9,3,4,3,0,0,0,0,15396,7.2,18764,237,56,-273,1110,23.7,1539.6,red,3.67,1.5,17,24,blue
4523569413,8,6,8,1,1,0,0,18198,7,18250,246,40,2713,464,24.6,1819.8,6,8,3,1,0,1,0,15485,6.8,17786,187,56,-2713,-464,18.7,1548.5,blue,2.67,1.12,17,14,blue
4502159358,13,9,19,1,1,0,0,19528,7.2,18855,211,42,1852,219,21.1,1952.8,9,13,5,0,0,0,0,17676,7.2,18636,217,72,-1852,-219,21.7,1767.6,red,3.56,1.08,17,18,blue
4471522569,8,6,6,2,1,1,0,17316,7,18199,206,68,767,796,20.6,1731.6,6,8,8,0,0,0,0,16549,6.8,17403,216,52,-767,-796,21.6,1654.9,blue,2.33,1.75,21,20,red
4465402060,7,5,10,0,0,0,0,16509,7,18241,202,52,373,-1568,20.2,1650.9,5,7,2,1,1,0,0,16136,7.2,19809,224,76,-373,1568,22.4,1613.6,red,3.4,1,15,16,red
4475988049,10,5,11,0,0,0,0,17741,6.8,18253,230,40,2405,1439,23,1774.1,5,10,6,1,1,0,0,15336,6.8,16814,199,40,-2405,-1439,19.9,1533.6,blue,4.2,1.1,53,17,blue
4524429055,4,0,2,2,1,1,0,16124,7.4,18986,244,76,2186,1319,24.4,1612.4,0,4,0,0,0,0,0,13938,6.8,17667,241,51,-2186,-1319,24.1,1393.8,red,12.03,0,21,21,blue
4523063509,5,3,8,1,1,0,0,16395,7,17740,214,52,1315,-99,21.4,1639.5,3,5,3,0,0,0,0,15080,7,17839,209,54,-1315,99,20.9,1508,blue,4.33,1.2,14,37,blue
4495755688,8,5,7,1,1,0,0,18020,7.2,18981,253,56,2533,1172,25.3,1802,5,8,4,0,0,0,0,15487,6.8,17809,212,60,-2533,-1172,21.2,1548.7,blue,3,1.12,19,21,blue
4479273649,3,5,8,0,0,0,0,14759,6.8,17310,194,56,-1394,-589,19.4,1475.9,5,3,7,1,1,0,0,16153,6.8,17899,246,44,1394,589,24.6,1615.3,red,2.2,4,10,14,red
4502014751,4,8,3,0,0,0,0,14521,6.6,16346,186,40,-4413,-5071,18.6,1452.1,8,4,12,1,1,0,0,18934,7.8,21417,234,79,4413,5071,23.4,1893.4,red,0.88,5,36,20,blue
4525225774,6,4,6,1,0,1,1,18341,7.2,19885,229,76,3347,2958,22.9,1834.1,4,6,8,1,1,0,0,14994,6.6,16927,206,47,-3347,-2958,20.6,1499.4,blue,3,2,18,20,blue
4460492996,14,6,19,0,0,0,0,19599,7.4,19082,211,44,4085,2139,21.1,1959.9,6,14,6,1,1,0,0,15514,6.8,16943,188,40,-4085,-2139,18.8,1551.4,red,5.5,0.86,16,12,blue
4518392539,10,4,14,0,0,0,0,18019,6.8,17440,210,48,4581,2792,21,1801.9,4,10,3,0,0,0,0,13438,6,14648,153,28,-4581,-2792,15.3,1343.8,red,6,0.7,15,16,blue
4513996335,7,7,7,1,1,0,0,16491,6.6,16774,190,60,453,-1745,19,1649.1,7,7,0,0,0,0,0,16038,7,18519,238,51,-453,1745,23.8,1603.8,red,2,1,44,22,blue
4521189222,14,7,15,0,0,0,0,21699,7.6,20734,242,43,5773,3643,24.2,2169.9,7,14,6,1,1,0,0,15926,6.8,17091,208,50,-5773,-3643,20.8,1592.6,blue,4.14,0.93,41,29,blue
4513157515,5,5,6,1,0,1,0,16249,7,18403,217,60,251,1074,21.7,1624.9,5,5,7,1,1,0,0,15998,7,17329,229,52,-251,-1074,22.9,1599.8,red,2.2,2.4,17,16,red
4524902181,7,7,6,1,1,0,0,16476,6.6,17474,210,53,335,731,21,1647.6,7,7,4,0,0,0,0,16141,6.6,16743,206,40,-335,-731,20.6,1614.1,red,1.86,1.57,91,24,red
4520017061,7,5,6,2,1,1,3,18246,6.8,17783,228,41,3826,3122,22.8,1824.6,5,7,8,0,0,0,0,14420,6.2,14661,156,44,-3826,-3122,15.6,1442,blue,2.6,1.86,41,24,blue
4495535828,6,3,5,2,1,1,0,16646,7.2,18549,242,49,919,94,24.2,1664.6,3,6,6,0,0,0,0,15727,7.2,18455,258,56,-919,-94,25.8,1572.7,blue,3.67,1.5,24,24,blue
4516132532,5,2,3,0,0,0,0,16568,7,18389,222,52,2150,475,22.2,1656.8,2,5,4,1,1,0,0,14418,7,17914,228,48,-2150,-475,22.8,1441.8,blue,4,1.2,15,13,blue
4439238044,8,6,10,1,1,0,1,18519,7.2,18555,223,48,1840,144,22.3,1851.9,6,8,6,1,0,1,0,16679,7.2,18411,214,52,-1840,-144,21.4,1667.9,blue,3,1.5,17,17,blue
4521769978,4,6,2,0,0,0,0,15498,6.8,17805,228,32,-1953,-1854,22.8,1549.8,6,4,5,2,1,1,0,17451,7.4,19659,259,58,1953,1854,25.9,1745.1,red,1,2.75,19,17,red
4475616584,4,7,4,0,0,0,0,14927,6.8,17831,205,52,-2435,-850,20.5,1492.7,7,4,12,1,1,0,0,17362,7.2,18681,227,59,2435,850,22.7,1736.2,red,1.14,4.75,20,25,red
4455484504,3,4,4,0,0,0,0,15120,6.8,17606,230,48,-1338,-779,23,1512,4,3,8,1,1,0,0,16458,7,18385,234,55,1338,779,23.4,1645.8,red,1.75,4,42,36,red
4522610884,7,3,10,1,1,0,0,17146,7.2,19310,227,63,2072,2367,22.7,1714.6,3,7,5,0,0,0,0,15074,6.8,16943,241,49,-2072,-2367,24.1,1507.4,blue,5.67,1.14,24,18,red
4525092845,5,10,3,1,0,1,0,16141,7,17238,229,52,-1634,-2844,22.9,1614.1,10,5,10,0,0,0,0,17775,7.6,20082,240,40,1634,2844,24,1777.5,red,0.8,4,17,17,blue
4467777075,8,4,8,1,1,0,0,17798,7.2,18795,220,56,3120,2464,22,1779.8,4,8,5,0,0,0,0,14678,6.6,16331,192,48,-3120,-2464,19.2,1467.8,blue,4,1.12,19,17,blue
4516815119,4,9,5,0,0,0,0,15945,6.8,17648,248,35,-781,289,24.8,1594.5,9,4,10,1,1,0,0,16726,6.8,17359,195,48,781,-289,19.5,1672.6,blue,1,4.75,38,11,red
4496160453,6,7,5,0,0,0,0,16169,6.6,17326,214,42,-620,-1984,21.4,1616.9,7,6,4,2,1,1,0,16789,7,19310,237,56,620,1984,23.7,1678.9,red,1.57,1.83,16,23,red
4521266857,3,6,1,0,0,0,0,15177,6.8,17645,220,52,-1716,-2811,22,1517.7,6,3,4,0,0,0,0,16893,7.4,20456,241,64,1716,2811,24.1,1689.3,red,0.67,3.33,22,22,blue
4505912615,6,0,9,0,0,0,0,18307,7.4,19628,235,69,5027,3394,23.5,1830.7,0,6,0,0,0,0,0,13280,6.4,16234,211,53,-5027,-3394,21.1,1328,blue,12.03,0,21,59,blue
4479275865,7,8,7,2,1,1,0,16473,7,18395,201,52,-932,150,20.1,1647.3,8,7,11,0,0,0,0,17405,7,18245,246,63,932,-150,24.6,1740.5,red,1.75,2.71,47,17,red
4458863956,10,2,17,1,1,0,1,19483,7,18561,211,56,5415,2991,21.1,1948.3,2,10,4,0,0,0,0,14068,6.4,15570,203,48,-5415,-2991,20.3,1406.8,blue,13.5,0.6,59,17,blue
4516849769,5,12,5,0,0,0,0,15230,6.4,15161,185,44,-3832,-3915,18.5,1523,12,5,11,1,1,0,0,19062,7.4,19076,219,58,3832,3915,21.9,1906.2,red,0.83,4.6,15,16,blue
4523130201,7,5,10,1,1,0,0,16583,7.2,17389,222,44,840,385,22.2,1658.3,5,7,4,0,0,0,0,15743,6.8,17004,213,48,-840,-385,21.3,1574.3,blue,3.4,1.29,47,22,red
4478851132,6,9,3,1,0,1,1,16840,7.2,18376,221,40,-990,-2014,22.1,1684,9,6,7,1,1,0,0,17830,7.4,20390,247,52,990,2014,24.7,1783,red,1,2.67,20,30,red
4480206299,9,7,12,1,0,1,0,17836,7.2,19027,214,64,969,1554,21.4,1783.6,7,9,7,1,1,0,0,16867,6.8,17473,216,36,-969,-1554,21.6,1686.7,blue,3,1.56,26,21,blue
4513547989,16,2,14,0,0,0,1,21658,7.6,20318,211,52,6413,3952,21.1,2165.8,2,16,1,2,1,1,0,15245,6.4,16366,203,52,-6413,-3952,20.3,1524.5,blue,15,0.19,19,79,blue
4476823895,14,9,14,0,0,0,0,19170,7,18219,193,42,3062,2772,19.3,1917,9,14,13,0,0,0,0,16108,6.2,15447,142,38,-3062,-2772,14.2,1610.8,blue,3.11,1.57,12,12,red
4521990616,9,6,7,0,0,0,0,18229,6.8,18093,230,46,2765,1407,23,1822.9,6,9,5,2,1,1,0,15464,6.6,16686,195,56,-2765,-1407,19.5,1546.4,blue,2.67,1.22,23,22,blue
4523612845,6,4,6,0,0,0,0,17591,7.2,18925,235,70,3208,3285,23.5,1759.1,4,6,2,0,0,0,0,14383,6.2,15640,186,52,-3208,-3285,18.6,1438.3,blue,3,1,29,19,red
4487157845,4,5,7,0,0,0,0,15067,6.8,17232,172,56,-1641,-1610,17.2,1506.7,5,4,10,0,0,0,0,16708,7.4,18842,254,52,1641,1610,25.4,1670.8,red,2.2,3.75,25,23,blue
4522204465,2,12,2,0,0,0,0,13844,6.6,15601,224,32,-5161,-4099,22.4,1384.4,12,2,10,1,1,0,0,19005,7.2,19700,200,58,5161,4099,20,1900.5,red,0.33,11,21,20,red
4522630339,3,5,3,0,0,0,0,15699,6.8,17479,226,49,-907,-1650,22.6,1569.9,5,3,6,1,1,0,0,16606,7.4,19129,244,55,907,1650,24.4,1660.6,red,1.2,3.67,18,18,blue
4523747667,6,6,6,0,0,0,0,17077,7,19128,242,61,-162,177,24.2,1707.7,6,6,9,0,0,0,0,17239,7,18951,245,66,162,-177,24.5,1723.9,blue,2,2.5,15,17,red
4479811257,5,10,8,0,0,0,0,15710,6.6,16731,205,46,-3731,-1458,20.5,1571,10,5,11,1,1,0,0,19441,7.2,18189,230,51,3731,1458,23,1944.1,blue,1.3,4.2,30,19,red
4521508038,5,4,4,0,0,0,0,16450,7,18801,229,72,1771,1846,22.9,1645,4,5,4,1,1,0,0,14679,6.6,16955,194,46,-1771,-1846,19.4,1467.9,blue,2.25,1.6,18,18,blue
4519707046,3,5,0,0,0,0,0,16228,6.8,18476,234,71,352,639,23.4,1622.8,5,3,6,0,0,0,0,15876,7,17837,203,44,-352,-639,20.3,1587.6,red,0.6,3.67,17,11,red
4497518760,6,4,2,1,1,0,0,16803,7,18812,255,61,1189,1151,25.5,1680.3,4,6,5,0,0,0,0,15614,7.2,17661,206,59,-1189,-1151,20.6,1561.4,red,2,1.5,18,21,blue
4508944628,2,5,3,1,1,0,0,15462,7,17729,249,66,-1176,-1499,24.9,1546.2,5,2,7,0,0,0,0,16638,7.2,19228,248,58,1176,1499,24.8,1663.8,red,1,6,17,16,blue
4452094519,4,3,2,1,0,1,1,16233,6.8,17972,210,52,1404,1286,21,1623.3,3,4,3,0,0,0,0,14829,6.8,16686,209,51,-1404,-1286,20.9,1482.9,blue,2,1.5,47,19,blue
4520635359,7,17,8,1,0,1,0,16239,6.4,16109,202,52,-4876,-3481,20.2,1623.9,17,7,19,1,1,0,0,21115,7.2,19590,230,56,4876,3481,23,2111.5,blue,0.88,5.14,17,20,blue
4494997427,4,4,4,0,0,0,0,15514,6.6,16759,223,40,249,182,22.3,1551.4,4,4,5,1,1,0,0,15265,6.6,16577,204,45,-249,-182,20.4,1526.5,red,2,2.25,52,20,blue
4510743297,9,6,7,0,0,0,0,18466,7.6,19801,218,68,2220,2300,21.8,1846.6,6,9,7,1,1,0,0,16246,7,17501,185,52,-2220,-2300,18.5,1624.6,red,2.67,1.44,45,13,blue
4499992790,4,4,4,1,1,0,0,16907,7.2,18996,259,55,1559,814,25.9,1690.7,4,4,7,0,0,0,0,15348,6.8,18182,189,56,-1559,-814,18.9,1534.8,red,2,2.75,40,35,blue
4455312963,11,7,11,0,0,0,0,17662,7.2,18294,195,24,1673,536,19.5,1766.2,7,11,5,1,0,1,0,15989,7,17758,173,63,-1673,-536,17.3,1598.9,blue,3.14,1.09,15,47,blue
4475518847,4,12,1,0,0,0,0,14738,6.6,16575,199,52,-4785,-3317,19.9,1473.8,12,4,15,1,1,0,0,19523,7.2,19892,220,65,4785,3317,22,1952.3,red,0.42,6.75,14,31,red
4488507163,7,11,13,1,1,0,0,16225,6.6,17213,206,56,-2463,-2163,20.6,1622.5,11,7,13,0,0,0,0,18688,7.4,19376,224,36,2463,2163,22.4,1868.8,red,1.82,3.43,19,20,red
4459250324,7,1,13,0,0,0,0,18486,7.4,20095,264,68,5159,4916,26.4,1848.6,1,7,2,1,1,0,0,13327,6.4,15179,182,48,-5159,-4916,18.2,1332.7,blue,20,0.43,19,18,blue
4467381838,2,9,2,0,0,0,0,14597,6.8,17317,220,44,-3805,-2559,22,1459.7,9,2,13,0,0,0,0,18402,7.4,19876,274,48,3805,2559,27.4,1840.2,red,0.44,11,41,20,red
4523590647,6,2,3,0,0,0,0,16818,7.2,19595,250,56,2274,2694,25,1681.8,2,6,2,0,0,0,0,14544,6.8,16901,202,50,-2274,-2694,20.2,1454.4,blue,4.5,0.67,23,13,blue
4463551021,2,11,2,0,0,0,0,13714,6.6,16890,201,43,-5129,-3055,20.1,1371.4,11,2,12,1,0,1,0,18843,7.2,19945,250,38,5129,3055,25,1884.3,red,0.36,11.5,18,14,red
4517040983,6,4,5,1,1,0,1,17946,7.2,18589,225,64,2398,1573,22.5,1794.6,4,6,2,1,0,1,0,15548,6.6,17016,230,45,-2398,-1573,23,1554.8,blue,2.75,1,22,20,red
4524348697,6,5,3,1,0,1,0,16141,7.4,19201,215,58,488,2349,21.5,1614.1,5,6,9,1,1,0,0,15653,6.6,16852,183,44,-488,-2349,18.3,1565.3,red,1.8,2.33,20,19,red
4481332118,7,11,8,0,0,0,0,17151,6.8,17131,215,54,-2489,-2055,21.5,1715.1,11,7,18,1,1,0,0,19640,7.2,19186,205,65,2489,2055,20.5,1964,red,1.36,4.14,17,15,red
4509091721,9,10,15,0,0,0,0,18483,7,18474,222,44,270,-688,22.2,1848.3,10,9,13,1,1,0,0,18213,7.2,19162,207,68,-270,688,20.7,1821.3,blue,2.4,2.56,46,23,blue
4520730804,3,1,2,2,1,1,0,15530,6.8,17715,235,52,1219,232,23.5,1553,1,3,3,0,0,0,0,14311,6.8,17483,238,46,-1219,-232,23.8,1431.1,blue,5,1.33,27,46,blue
4516320607,7,5,6,1,1,0,0,15900,7,18137,206,48,-435,-960,20.6,1590,5,7,4,0,0,0,0,16335,7,19097,218,77,435,960,21.8,1633.5,red,2.6,1.29,13,36,red
4522838213,7,0,5,2,1,1,0,17520,7.2,19639,245,63,4228,2880,24.5,1752,0,7,0,0,0,0,0,13292,6.6,16759,194,60,-4228,-2880,19.4,1329.2,blue,12.03,0,15,16,blue
4521070443,5,4,5,0,0,0,0,15933,7.2,18047,246,40,465,632,24.6,1593.3,4,5,5,2,1,1,0,15468,6.8,17415,203,49,-465,-632,20.3,1546.8,red,2.5,1.8,16,42,blue
4419504973,6,9,7,0,0,0,0,16369,7,18174,236,51,-1673,-1221,23.6,1636.9,9,6,10,0,0,0,0,18042,7.4,19395,239,40,1673,1221,23.9,1804.2,red,1.44,3.17,23,42,blue
4523803746,0,5,0,0,0,0,0,14422,6.6,17039,245,59,-1723,-545,24.5,1442.2,5,0,10,1,1,0,0,16145,6.8,17584,229,52,1723,545,22.9,1614.5,blue,0,12.65,19,21,red
4461203281,1,9,2,0,0,0,0,13570,6.2,15620,194,52,-6578,-4807,19.4,1357,9,1,8,2,1,1,1,20148,7.2,20427,267,63,6578,4807,26.7,2014.8,red,0.33,17,20,24,red
4525186736,4,7,6,0,0,0,0,15706,7,17720,244,46,-1992,-1588,24.4,1570.6,7,4,11,2,1,1,0,17698,7.2,19308,256,56,1992,1588,25.6,1769.8,red,1.43,4.5,17,46,red
4489559952,9,9,9,0,0,0,0,17898,7,18398,231,52,-113,-116,23.1,1789.8,9,9,11,1,1,0,0,18011,7.2,18514,218,52,113,116,21.8,1801.1,blue,2,2.22,23,44,red
4494926014,3,8,3,0,0,0,0,14397,6.6,16267,210,52,-3517,-3374,21,1439.7,8,3,9,1,1,0,0,17914,7.2,19641,226,64,3517,3374,22.6,1791.4,red,0.75,5.67,17,16,red
4496339306,5,3,6,1,0,1,0,17227,7,18492,245,62,2582,2655,24.5,1722.7,3,5,5,1,1,0,0,14645,6.2,15837,200,49,-2582,-2655,20,1464.5,blue,3.67,1.6,18,21,red
4504441454,6,4,7,1,1,0,0,16080,7,17928,218,31,533,1187,21.8,1608,4,6,6,0,0,0,0,15547,6.6,16741,219,52,-533,-1187,21.9,1554.7,red,3.25,1.67,18,20,red
4522672364,4,7,4,1,1,0,0,15346,6.6,16812,230,48,-973,-1012,23,1534.6,7,4,6,0,0,0,0,16319,6.8,17824,178,64,973,1012,17.8,1631.9,red,1.14,3.25,21,24,blue
4473758044,2,8,2,1,0,1,0,13853,6.2,14781,205,42,-3650,-3119,20.5,1385.3,8,2,7,0,0,0,0,17503,7.2,17900,221,46,3650,3119,22.1,1750.3,red,0.5,7.5,26,21,red
4523105100,2,6,1,0,0,0,0,14417,6.6,16652,198,60,-1930,-2043,19.8,1441.7,6,2,7,1,1,0,0,16347,7.2,18695,223,53,1930,2043,22.3,1634.7,red,0.5,6.5,17,19,blue
4525199033,13,6,14,0,0,0,0,18676,7,18018,196,44,3188,2289,19.6,1867.6,6,13,5,0,0,0,0,15488,6.4,15729,164,28,-3188,-2289,16.4,1548.8,blue,4.5,0.85,42,18,blue
4422002181,10,4,13,0,0,0,0,18858,7,18627,195,77,2674,1630,19.5,1885.8,4,10,4,0,0,0,0,16184,6.4,16997,240,52,-2674,-1630,24,1618.4,red,5.75,0.8,29,15,blue
4477479713,10,3,8,1,1,0,0,18463,7.4,19599,248,40,3002,2125,24.8,1846.3,3,10,3,1,0,1,0,15461,6.8,17474,218,58,-3002,-2125,21.8,1546.1,blue,6,0.6,18,12,blue
4480020751,5,7,3,0,0,0,0,15286,6.6,16864,181,49,-1936,-646,18.1,1528.6,7,5,7,1,1,0,0,17222,7,17510,230,42,1936,646,23,1722.2,red,1.14,2.8,19,24,blue
4509961574,6,10,8,1,1,0,0,17088,6.8,18472,206,82,-2595,-574,20.6,1708.8,10,6,9,0,0,0,1,19683,7.4,19046,233,50,2595,574,23.3,1968.3,red,1.4,3.17,18,15,blue
4448333307,3,10,4,0,0,0,0,14674,6.4,15727,184,48,-5092,-4196,18.4,1467.4,10,3,5,0,0,0,1,19766,7.4,19923,240,48,5092,4196,24,1976.6,red,0.7,5,17,41,blue
4516589637,9,8,8,0,0,0,0,16676,7.2,18316,201,47,-978,-1076,20.1,1667.6,8,9,11,0,0,0,0,17654,7.4,19392,203,59,978,1076,20.3,1765.4,blue,2.12,2.11,15,33,red
4494107603,6,3,5,2,1,1,0,16843,7.2,19160,241,52,1597,1617,24.1,1684.3,3,6,5,0,0,0,0,15246,6.8,17543,231,42,-1597,-1617,23.1,1524.6,red,3.67,1.33,32,24,blue
4474739496,8,4,10,1,1,0,0,17640,7,18174,207,55,4035,3311,20.7,1764,4,8,9,0,0,0,0,13605,6,14863,155,40,-4035,-3311,15.5,1360.5,blue,4.5,1.62,20,54,blue
4524259924,7,7,9,1,0,1,0,16517,6.6,16968,182,50,473,446,18.2,1651.7,7,7,7,1,1,0,0,16044,6.6,16522,183,42,-473,-446,18.3,1604.4,red,2.29,2,22,20,blue
4524541241,9,1,12,1,0,1,1,18626,7.4,19683,205,38,5448,4419,20.5,1862.6,1,9,1,1,1,0,0,13178,6.4,15264,179,45,-5448,-4419,17.9,1317.8,blue,21,0.22,19,17,blue
4462131057,16,5,25,1,1,0,0,20996,7.2,19123,218,47,6476,4261,21.8,2099.6,5,16,8,0,0,0,0,14520,6.2,14862,147,41,-6476,-4261,14.7,1452,blue,8.2,0.81,22,16,blue
4513183319,5,3,4,0,0,0,0,16595,7.2,19727,220,59,1584,2449,22,1659.5,3,5,4,2,1,1,0,15011,6.8,17278,204,47,-1584,-2449,20.4,1501.1,blue,3,1.4,16,23,red
4478377067,6,8,4,1,0,1,0,16561,7,18103,239,54,-1637,-886,23.9,1656.1,8,6,7,1,1,0,0,18198,7.2,18989,240,57,1637,886,24,1819.8,red,1.25,2.5,21,45,red
4491128143,4,8,4,0,0,0,0,15676,7.2,19519,223,63,-2476,-394,22.3,1567.6,8,4,7,2,1,1,0,18152,7.4,19913,260,64,2476,394,26,1815.2,red,1,3.75,14,22,red
4494451554,7,5,9,1,1,0,0,16847,7,17670,209,43,505,-1017,20.9,1684.7,5,7,5,0,0,0,0,16342,7.2,18687,212,68,-505,1017,21.2,1634.2,blue,3.2,1.43,21,18,red
4516598704,4,5,1,0,0,0,0,14837,6.8,17198,205,52,-576,-1318,20.5,1483.7,5,4,8,1,1,0,0,15413,7.2,18516,172,60,576,1318,17.2,1541.3,blue,1,3.25,23,28,red
4505468000,4,7,4,0,0,0,0,15624,6.8,18203,229,58,-1647,-1866,22.9,1562.4,7,4,7,1,1,0,0,17271,7.4,20069,243,58,1647,1866,24.3,1727.1,red,1.14,3.5,17,22,red
4433044293,3,5,3,1,1,0,0,14587,6.8,16414,222,48,-2395,-2214,22.2,1458.7,5,3,6,1,0,1,0,16982,7,18628,254,60,2395,2214,25.4,1698.2,red,1.2,3.67,21,30,red
4516410666,4,7,7,1,0,1,0,15904,6.6,16786,232,47,-1067,-1598,23.2,1590.4,7,4,5,1,1,0,0,16971,7,18384,230,39,1067,1598,23,1697.1,red,1.57,3,23,21,blue
4450445125,0,5,0,1,0,1,0,14103,6.6,17162,230,66,-1977,-700,23,1410.3,5,0,4,0,0,0,0,16080,7,17862,224,54,1977,700,22.4,1608,red,0,12.65,16,16,red
4522483901,7,2,11,1,1,0,0,16685,7,18048,216,40,2306,1659,21.6,1668.5,2,7,2,0,0,0,0,14379,6.6,16389,208,44,-2306,-1659,20.8,1437.9,blue,9,0.57,21,22,blue
4502043539,5,5,7,1,1,0,0,16501,6.8,18178,234,50,366,84,23.4,1650.1,5,5,4,0,0,0,0,16135,6.8,18094,231,62,-366,-84,23.1,1613.5,blue,2.4,1.8,25,22,red
4486347504,4,4,6,1,0,1,0,15694,6.6,17103,248,40,567,-1018,24.8,1569.4,4,4,3,1,1,0,0,15127,7,18121,245,44,-567,1018,24.5,1512.7,red,2.5,1.75,22,22,blue
4488749710,7,6,4,1,1,0,0,16544,7,18907,247,47,272,1485,24.7,1654.4,6,7,6,0,0,0,0,16272,7,17422,221,54,-272,-1485,22.1,1627.2,blue,1.83,1.71,17,39,red
4503402454,11,8,15,0,0,0,0,18923,7,18843,225,68,1744,454,22.5,1892.3,8,11,7,1,0,1,0,17179,7,18389,219,48,-1744,-454,21.9,1717.9,red,3.25,1.36,21,18,blue
4476285396,3,7,2,0,0,0,0,14756,6.6,16229,226,48,-2175,-2386,22.6,1475.6,7,3,9,0,0,0,0,16931,7.2,18615,233,50,2175,2386,23.3,1693.1,red,0.71,5.33,18,18,blue
4499239181,4,14,5,1,0,1,0,14450,6.4,15560,186,48,-5976,-4619,18.6,1445,14,4,14,1,1,0,0,20426,7.4,20179,264,33,5976,4619,26.4,2042.6,blue,0.64,7,19,16,red
4477299853,3,3,4,0,0,0,0,15332,7,17832,229,55,359,-386,22.9,1533.2,3,3,0,1,1,0,0,14973,7,18218,242,48,-359,386,24.2,1497.3,blue,2.33,1,22,41,blue
4520840056,2,4,2,0,0,0,0,14026,6.8,17348,210,45,-2478,-1258,21,1402.6,4,2,7,0,0,0,0,16504,7.2,18606,244,66,2478,1258,24.4,1650.4,red,1,5.5,55,20,red
4515792807,7,6,7,0,0,0,0,16835,7,18378,220,52,700,814,22,1683.5,6,7,6,0,0,0,0,16135,7,17564,210,45,-700,-814,21,1613.5,red,2.33,1.71,17,17,blue
4516517025,7,5,4,0,0,0,0,17301,7.8,20766,241,67,1207,2244,24.1,1730.1,5,7,4,0,0,0,0,16094,7,18522,243,52,-1207,-2244,24.3,1609.4,blue,2.2,1.29,38,12,blue
4467606891,6,7,7,0,0,0,0,16489,7.2,17951,219,55,-592,-223,21.9,1648.9,7,6,9,2,1,1,0,17081,7,18174,227,52,592,223,22.7,1708.1,blue,1.86,2.67,17,17,red
4489529457,8,7,13,0,0,0,0,17212,7,17919,227,41,684,167,22.7,1721.2,7,8,6,0,0,0,0,16528,6.8,17752,199,55,-684,-167,19.9,1652.8,blue,3,1.62,22,16,blue
4502671483,5,9,7,2,1,1,0,15090,6.6,15998,176,56,-3684,-3135,17.6,1509,9,5,11,0,0,0,0,18774,7,19133,246,51,3684,3135,24.6,1877.4,red,1.33,4,16,16,blue
4519385513,2,4,2,0,0,0,0,14319,6.6,16364,219,51,-1272,-2335,21.9,1431.9,4,2,1,0,0,0,0,15591,7.2,18699,236,48,1272,2335,23.6,1559.1,red,1,2.5,13,13,red
4489533788,5,4,6,0,0,0,0,16721,7,18046,237,53,1788,2424,23.7,1672.1,4,5,6,0,0,0,0,14933,6.4,15622,210,42,-1788,-2424,21,1493.3,blue,2.75,2,18,17,red
4517834101,4,12,1,0,0,0,0,15089,6.6,17098,235,53,-5292,-4004,23.5,1508.9,12,4,14,1,1,0,1,20381,7.6,21102,234,63,5292,4004,23.4,2038.1,red,0.42,6.5,17,18,blue
4514486650,4,7,7,0,0,0,0,15662,6.8,17214,202,42,-130,-624,20.2,1566.2,7,4,9,1,1,0,0,15792,6.8,17838,200,35,130,624,20,1579.2,blue,1.57,4,17,19,blue
4512554804,5,9,5,0,0,0,0,15463,6.6,16939,206,44,-2791,-2246,20.6,1546.3,9,5,13,1,1,0,0,18254,7.4,19185,227,57,2791,2246,22.7,1825.4,red,1.11,4.4,19,19,red
4452269008,7,12,12,0,0,0,0,16880,7,17307,216,43,-2125,-3115,21.6,1688,12,7,12,1,0,1,0,19005,7.4,20422,221,33,2125,3115,22.1,1900.5,red,1.58,3.43,11,15,blue
4522521968,5,2,3,2,1,1,0,15216,7.2,18894,216,53,-101,-556,21.6,1521.6,2,5,0,0,0,0,0,15317,7.2,19450,248,68,101,556,24.8,1531.7,blue,4,0.4,14,15,red
4458560813,10,7,13,0,0,0,0,17674,7,18595,209,48,1269,788,20.9,1767.4,7,10,6,0,0,0,0,16405,7,17807,205,32,-1269,-788,20.5,1640.5,blue,3.29,1.3,20,13,blue
4524198218,5,6,5,1,1,0,0,16533,6.6,17396,231,43,251,-340,23.1,1653.3,6,5,6,0,0,0,0,16282,7,17736,217,61,-251,340,21.7,1628.2,red,1.67,2.4,21,47,blue
4521761275,4,12,3,0,0,0,0,15716,6.8,16980,225,39,-3446,-3817,22.5,1571.6,12,4,10,2,1,1,0,19162,7.8,20797,239,59,3446,3817,23.9,1916.2,blue,0.58,5.5,18,15,red
4511226212,6,4,6,0,0,0,0,17631,7,18398,261,53,2803,2471,26.1,1763.1,4,6,7,1,0,1,0,14828,6.6,15927,188,46,-2803,-2471,18.8,1482.8,blue,3,1.83,36,23,blue
4423083360,3,5,2,0,0,0,0,15148,7,18263,213,50,-1416,63,21.3,1514.8,5,3,8,1,1,0,0,16564,7,18200,230,67,1416,-63,23,1656.4,red,1,4.33,16,17,red
4466248745,3,7,3,0,0,0,0,14649,6.8,17099,186,52,-2588,-884,18.6,1464.9,7,3,9,1,1,0,0,17237,7,17983,246,36,2588,884,24.6,1723.7,red,0.86,5.33,135,23,red
4469830896,6,7,7,1,1,0,0,16517,6.8,16913,238,44,-409,-2098,23.8,1651.7,7,6,7,1,0,1,0,16926,7,19011,254,44,409,2098,25.4,1692.6,red,1.86,2.33,22,22,red
4516145589,9,9,11,0,0,0,0,18026,7,18214,211,56,894,639,21.1,1802.6,9,9,8,0,0,0,0,17132,6.8,17575,195,47,-894,-639,19.5,1713.2,blue,2.22,1.89,16,14,red
4513579989,7,10,3,0,0,0,0,16399,7,18258,214,44,-1977,-944,21.4,1639.9,10,7,9,0,0,0,0,18376,7.2,19202,231,55,1977,944,23.1,1837.6,red,1,2.71,34,17,blue
4483693148,13,5,15,1,0,1,0,18959,6.8,18151,186,56,2316,1298,18.6,1895.9,5,13,4,1,1,0,0,16643,6.6,16853,219,40,-2316,-1298,21.9,1664.3,blue,5.6,0.69,25,21,blue
4517942956,2,6,0,0,0,0,0,13888,6.4,15518,172,52,-3220,-4094,17.2,1388.8,6,2,6,1,0,1,0,17108,7.4,19612,242,52,3220,4094,24.2,1710.8,red,0.33,6,54,17,red
4521180188,3,3,2,1,1,0,0,15188,7,17748,236,57,52,1036,23.6,1518.8,3,3,3,0,0,0,0,15136,6.6,16712,214,55,-52,-1036,21.4,1513.6,blue,1.67,2,15,15,red
4485702614,2,4,0,0,0,0,0,14395,6.6,17060,210,43,-1386,-335,21,1439.5,4,2,6,0,0,0,0,15781,6.8,17395,211,60,1386,335,21.1,1578.1,red,0.5,5,12,17,red
4524823620,8,5,13,0,0,0,0,17663,6.8,18440,202,60,1942,890,20.2,1766.3,5,8,3,1,0,1,0,15721,6.8,17550,205,58,-1942,-890,20.5,1572.1,red,4.2,1,56,41,blue
4492333957,9,5,7,1,0,1,0,18348,7.2,19545,216,62,3111,2739,21.6,1834.8,5,9,4,1,1,0,0,15237,6.8,16806,202,51,-3111,-2739,20.2,1523.7,blue,3.2,1,15,13,blue
4501213837,2,5,2,0,0,0,0,13337,6.4,15472,197,43,-4427,-3299,19.7,1333.7,5,2,5,1,1,0,1,17764,7.2,18771,236,48,4427,3299,23.6,1776.4,blue,0.8,5,23,21,red
4522640075,8,4,11,0,0,0,0,17064,7,18586,207,42,1183,1036,20.7,1706.4,4,8,2,1,0,1,0,15881,7,17550,217,54,-1183,-1036,21.7,1588.1,blue,4.75,0.75,59,19,blue
4513734399,13,1,8,2,1,1,0,18595,7.6,21025,237,60,5236,5547,23.7,1859.5,1,13,1,0,0,0,0,13359,6.6,15478,199,52,-5236,-5547,19.9,1335.9,blue,21,0.15,21,14,blue
4464180700,2,4,2,0,0,0,0,15096,7,17840,228,48,-915,-1035,22.8,1509.6,4,2,4,0,0,0,0,16011,7.2,18875,239,65,915,1035,23.9,1601.1,red,1,4,19,36,red
4520900550,8,4,3,0,0,0,0,17743,7.6,20843,247,56,2507,3436,24.7,1774.3,4,8,5,0,0,0,0,15236,6.8,17407,186,67,-2507,-3436,18.6,1523.6,blue,2.75,1.12,44,14,red
4424690853,7,8,6,0,0,0,0,17088,7.2,18459,219,40,-788,151,21.9,1708.8,8,7,5,2,1,1,0,17876,7.2,18308,226,64,788,-151,22.6,1787.6,blue,1.62,1.86,14,15,blue
4504218581,8,3,10,1,1,0,0,17810,7.6,19743,248,57,3866,3496,24.8,1781,3,8,1,0,0,0,0,13944,6.4,16247,191,41,-3866,-3496,19.1,1394.4,blue,6,0.5,19,20,red
4422174919,0,3,0,0,0,0,0,13954,6.8,17057,231,60,-936,-624,23.1,1395.4,3,0,3,0,0,0,0,14890,7,17681,199,47,936,624,19.9,1489,blue,0,12.65,16,20,red
4514595222,5,5,4,0,0,0,0,16300,7.2,19402,244,45,955,1833,24.4,1630,5,5,3,1,1,0,0,15345,7,17569,192,63,-955,-1833,19.2,1534.5,blue,1.8,1.6,15,17,blue
4471458377,5,9,7,1,0,1,0,16096,7,17359,224,45,-581,146,22.4,1609.6,9,5,8,0,0,0,0,16677,6.8,17213,204,43,581,-146,20.4,1667.7,red,1.33,3.4,20,18,red
4523361669,5,10,6,1,1,0,0,16331,6.6,16667,220,51,-2814,-2623,22,1633.1,10,5,10,1,0,1,0,19145,7,19290,220,64,2814,2623,22,1914.5,red,1.1,4,19,17,blue
4522408229,5,2,4,2,1,1,0,16515,7.2,18870,257,54,1967,1068,25.7,1651.5,2,5,3,0,0,0,0,14548,7,17802,233,48,-1967,-1068,23.3,1454.8,blue,4.5,1,29,19,blue
4464898838,5,3,7,1,1,0,0,16860,7,18682,264,45,1245,686,26.4,1686,3,5,2,0,0,0,0,15615,7,17996,248,63,-1245,-686,24.8,1561.5,blue,4,1,17,17,red
4509176495,8,6,11,0,0,0,0,16870,6.6,16180,212,44,829,-929,21.2,1687,6,8,5,1,1,0,0,16041,6.6,17109,245,46,-829,929,24.5,1604.1,blue,3.17,1.38,21,24,blue
4522565095,4,4,5,0,0,0,0,17001,7.2,19717,242,61,759,467,24.2,1700.1,4,4,4,0,0,0,0,16242,7.2,19250,242,63,-759,-467,24.2,1624.2,blue,2.25,2,147,13,red
4524987939,2,0,3,0,0,0,0,14112,6.6,16664,223,30,-174,-35,22.3,1411.2,0,2,0,0,0,0,0,14286,6.6,16699,226,44,174,35,22.6,1428.6,red,12.03,0,20,22,blue
4514375184,2,6,2,1,1,0,0,15300,7,18001,266,53,-978,-849,26.6,1530,6,2,8,0,0,0,0,16278,7,18850,228,48,978,849,22.8,1627.8,red,0.67,7,18,19,red
4482060310,12,7,14,1,1,0,0,19276,7.2,19221,192,49,1801,2218,19.2,1927.6,7,12,8,0,0,0,0,17475,6.8,17003,217,36,-1801,-2218,21.7,1747.5,blue,3.71,1.25,16,15,blue
4453451524,4,7,9,0,0,0,0,15766,6.6,16789,220,48,-1590,-780,22,1576.6,7,4,11,1,1,0,0,17356,6.8,17569,235,52,1590,780,23.5,1735.6,red,1.86,4.5,43,27,blue
4524313607,5,6,8,0,0,0,0,15292,7,18345,187,54,-1805,-504,18.7,1529.2,6,5,10,1,1,0,0,17097,7,18849,241,64,1805,504,24.1,1709.7,red,2.17,3.2,17,21,blue
4496666783,2,5,1,0,0,0,0,14321,6.4,16217,203,44,-1296,-382,20.3,1432.1,5,2,5,1,1,0,0,15617,6.6,16599,226,38,1296,382,22.6,1561.7,red,0.6,5,21,24,blue
4521738379,6,9,12,0,0,0,0,16492,6.8,17944,220,47,-2847,-1355,22,1649.2,9,6,19,2,1,1,1,19339,7.4,19299,237,56,2847,1355,23.7,1933.9,red,2,4.67,22,55,blue
4515360934,8,6,12,1,1,0,0,17357,7,18244,222,48,1031,829,22.2,1735.7,6,8,10,1,0,1,0,16326,6.8,17415,208,36,-1031,-829,20.8,1632.6,blue,3.33,2,21,18,blue
4523068709,5,4,6,0,0,0,1,17519,6.8,17307,215,46,1953,135,21.5,1751.9,4,5,6,0,0,0,0,15566,6.6,17172,215,48,-1953,-135,21.5,1556.6,blue,2.75,2,39,17,blue
4405265632,4,4,5,0,0,0,0,16139,6.8,17770,245,46,690,444,24.5,1613.9,4,4,7,1,1,0,0,15449,6.8,17326,206,52,-690,-444,20.6,1544.9,blue,2.25,2.75,18,25,blue
4521497074,7,10,7,1,1,0,0,17088,7,18568,201,60,-793,606,20.1,1708.8,10,7,9,0,0,0,0,17881,7,17962,221,48,793,-606,22.1,1788.1,red,1.4,2.71,31,17,red
4465328371,6,3,6,1,1,0,0,15609,6.8,18083,180,67,661,735,18,1560.9,3,6,2,0,0,0,0,14948,6.6,17348,199,52,-661,-735,19.9,1494.8,blue,4,0.83,17,15,red
4507022630,8,4,10,1,0,1,1,18913,7.4,19182,225,60,3240,1787,22.5,1891.3,4,8,6,1,1,0,0,15673,6.8,17395,237,48,-3240,-1787,23.7,1567.3,red,4.5,1.25,15,23,blue
4518246316,9,6,12,1,1,0,0,18054,7.2,18465,241,52,1859,1271,24.1,1805.4,6,9,11,0,0,0,0,16195,6.8,17194,197,55,-1859,-1271,19.7,1619.5,blue,3.5,1.89,17,39,red
4514424102,6,3,5,1,1,0,0,15690,6.8,17299,214,44,903,1110,21.4,1569,3,6,3,0,0,0,0,14787,6.8,16189,199,52,-903,-1110,19.9,1478.7,blue,3.67,1,18,15,red
4518841183,4,4,2,0,0,0,0,16003,6.8,17739,226,56,353,-160,22.6,1600.3,4,4,5,1,1,0,0,15650,6.8,17899,209,59,-353,160,20.9,1565,red,1.5,2.25,16,16,blue
4516498052,9,9,10,0,0,0,1,18181,6.6,17078,202,36,1520,1110,20.2,1818.1,9,9,14,0,0,0,0,16661,6.6,15968,165,31,-1520,-1110,16.5,1666.1,blue,2.11,2.56,18,41,red
4427765980,5,6,7,0,0,0,0,15628,7,17683,221,49,-623,-39,22.1,1562.8,6,5,6,1,1,0,0,16251,6.8,17722,223,42,623,39,22.3,1625.1,red,2,2.4,43,23,red
4522338747,11,5,12,1,1,0,0,18093,6.8,17986,211,48,2025,-460,21.1,1809.3,5,11,3,0,0,0,0,16068,6.8,18446,199,52,-2025,460,19.9,1606.8,blue,4.6,0.73,30,15,blue
4506917789,4,4,4,1,0,1,0,15607,7,18678,215,57,-315,718,21.5,1560.7,4,4,3,1,1,0,0,15922,6.8,17960,246,62,315,-718,24.6,1592.2,blue,2,1.75,16,21,red
4439770963,3,5,2,1,1,0,0,15164,6.8,17404,218,51,-1592,-2199,21.8,1516.4,5,3,5,0,0,0,0,16756,7.2,19603,255,52,1592,2199,25.5,1675.6,blue,1,3.33,19,12,blue
4467345105,9,8,5,0,0,0,0,18090,7,18948,238,43,736,-349,23.8,1809,8,9,9,0,0,0,0,17354,7.4,19297,213,59,-736,349,21.3,1735.4,red,1.75,1.89,23,21,red
4465110023,6,1,5,1,1,0,0,17001,7,18549,240,49,3156,1621,24,1700.1,1,6,2,0,0,0,0,13845,6.8,16928,206,47,-3156,-1621,20.6,1384.5,blue,11,0.5,17,16,blue
4522649114,5,2,9,0,0,0,0,15904,7,17670,213,48,1085,-556,21.3,1590.4,2,5,1,0,0,0,0,14819,6.8,18226,229,64,-1085,556,22.9,1481.9,blue,7,0.6,28,22,blue
4505443284,11,4,16,1,0,1,0,18215,7.2,19165,239,47,3672,4732,23.9,1821.5,4,11,6,1,1,0,0,14543,6.2,14433,183,59,-3672,-4732,18.3,1454.3,blue,6.75,0.91,32,20,red
4499995940,5,6,3,0,0,0,0,16177,7,18401,216,60,-126,463,21.6,1617.7,6,5,6,2,1,1,0,16303,6.6,17938,215,58,126,-463,21.5,1630.3,blue,1.33,2.4,19,20,red
4495892893,5,9,5,1,1,0,1,17087,6.8,17225,206,44,-988,-1321,20.6,1708.7,9,5,8,1,0,1,1,18075,7.2,18546,201,39,988,1321,20.1,1807.5,red,1.11,3.4,21,62,red
4524282736,6,5,5,1,0,1,0,16594,7,18973,224,50,466,933,22.4,1659.4,5,6,8,1,1,0,0,16128,7,18040,233,52,-466,-933,23.3,1612.8,blue,2.2,2.17,17,44,blue
4475253617,2,4,1,0,0,0,0,15101,7,18673,241,64,-1443,-269,24.1,1510.1,4,2,5,1,1,0,0,16544,7,18942,217,68,1443,269,21.7,1654.4,red,0.75,4.5,40,45,blue
4520039932,5,5,4,1,1,0,0,15787,6.8,17255,209,63,833,383,20.9,1578.7,5,5,10,0,0,0,0,14954,6.6,16872,179,36,-833,-383,17.9,1495.4,blue,1.8,3,27,45,red
4479148881,4,5,3,1,1,0,0,15936,7,18164,255,56,-189,-709,25.5,1593.6,5,4,4,0,0,0,0,16125,7.4,18873,252,44,189,709,25.2,1612.5,blue,1.4,2.25,22,19,blue
4521490915,3,4,6,0,0,0,0,15608,7.2,18584,234,60,-233,20,23.4,1560.8,4,3,4,2,1,1,0,15841,7.2,18564,240,57,233,-20,24,1584.1,red,2.25,2.67,19,16,red
4452414330,7,8,4,0,0,0,0,17226,7,19315,226,58,-193,548,22.6,1722.6,8,7,7,1,1,0,0,17419,7.2,18767,223,48,193,-548,22.3,1741.9,blue,1.38,2.14,13,21,blue
4505938604,8,9,6,0,0,0,0,16972,7.2,19143,198,64,-1832,-386,19.8,1697.2,9,8,10,1,1,0,0,18804,7.4,19529,230,60,1832,386,23,1880.4,red,1.56,2.38,17,38,red
4523349823,6,6,6,1,0,1,0,16421,7.4,19037,224,50,961,849,22.4,1642.1,6,6,4,0,0,0,0,15460,7,18188,194,48,-961,-849,19.4,1546,blue,2,1.67,14,18,red
4519268347,2,3,3,1,0,1,1,16664,6.8,18036,255,55,1047,-143,25.5,1666.4,3,2,4,1,1,0,0,15617,7,18179,247,54,-1047,143,24.7,1561.7,red,1.67,3.5,14,17,red
4520614992,4,12,4,0,0,0,0,14920,6.8,17398,186,57,-6000,-3856,18.6,1492,12,4,15,1,1,0,0,20920,7.6,21254,246,60,6000,3856,24.6,2092,red,0.67,6.75,16,20,red
4503114747,9,5,7,1,1,0,0,18227,7.4,19733,248,56,3036,3251,24.8,1822.7,5,9,3,0,0,0,0,15191,6.6,16482,173,44,-3036,-3251,17.3,1519.1,red,3.2,0.89,146,17,red
4525105080,16,4,21,0,0,0,0,19885,7,18684,177,33,5422,3259,17.7,1988.5,4,16,4,1,1,0,0,14463,6.4,15425,182,32,-5422,-3259,18.2,1446.3,blue,9.25,0.5,23,18,blue
4515342462,7,11,7,0,0,0,0,15225,6.4,16334,180,40,-3230,-3243,18,1522.5,11,7,7,1,1,0,0,18455,7.2,19577,227,52,3230,3243,22.7,1845.5,red,1.27,2.57,16,20,red
4518772653,3,7,5,1,1,0,0,15070,6.8,18012,217,50,-2692,-1151,21.7,1507,7,3,14,0,0,0,0,17762,7.6,19163,225,52,2692,1151,22.5,1776.2,red,1.14,7,18,18,red
4521931000,6,8,3,1,1,0,0,16425,7,18433,232,39,-336,-124,23.2,1642.5,8,6,6,0,0,0,0,16761,7.2,18557,197,47,336,124,19.7,1676.1,red,1.12,2.33,18,16,red
4510216676,7,5,10,0,0,0,0,17168,7,17989,233,52,1089,196,23.3,1716.8,5,7,4,1,1,0,0,16079,6.8,17793,235,52,-1089,-196,23.5,1607.9,blue,3.4,1.29,18,18,blue
4524358757,9,8,12,1,1,0,0,17822,7,18329,209,44,-775,687,20.9,1782.2,8,9,8,0,0,0,1,18597,6.6,17642,219,44,775,-687,21.9,1859.7,blue,2.62,1.78,86,17,red
4511106120,1,8,2,0,0,0,0,14055,6.6,16334,208,55,-4331,-2588,20.8,1405.5,8,1,10,1,1,0,0,18386,7.2,18922,226,56,4331,2588,22.6,1838.6,red,0.38,18,18,47,red
4521200467,5,7,6,1,1,0,0,16213,6.6,17532,208,48,-916,483,20.8,1621.3,7,5,12,0,0,0,0,17129,7,17049,215,56,916,-483,21.5,1712.9,red,1.57,3.8,18,13,red
4432479644,6,12,4,0,0,0,0,16337,7,16985,202,52,-2529,-2091,20.2,1633.7,12,6,15,1,1,0,0,18866,7.2,19076,214,48,2529,2091,21.4,1886.6,red,0.83,4.5,14,40,red
4511816090,2,2,3,1,0,1,0,15736,7,18218,234,60,705,-208,23.4,1573.6,2,2,2,1,1,0,0,15031,7,18426,250,59,-705,208,25,1503.1,red,2.5,2,19,17,blue
4441400812,4,4,3,1,0,1,1,16790,6.8,18508,242,45,1814,619,24.2,1679,4,4,5,1,1,0,0,14976,6.8,17889,185,47,-1814,-619,18.5,1497.6,blue,1.75,2.25,19,23,red
4509325423,3,5,5,1,1,0,0,16091,6.6,17434,230,54,-1053,-1363,23,1609.1,5,3,5,0,0,0,0,17144,7,18797,248,47,1053,1363,24.8,1714.4,red,1.6,3.33,29,24,blue
4500668371,2,9,3,0,0,0,0,14433,6.4,15908,210,42,-4395,-4086,21,1443.3,9,2,9,2,1,1,1,18828,7.4,19994,219,63,4395,4086,21.9,1882.8,red,0.56,9,16,21,red
4519714045,7,2,4,0,0,0,0,17389,7,18966,237,52,3129,1416,23.7,1738.9,2,7,1,1,1,0,0,14260,6.8,17550,203,60,-3129,-1416,20.3,1426,blue,5.5,0.43,15,14,blue
4470842371,2,9,2,1,0,1,0,14475,6.6,16283,205,64,-4666,-3086,20.5,1447.5,9,2,9,1,1,0,1,19141,7.2,19369,224,58,4666,3086,22.4,1914.1,red,0.44,9,16,18,red
4513277280,1,3,1,1,0,1,0,15373,7,18233,264,80,599,754,26.4,1537.3,3,1,3,0,0,0,0,14774,6.8,17479,212,48,-599,-754,21.2,1477.4,red,0.67,6,40,46,red
4515518787,3,7,3,0,0,0,0,14381,6.6,16919,202,41,-2528,-993,20.2,1438.1,7,3,10,1,1,0,0,16909,6.8,17912,196,51,2528,993,19.6,1690.9,red,0.86,5.67,11,14,red
4524043423,8,7,5,0,0,0,0,17975,7.2,18967,248,51,1283,518,24.8,1797.5,7,8,2,1,1,0,0,16692,7,18449,217,68,-1283,-518,21.7,1669.2,blue,1.86,1.12,14,16,blue
4445985804,7,2,8,1,1,0,0,17459,7.2,19021,231,64,2929,1296,23.1,1745.9,2,7,2,0,0,0,0,14530,7,17725,191,64,-2929,-1296,19.1,1453,blue,7.5,0.57,23,16,blue
4459570157,6,7,8,1,0,1,1,19056,7.4,19650,232,72,2638,2423,23.2,1905.6,7,6,12,0,0,0,0,16418,6.8,17227,204,37,-2638,-2423,20.4,1641.8,blue,2,3.17,16,17,blue
4522848793,2,8,2,0,0,0,0,14117,6.6,16799,199,44,-4158,-3452,19.9,1411.7,8,2,7,2,1,1,0,18275,7.4,20251,248,56,4158,3452,24.8,1827.5,red,0.5,7.5,21,18,red
4481684110,6,7,12,1,0,1,0,17191,6.8,17872,227,45,-355,-1775,22.7,1719.1,7,6,8,0,0,0,0,17546,7.2,19647,204,64,355,1775,20.4,1754.6,red,2.57,2.5,18,13,blue
4513438195,9,4,11,1,1,0,0,18585,7.2,18660,216,51,3161,2079,21.6,1858.5,4,9,4,0,0,0,0,15424,6.8,16581,185,68,-3161,-2079,18.5,1542.4,blue,5,0.89,16,15,blue
4453399746,11,4,4,2,1,1,0,18271,7.2,20332,224,48,2875,3178,22.4,1827.1,4,11,4,0,0,0,0,15396,6.8,17154,213,56,-2875,-3178,21.3,1539.6,blue,3.75,0.73,19,14,blue
4492722693,8,5,8,0,0,0,0,17953,6.8,18196,218,59,3363,2997,21.8,1795.3,5,8,9,1,1,0,0,14590,6.4,15199,176,43,-3363,-2997,17.6,1459,blue,3.2,1.75,14,15,blue
4459114610,6,4,8,1,1,0,0,15645,6.8,17261,184,47,6,1023,18.4,1564.5,4,6,3,1,0,1,0,15639,6.6,16238,230,42,-6,-1023,23,1563.9,red,3.5,1.17,30,20,blue
4472293510,1,4,1,0,0,0,0,14588,6.8,17460,241,45,-2574,-404,24.1,1458.8,4,1,6,0,0,0,1,17162,6.8,17864,222,47,2574,404,22.2,1716.2,red,0.5,10,15,14,red
4520411490,4,5,7,0,0,0,0,16152,7,17881,260,44,-428,-432,26,1615.2,5,4,7,2,1,1,0,16580,7.2,18313,238,56,428,432,23.8,1658,blue,2.2,3,18,20,red
4510541398,8,2,5,1,1,0,0,17030,6.8,18285,212,47,1866,80,21.2,1703,2,8,2,0,0,0,0,15164,7.2,18205,246,57,-1866,-80,24.6,1516.4,blue,6.5,0.5,17,20,blue
4457247520,15,10,9,1,0,1,0,19204,7.6,20520,215,54,1902,3370,21.5,1920.4,10,15,12,0,0,0,0,17302,6.8,17150,183,27,-1902,-3370,18.3,1730.2,blue,2.4,1.47,124,17,blue
4488648117,4,5,3,0,0,0,0,14925,7,18636,218,49,-1375,-850,21.8,1492.5,5,4,4,1,1,0,0,16300,7.6,19486,220,76,1375,850,22,1630,red,1.4,2.25,29,23,red
4518422789,8,3,9,2,1,1,0,17561,7.2,19417,222,49,2585,3290,22.2,1756.1,3,8,4,0,0,0,0,14976,6.4,16127,222,43,-2585,-3290,22.2,1497.6,blue,5.67,0.88,20,22,red
4426682867,4,8,7,0,0,0,0,15049,6.6,16534,211,47,-2353,-2050,21.1,1504.9,8,4,7,2,1,1,0,17402,7,18584,235,44,2353,2050,23.5,1740.2,red,1.38,3.75,24,38,red
4517499041,3,4,4,1,1,0,0,15523,7,18159,233,60,-279,-411,23.3,1552.3,4,3,6,0,0,0,0,15802,7.2,18570,247,52,279,411,24.7,1580.2,red,1.75,3.33,15,14,blue
4496882538,2,11,2,0,0,0,0,14910,6.8,16907,227,56,-2917,-2806,22.7,1491,11,2,4,2,1,1,0,17827,7,19713,216,53,2917,2806,21.6,1782.7,red,0.36,7.5,14,17,red
4519072442,5,14,4,0,0,0,0,15787,6.6,15849,200,40,-3783,-3300,20,1578.7,14,5,12,1,1,0,0,19570,7.2,19149,201,61,3783,3300,20.1,1957,red,0.64,5.2,14,34,blue
4511135816,5,5,4,0,0,0,0,16840,7.2,19282,264,53,-103,859,26.4,1684,5,5,3,2,1,1,1,16943,7,18423,219,48,103,-859,21.9,1694.3,red,1.8,1.6,15,19,red
4513953505,2,2,2,1,1,0,0,14541,6.8,18354,240,48,-1345,-621,24,1454.1,2,2,2,0,0,0,0,15886,7.2,18975,260,61,1345,621,26,1588.6,blue,2,2,31,17,red
4516839645,6,8,6,0,0,0,0,16273,7,17751,193,55,-1115,-883,19.3,1627.3,8,6,7,1,1,0,0,17388,7.2,18634,208,72,1115,883,20.8,1738.8,blue,1.5,2.5,17,20,blue
4517169650,2,5,5,0,0,0,0,14531,6.8,16999,222,56,-1711,-2183,22.2,1453.1,5,2,5,1,1,0,0,16242,7.2,19182,235,52,1711,2183,23.5,1624.2,red,1.4,5,29,19,red
4478166027,9,5,10,0,0,0,0,17413,7,17940,229,25,1221,-172,22.9,1741.3,5,9,7,0,0,0,0,16192,7,18112,213,67,-1221,172,21.3,1619.2,blue,3.8,1.33,51,15,blue
4511093393,3,9,3,0,0,0,0,15622,6.8,17546,246,50,-2461,-1626,24.6,1562.2,9,3,10,1,1,0,0,18083,7.2,19172,228,48,2461,1626,22.8,1808.3,red,0.67,6.33,39,19,red
4519770095,10,10,11,2,1,1,1,19556,7.2,18530,198,53,2100,1556,19.8,1955.6,10,10,11,0,0,0,0,17456,6.8,16974,189,47,-2100,-1556,18.9,1745.6,red,2.1,2.1,11,18,blue
4518322850,6,7,5,0,0,0,0,16797,7,18636,213,65,823,2681,21.3,1679.7,7,6,11,1,0,1,0,15974,6.4,15955,158,44,-823,-2681,15.8,1597.4,red,1.57,3,19,16,blue
4513928992,5,7,10,1,0,1,0,15735,6.6,17073,225,47,-488,-237,22.5,1573.5,7,5,8,1,1,0,0,16223,6.8,17310,200,48,488,237,20,1622.3,red,2.14,3,19,22,red
4513293548,13,7,15,1,1,0,0,18570,7.2,19063,206,51,2093,2151,20.6,1857,7,13,11,0,0,0,0,16477,6.6,16912,212,42,-2093,-2151,21.2,1647.7,blue,4,1.38,24,17,blue
4521046337,8,3,8,0,0,0,0,17849,7,18536,227,40,3364,2412,22.7,1784.9,3,8,2,1,1,0,0,14485,6.4,16124,223,49,-3364,-2412,22.3,1448.5,blue,5.33,0.62,19,16,blue
4513125079,11,6,16,1,1,0,0,19364,7.4,19292,232,49,3356,2257,23.2,1936.4,6,11,9,0,0,0,0,16008,6.8,17035,198,41,-3356,-2257,19.8,1600.8,blue,4.5,1.36,21,21,blue
4517761831,9,4,7,0,0,0,0,17047,7.2,19134,226,57,1992,2548,22.6,1704.7,4,9,4,1,1,0,0,15055,6.6,16586,225,44,-1992,-2548,22.5,1505.5,blue,4,0.89,16,15,red
4513550456,5,9,4,0,0,0,0,16105,7,17701,237,52,-1198,-833,23.7,1610.5,9,5,8,1,0,1,0,17303,7.2,18534,230,40,1198,833,23,1730.3,red,1,3.4,22,23,blue
4481845799,5,9,5,0,0,0,0,15611,7,17672,222,44,-2415,-2092,22.2,1561.1,9,5,10,1,1,0,0,18026,7.2,19764,231,56,2415,2092,23.1,1802.6,red,1.11,3.8,16,13,red
4494815274,12,6,12,0,0,0,0,18766,7.2,20059,231,45,2265,2656,23.1,1876.6,6,12,6,0,0,0,0,16501,6.8,17403,225,48,-2265,-2656,22.5,1650.1,blue,4,1,12,24,blue
4505931030,7,4,6,1,1,0,0,17590,7.2,19299,231,56,2708,1906,23.1,1759,4,7,3,1,0,1,0,14882,6.6,17393,223,37,-2708,-1906,22.3,1488.2,blue,3.25,1,19,109,blue
4522772427,6,10,3,1,0,1,0,15222,6.4,16160,192,38,-2558,-2878,19.2,1522.2,10,6,15,1,1,0,0,17780,7.2,19038,205,49,2558,2878,20.5,1778,red,0.9,4.17,20,63,blue
4510804992,3,4,1,0,0,0,0,15537,7.2,18116,239,56,-294,-531,23.9,1553.7,4,3,4,1,0,1,0,15831,7.2,18647,244,48,294,531,24.4,1583.1,red,1,2.67,22,20,red
4518577355,10,5,9,1,1,0,0,19265,7.4,20085,244,75,4692,3644,24.4,1926.5,5,10,0,0,0,0,0,14573,6.6,16441,221,28,-4692,-3644,22.1,1457.3,blue,3.8,0.5,18,17,blue
4518324139,2,3,2,1,1,0,0,14746,7,17859,237,56,-1222,-815,23.7,1474.6,3,2,2,0,0,0,0,15968,7.2,18674,246,44,1222,815,24.6,1596.8,red,1.33,2.5,24,20,red
4479045303,4,7,7,1,1,0,0,15261,6.8,15935,227,40,-1107,-2894,22.7,1526.1,7,4,4,0,0,0,0,16368,7.2,18829,224,68,1107,2894,22.4,1636.8,blue,1.57,2.75,17,17,red
4487273871,2,6,0,0,0,0,0,13465,6.2,15462,191,43,-3179,-937,19.1,1346.5,6,2,6,1,1,0,0,16644,6.6,16399,226,43,3179,937,22.6,1664.4,red,0.33,6,18,17,red
4523365971,16,5,7,1,0,1,0,20310,7.4,20225,230,60,5565,5067,23,2031,5,16,3,1,1,0,0,14745,6.2,15158,169,46,-5565,-5067,16.9,1474.5,blue,4.6,0.5,11,82,blue
4496715260,7,4,10,0,0,0,0,17527,7,18186,227,56,1863,464,22.7,1752.7,4,7,6,1,1,0,0,15664,7,17722,231,48,-1863,-464,23.1,1566.4,blue,4.25,1.43,16,20,blue
4465317385,7,13,7,0,0,0,0,15061,6.2,15124,183,31,-4179,-4531,18.3,1506.1,13,7,8,1,0,1,0,19240,7.2,19655,236,52,4179,4531,23.6,1924,red,1.08,3,19,18,blue
4489876149,7,9,7,1,1,0,0,16765,7.2,18366,213,57,-923,-229,21.3,1676.5,9,7,8,0,0,0,0,17688,7,18595,214,38,923,229,21.4,1768.8,blue,1.56,2.43,49,11,blue
4523715592,4,7,4,0,0,0,0,15018,6.6,17474,200,50,-1910,-1781,20,1501.8,7,4,6,0,0,0,0,16928,7.2,19255,227,43,1910,1781,22.7,1692.8,red,1.14,3.25,16,38,red
4505476862,9,3,9,0,0,0,0,18205,7.4,19871,225,48,4061,3186,22.5,1820.5,3,9,2,1,0,1,0,14144,6.6,16685,187,39,-4061,-3186,18.7,1414.4,blue,6,0.56,36,12,blue
4465999094,5,3,6,0,0,0,0,15284,6.6,16690,187,51,-480,-607,18.7,1528.4,3,5,3,1,1,0,0,15764,6.6,17297,230,60,480,607,23,1576.4,blue,3.67,1.2,13,16,blue
4467191022,3,6,4,1,1,0,0,15026,6.4,16386,202,52,-2243,-3667,20.2,1502.6,6,3,8,0,0,0,0,17269,7.6,20053,229,75,2243,3667,22.9,1726.9,red,1.17,4.67,25,42,blue
4524493753,5,3,5,0,0,0,0,15827,6.8,17668,212,52,443,-1437,21.2,1582.7,3,5,4,1,1,0,0,15384,7.2,19105,232,59,-443,1437,23.2,1538.4,red,3.33,1.4,17,39,blue
4511896350,6,4,8,0,0,0,0,16463,7.2,18961,221,60,354,816,22.1,1646.3,4,6,1,0,0,0,0,16109,7,18145,225,48,-354,-816,22.5,1610.9,blue,3.5,0.83,37,16,red
4522843315,9,8,7,0,0,0,0,16908,6.8,17271,196,31,-363,-191,19.6,1690.8,8,9,9,1,1,0,0,17271,6.8,17462,187,68,363,191,18.7,1727.1,blue,2,1.89,18,42,blue
4470854778,6,3,5,1,0,1,1,18017,7.2,18923,228,68,2459,834,22.8,1801.7,3,6,3,1,1,0,0,15558,6.8,18089,220,51,-2459,-834,22,1555.8,red,3.67,1,25,20,red
4462225313,4,3,2,1,1,0,0,15257,6.8,18061,221,44,-216,882,22.1,1525.7,3,4,3,0,0,0,0,15473,6.6,17179,244,53,216,-882,24.4,1547.3,blue,2,1.5,16,20,blue
4450504768,0,5,0,0,0,0,0,13643,7,16820,217,62,-3585,-3405,21.7,1364.3,5,0,6,1,1,0,0,17228,7.4,20225,266,68,3585,3405,26.6,1722.8,red,0,12.65,25,22,red
4476854395,3,8,1,0,0,0,0,14418,6.4,16672,206,52,-2778,-2174,20.6,1441.8,8,3,7,2,1,1,0,17196,7,18846,205,52,2778,2174,20.5,1719.6,blue,0.5,5,30,21,red
4454163991,5,8,5,1,1,0,0,15999,7,18592,241,48,-2450,-1839,24.1,1599.9,8,5,6,0,0,0,0,18449,7.2,20431,255,63,2450,1839,25.5,1844.9,red,1.25,2.8,16,56,red
4508386136,3,4,4,0,0,0,0,15031,6.8,16824,202,55,-330,-142,20.2,1503.1,4,3,5,1,0,1,0,15361,6.6,16966,215,46,330,142,21.5,1536.1,blue,1.75,3,26,18,red
4520641645,6,1,8,1,1,0,0,16129,7.2,18567,210,48,2279,2842,21,1612.9,1,6,1,0,0,0,0,13850,6.4,15725,205,39,-2279,-2842,20.5,1385,red,14,0.33,28,19,red
4451815027,5,4,8,0,0,0,0,16059,7,18553,216,48,-1694,-1,21.6,1605.9,4,5,5,2,1,1,1,17753,7.2,18554,231,52,1694,1,23.1,1775.3,red,3.25,1.8,18,28,red
4447390730,8,6,13,0,0,0,0,17731,7,18478,256,34,709,1296,25.6,1773.1,6,8,5,0,0,0,0,17022,6.8,17182,229,54,-709,-1296,22.9,1702.2,blue,3.5,1.38,18,14,red
4498702463,4,12,3,0,0,0,0,15202,6.6,16607,219,40,-6871,-5115,21.9,1520.2,12,4,11,1,1,0,1,22073,8,21722,253,80,6871,5115,25.3,2207.3,red,0.58,5.75,14,36,red
4496993021,4,4,1,0,0,0,0,15786,7.2,18637,246,60,987,1253,24.6,1578.6,4,4,4,1,1,0,0,14799,6.8,17384,200,47,-987,-1253,20,1479.9,blue,1.25,2,16,18,red
4478459964,5,3,11,1,0,1,0,16003,7,17277,216,56,145,-862,21.6,1600.3,3,5,4,0,0,0,0,15858,7,18139,246,59,-145,862,24.6,1585.8,blue,5.33,1.4,24,21,blue
4497646663,2,9,1,0,0,0,0,13867,6.2,15515,206,31,-3975,-4232,20.6,1386.7,9,2,9,0,0,0,0,17842,7,19747,237,44,3975,4232,23.7,1784.2,red,0.33,9,84,20,red
4484829237,5,4,4,1,1,0,0,15792,7,17609,228,56,683,246,22.8,1579.2,4,5,6,0,0,0,0,15109,6.6,17363,210,41,-683,-246,21,1510.9,blue,2.25,2,20,21,blue
4511494997,2,5,2,0,0,0,0,14415,6.8,17248,215,49,-1674,-772,21.5,1441.5,5,2,6,1,1,0,0,16089,6.8,18020,246,44,1674,772,24.6,1608.9,red,0.8,5.5,23,24,red
4518046236,6,3,6,1,1,0,0,16665,7,18534,236,56,1630,1924,23.6,1666.5,3,6,3,0,0,0,0,15035,6.8,16610,235,36,-1630,-1924,23.5,1503.5,blue,4,1,14,15,red
4508510865,5,5,2,0,0,0,0,15775,6.6,16946,249,45,-848,-4,24.9,1577.5,5,5,7,1,1,0,0,16623,6.6,16950,225,53,848,4,22.5,1662.3,blue,1.4,2.4,21,22,red
4521738824,4,7,5,1,1,0,0,16418,6.8,17454,237,50,217,72,23.7,1641.8,7,4,5,0,0,0,0,16201,6.6,17382,216,40,-217,-72,21.6,1620.1,red,1.29,3,19,16,blue
4522160607,12,8,8,0,0,0,0,19525,7.6,20374,242,50,3224,2800,24.2,1952.5,8,12,10,0,0,0,0,16301,7,17574,181,32,-3224,-2800,18.1,1630.1,red,2.5,1.5,22,67,blue
4499876537,4,13,3,0,0,0,0,14349,6.6,16821,159,49,-6973,-3705,15.9,1434.9,13,4,11,1,1,0,1,21322,7.6,20526,263,60,6973,3705,26.3,2132.2,red,0.54,6,12,19,red
4525145035,6,8,9,0,0,0,0,16480,6.6,17339,226,48,-1726,63,22.6,1648,8,6,9,1,0,1,1,18206,6.8,17276,229,26,1726,-63,22.9,1820.6,red,1.88,2.83,13,20,blue
4495025348,8,7,4,2,1,1,0,17683,7.6,20153,237,56,1289,2602,23.7,1768.3,7,8,7,0,0,0,0,16394,6.6,17551,208,36,-1289,-2602,20.8,1639.4,blue,1.71,1.75,15,18,red
4469156590,8,13,8,1,1,0,0,16797,6.8,17770,200,48,-3201,-3067,20,1679.7,13,8,16,0,0,0,0,19998,7.6,20837,232,47,3201,3067,23.2,1999.8,red,1.23,3.62,14,56,blue
4514168279,5,6,3,1,1,0,0,14616,6.6,16844,183,40,-1313,-1476,18.3,1461.6,6,5,3,0,0,0,0,15929,7,18320,217,56,1313,1476,21.7,1592.9,red,1.33,1.8,17,15,blue
4521789361,11,1,11,0,0,0,0,18622,7.2,19365,245,50,5269,3577,24.5,1862.2,1,11,1,0,0,0,0,13353,6.6,15788,189,45,-5269,-3577,18.9,1335.3,blue,22,0.18,20,37,blue
4522791415,4,11,3,0,0,0,0,14689,6.6,16679,195,49,-5354,-4248,19.5,1468.9,11,4,10,1,1,0,0,20043,7.6,20927,244,61,5354,4248,24.4,2004.3,red,0.64,5.25,18,19,red
4516499874,10,12,13,1,1,0,0,17842,6.8,18236,194,52,-1949,-1074,19.4,1784.2,12,10,12,0,0,0,0,19791,7.2,19310,228,46,1949,1074,22.8,1979.1,red,1.92,2.4,14,18,red
4523342801,2,3,1,1,1,0,0,14756,7.2,18676,237,64,-1318,132,23.7,1475.6,3,2,5,0,0,0,0,16074,6.8,18544,266,38,1318,-132,26.6,1607.4,blue,1,4,42,22,red
4478911331,12,5,23,1,1,0,0,18494,6.8,17736,212,43,3098,2685,21.2,1849.4,5,12,9,0,0,0,0,15396,6.2,15051,188,34,-3098,-2685,18.8,1539.6,blue,7,1.17,18,26,red
4478232442,2,7,4,1,1,0,0,13870,6.4,15601,202,46,-2809,-2023,20.2,1387,7,2,7,0,0,0,0,16679,6.8,17624,221,50,2809,2023,22.1,1667.9,red,0.86,7,21,27,red
4497737191,3,3,2,1,1,0,0,14409,6.4,17030,212,44,-108,-914,21.2,1440.9,3,3,5,1,0,1,0,14517,7,17944,200,50,108,914,20,1451.7,red,1.67,2.67,20,45,red
4495097170,5,11,5,0,0,0,0,15543,6.8,17304,197,44,-3318,-2979,19.7,1554.3,11,5,8,2,1,1,0,18861,7.6,20283,228,60,3318,2979,22.8,1886.1,red,0.91,3.8,17,15,red
4519598858,6,14,5,0,0,0,0,15740,6.4,15862,177,49,-4093,-2844,17.7,1574,14,6,16,1,1,0,0,19833,7.2,18706,208,41,4093,2844,20.8,1983.3,red,0.79,5,84,23,red
4521451457,5,7,4,0,0,0,0,15691,6.8,17738,190,60,-854,-1069,19,1569.1,7,5,5,2,1,1,0,16545,7,18807,227,52,854,1069,22.7,1654.5,blue,1.29,2.4,63,18,blue
4524214871,3,8,4,1,0,1,0,15314,7,17245,207,61,-1891,-1211,20.7,1531.4,8,3,6,0,0,0,0,17205,7.2,18456,226,44,1891,1211,22.6,1720.5,blue,0.88,4.67,20,16,blue
4522611565,14,3,15,0,0,0,1,20030,7.2,18878,205,58,5872,4455,20.5,2003,3,14,5,0,0,0,0,14158,6,14423,171,34,-5872,-4455,17.1,1415.8,blue,9.67,0.57,45,41,blue
4464785685,6,2,5,1,1,0,0,18121,7.4,19941,257,68,3713,3023,25.7,1812.1,2,6,1,1,0,1,0,14408,6.6,16918,241,40,-3713,-3023,24.1,1440.8,blue,5.5,0.5,20,26,blue
4514180847,10,5,12,2,1,1,0,18625,7.2,18897,223,63,3149,2125,22.3,1862.5,5,10,4,0,0,0,0,15476,6.8,16772,227,40,-3149,-2125,22.7,1547.6,blue,4.4,0.9,20,18,blue
4459259003,10,1,7,0,0,0,0,18152,7.2,19147,233,47,4263,2953,23.3,1815.2,1,10,2,1,0,1,0,13889,6.6,16194,204,55,-4263,-2953,20.4,1388.9,blue,17,0.3,23,19,blue
4480352834,7,3,10,0,0,0,0,17350,7.2,18363,233,46,2896,1979,23.3,1735,3,7,6,0,0,0,0,14454,6.4,16384,199,40,-2896,-1979,19.9,1445.4,blue,5.67,1.29,19,15,blue
4524038349,6,2,7,1,1,0,0,16363,7,18353,218,52,2216,1311,21.8,1636.3,2,6,2,0,0,0,0,14147,6.6,17042,211,56,-2216,-1311,21.1,1414.7,blue,6.5,0.67,14,23,blue
4485749350,8,5,5,1,1,0,0,16104,6.8,17424,175,56,530,227,17.5,1610.4,5,8,4,0,0,0,0,15574,6.8,17197,227,47,-530,-227,22.7,1557.4,blue,2.6,1.12,19,20,blue
4518948833,6,5,9,1,1,0,0,15401,6.6,16508,195,32,-729,-889,19.5,1540.1,5,6,5,0,0,0,0,16130,6.6,17397,191,51,729,889,19.1,1613,blue,3,1.67,30,20,blue
4484466757,8,1,9,1,1,0,0,19331,7.4,20193,254,62,5885,4652,25.4,1933.1,1,8,0,0,0,0,0,13446,6.4,15541,169,59,-5885,-4652,16.9,1344.6,blue,17,0.12,12,15,red
4458884103,11,6,9,1,1,0,0,17537,7.2,19736,196,56,2607,1862,19.6,1753.7,6,11,2,0,0,0,0,14930,7,17874,183,44,-2607,-1862,18.3,1493,red,3.33,0.73,18,13,blue
4524294233,11,6,14,0,0,0,0,18379,7.2,19031,203,52,1952,1542,20.3,1837.9,6,11,9,1,1,0,0,16427,6.8,17489,196,64,-1952,-1542,19.6,1642.7,red,4.17,1.36,25,20,blue
4478567807,2,7,2,0,0,0,0,14857,6.4,16453,210,59,-1726,-1890,21,1485.7,7,2,17,1,1,0,0,16583,7.2,18343,203,44,1726,1890,20.3,1658.3,red,0.57,12,20,16,red
4505623673,8,6,6,0,0,0,0,17520,7,18523,220,48,996,116,22,1752,6,8,6,1,1,0,0,16524,6.8,18407,221,43,-996,-116,22.1,1652.4,blue,2.33,1.5,18,21,blue
4520992156,4,9,4,0,0,0,0,14837,6.6,17437,209,48,-4715,-1691,20.9,1483.7,9,4,10,2,1,1,1,19552,7.4,19128,239,44,4715,1691,23.9,1955.2,red,0.89,4.75,19,17,red
4509478131,5,5,8,0,0,0,0,16930,7.2,18587,237,52,928,-633,23.7,1693,5,5,3,1,1,0,0,16002,7.2,19220,241,56,-928,633,24.1,1600.2,red,2.6,1.6,22,24,red
4524787286,7,10,11,0,0,0,0,16332,6.8,17067,196,56,-1514,-893,19.6,1633.2,10,7,9,1,1,0,0,17846,6.8,17960,211,48,1514,893,21.1,1784.6,red,1.8,2.71,104,19,red
4523329461,5,6,2,0,0,0,0,15807,7.2,18325,231,43,-281,497,23.1,1580.7,6,5,5,0,0,0,0,16088,7,17828,230,48,281,-497,23,1608.8,red,1.17,2.2,24,23,red
4524378471,11,10,10,1,1,0,0,18720,7.2,18913,222,44,-438,-669,22.2,1872,10,11,12,0,0,0,0,19158,7.2,19582,186,64,438,669,18.6,1915.8,blue,2.1,2,21,38,red
4520690347,1,2,1,0,0,0,0,14215,6.6,17252,228,52,-579,-379,22.8,1421.5,2,1,1,1,1,0,0,14794,6.8,17631,233,40,579,379,23.3,1479.4,red,1,3,21,45,red
4456415287,13,5,9,0,0,0,0,19124,7.2,20438,244,56,3579,2679,24.4,1912.4,5,13,4,1,1,0,0,15545,7,17759,191,52,-3579,-2679,19.1,1554.5,blue,4.4,0.69,19,18,blue
4469875556,3,4,1,0,0,0,0,14352,6.8,17455,222,44,-1241,-1045,22.2,1435.2,4,3,2,1,0,1,0,15593,6.8,18500,232,55,1241,1045,23.2,1559.3,red,1,2,20,18,red
4520327496,5,3,7,0,0,0,0,16784,7,18136,252,56,727,-566,25.2,1678.4,3,5,2,0,0,0,0,16057,7.2,18702,221,55,-727,566,22.1,1605.7,blue,4,1,30,13,red
4522499744,5,7,6,1,1,0,0,16328,6.8,17945,241,50,-972,-1814,24.1,1632.8,7,5,8,0,0,0,0,17300,7.2,19759,233,53,972,1814,23.3,1730,blue,1.57,3,16,15,blue
4501224571,5,8,3,0,0,0,0,15318,7,18578,200,48,-1086,646,20,1531.8,8,5,8,2,1,1,0,16404,6.8,17932,194,43,1086,-646,19.4,1640.4,red,1,3.2,14,36,red
4505993951,3,5,5,0,0,0,0,14896,6.8,17240,207,42,-2200,-1933,20.7,1489.6,5,3,6,2,1,1,0,17096,7.4,19173,235,63,2200,1933,23.5,1709.6,blue,1.6,3.67,15,55,blue
4474824980,5,3,6,1,1,0,0,15667,7,17128,202,51,481,-259,20.2,1566.7,3,5,1,0,0,0,0,15186,6.8,17387,219,57,-481,259,21.9,1518.6,blue,3.67,0.8,16,18,blue
4441973762,13,9,13,1,1,0,1,21908,7.4,20909,227,84,4612,2877,22.7,2190.8,9,13,12,0,0,0,0,17296,7,18032,195,44,-4612,-2877,19.5,1729.6,blue,2.89,1.62,18,16,blue
4515510441,6,5,5,1,0,1,0,16372,6.8,17570,234,42,1506,-265,23.4,1637.2,5,6,3,1,1,0,0,14866,6.8,17835,200,59,-1506,265,20,1486.6,red,2.2,1.33,76,42,blue
4524917610,7,2,9,1,1,0,0,15993,6.4,16122,188,51,2090,468,18.8,1599.3,2,7,2,0,0,0,0,13903,6.4,15654,209,36,-2090,-468,20.9,1390.3,blue,8,0.57,19,22,blue
4488919403,5,5,7,0,0,0,0,14469,6.2,15329,136,48,-2579,-3819,13.6,1446.9,5,5,2,1,0,1,0,17048,7.2,19148,244,60,2579,3819,24.4,1704.8,red,2.4,1.4,15,17,red
4467269037,5,1,6,1,1,0,0,16956,7.2,18750,259,56,1723,740,25.9,1695.6,1,5,1,1,0,1,0,15233,6.8,18010,262,64,-1723,-740,26.2,1523.3,blue,11,0.4,25,16,blue
4515518860,7,7,4,1,0,1,0,16699,7,18064,212,48,559,55,21.2,1669.9,7,7,7,1,1,0,0,16140,7.2,18009,194,56,-559,-55,19.4,1614,red,1.57,2,15,19,blue
4466772650,3,8,1,0,0,0,0,14868,6.6,16222,237,41,-3346,-3153,23.7,1486.8,8,3,9,2,1,1,0,18214,7.2,19375,229,52,3346,3153,22.9,1821.4,red,0.5,5.67,28,23,red
4522174170,9,11,15,2,1,1,0,18281,7,17856,218,44,785,812,21.8,1828.1,11,9,12,0,0,0,0,17496,7,17044,184,40,-785,-812,18.4,1749.6,red,2.18,2.56,18,51,blue
4444894425,3,5,4,0,0,0,0,15144,7.4,18640,214,56,-439,775,21.4,1514.4,5,3,6,2,1,1,0,15583,6.6,17865,241,32,439,-775,24.1,1558.3,red,1.4,3.67,24,19,red
4520952711,4,10,4,0,0,0,0,14135,6.4,15854,182,48,-4416,-3186,18.2,1413.5,10,4,10,1,1,0,0,18551,7.4,19040,231,44,4416,3186,23.1,1855.1,red,0.8,5,23,20,red
4519044146,3,9,2,0,0,0,0,13808,6.2,15418,169,42,-4523,-3729,16.9,1380.8,9,3,9,1,1,0,0,18331,7.2,19147,219,65,4523,3729,21.9,1833.1,red,0.56,6,14,19,blue
4439283192,4,9,4,1,1,0,0,15137,6.6,15969,206,38,-3447,-3324,20.6,1513.7,9,4,10,1,0,1,0,18584,7.2,19293,262,59,3447,3324,26.2,1858.4,red,0.89,4.75,22,22,red
4508316147,7,4,7,1,1,0,0,17247,7,18201,223,48,2145,870,22.3,1724.7,4,7,5,0,0,0,0,15102,6.8,17331,231,29,-2145,-870,23.1,1510.2,blue,3.5,1.29,24,19,blue
4449290727,5,4,6,0,0,0,0,16485,7.2,18714,247,48,577,1501,24.7,1648.5,4,5,5,1,1,0,0,15908,6.8,17213,236,56,-577,-1501,23.6,1590.8,red,2.75,1.8,17,16,red
4489725249,7,12,11,1,0,1,0,16867,6.8,16680,209,52,-1883,-873,20.9,1686.7,12,7,13,1,1,0,0,18750,7,17553,226,34,1883,873,22.6,1875,red,1.5,3.57,27,24,blue
4462678795,3,9,2,0,0,0,0,14272,6,15106,194,55,-3608,-4288,19.4,1427.2,9,3,4,0,0,0,0,17880,7.2,19394,259,47,3608,4288,25.9,1788,red,0.56,4.33,41,19,red
4515621267,3,9,4,0,0,0,0,14282,6.6,16446,182,49,-4690,-3429,18.2,1428.2,9,3,11,1,1,0,0,18972,7.4,19875,235,65,4690,3429,23.5,1897.2,red,0.78,6.67,77,23,red
4475707542,4,3,5,0,0,0,0,16352,6.8,17852,220,56,1705,177,22,1635.2,3,4,2,1,1,0,0,14647,7,17675,202,64,-1705,-177,20.2,1464.7,blue,3,1.25,22,18,blue
4495519418,10,3,12,0,0,0,0,17862,7.4,19955,242,44,2417,2101,24.2,1786.2,3,10,3,1,1,0,0,15445,7,17854,203,64,-2417,-2101,20.3,1544.5,red,7.33,0.6,15,16,blue
4450519397,7,4,12,2,1,1,0,16431,6.8,17901,204,54,617,866,20.4,1643.1,4,7,6,0,0,0,0,15814,6.6,17035,236,52,-617,-866,23.6,1581.4,red,4.75,1.43,27,24,blue
4514247326,5,1,5,0,0,0,0,17114,7.4,19292,253,51,2861,2287,25.3,1711.4,1,5,1,1,1,0,0,14253,6.8,17005,248,51,-2861,-2287,24.8,1425.3,blue,10,0.4,22,19,blue
4522183138,9,10,11,2,1,1,1,19003,6.6,16349,226,31,503,-222,22.6,1900.3,10,9,14,0,0,0,0,18500,6.6,16571,209,43,-503,222,20.9,1850,blue,2,2.67,23,20,red
4521420506,6,9,10,0,0,0,0,15451,6.4,16217,188,35,-1679,-1569,18.8,1545.1,9,6,10,2,1,1,0,17130,7.2,17786,188,48,1679,1569,18.8,1713,red,1.78,3.17,15,28,blue
4520766314,9,3,13,1,1,0,0,17941,7.2,18842,205,52,2361,770,20.5,1794.1,3,9,3,0,0,0,0,15580,6.8,18072,249,52,-2361,-770,24.9,1558,red,7.33,0.67,20,19,blue
4455180442,12,3,10,1,1,0,0,19537,7.8,20680,246,51,4932,3923,24.6,1953.7,3,12,2,0,0,0,0,14605,6.6,16757,212,48,-4932,-3923,21.2,1460.5,blue,7.33,0.42,27,41,blue
4520880058,7,3,6,0,0,0,0,16863,6.6,17496,232,45,1310,-95,23.2,1686.3,3,7,3,1,1,0,0,15553,6.8,17591,227,55,-1310,95,22.7,1555.3,blue,4.33,0.86,23,17,blue
4512177311,3,8,3,1,1,0,0,15315,6.8,17328,213,48,-2314,-2460,21.3,1531.5,8,3,11,0,0,0,0,17629,7.2,19788,237,61,2314,2460,23.7,1762.9,red,0.75,6.33,33,20,blue
4452157467,5,6,10,1,1,0,0,15853,7,17700,204,55,-153,-962,20.4,1585.3,6,5,4,0,0,0,0,16006,6.8,18662,241,44,153,962,24.1,1600.6,blue,2.5,2,33,25,red
4519154901,2,6,0,0,0,0,0,14072,6.6,16596,207,56,-2186,-1093,20.7,1407.2,6,2,7,1,1,0,0,16258,7,17689,210,54,2186,1093,21,1625.8,red,0.33,6.5,17,38,blue
4476185279,9,12,8,0,0,0,0,17030,6.8,16983,176,41,-1567,1876,17.6,1703,12,9,15,0,0,0,0,18597,6.2,15107,171,36,1567,-1876,17.1,1859.7,red,1.42,3,46,15,red
4520799131,6,8,5,0,0,0,0,15617,6.8,17606,194,35,-2139,-1844,19.4,1561.7,8,6,10,1,1,0,0,17756,7.4,19450,200,80,2139,1844,20,1775.6,red,1.38,3,38,95,blue
4513869667,3,1,4,1,1,0,0,15634,6.6,17475,213,53,487,-618,21.3,1563.4,1,3,0,1,0,1,0,15147,7,18093,242,70,-487,618,24.2,1514.7,blue,7,0.33,19,39,blue
4524316009,5,7,2,1,0,1,0,15493,6.8,17405,211,52,-860,-121,21.1,1549.3,7,5,10,1,1,0,0,16353,7,17526,202,46,860,121,20.2,1635.3,blue,1,3.4,16,17,red
4476303520,5,3,5,1,1,0,0,15959,7.2,18751,244,52,786,1155,24.4,1595.9,3,5,5,0,0,0,0,15173,6.8,17596,238,49,-786,-1155,23.8,1517.3,red,3.33,1.6,23,19,red
4513547440,4,10,2,0,0,0,0,15945,7,17784,229,56,-1757,-1856,22.9,1594.5,10,4,8,2,1,1,0,17702,7.2,19640,209,60,1757,1856,20.9,1770.2,red,0.6,4.5,18,29,blue
4518322002,8,9,8,0,0,0,0,17389,7,18770,218,43,-1067,-523,21.8,1738.9,9,8,9,1,1,0,0,18456,7.4,19293,234,60,1067,523,23.4,1845.6,blue,1.78,2.25,41,20,red
4510307677,11,4,14,1,1,0,0,17961,7.2,19152,205,41,3354,2760,20.5,1796.1,4,11,5,0,0,0,0,14607,6.8,16392,206,32,-3354,-2760,20.6,1460.7,blue,6.25,0.82,18,13,blue
4446790862,4,3,2,0,0,0,0,15744,7.6,20593,234,67,419,1790,23.4,1574.4,3,4,0,1,1,0,0,15325,7.2,18803,263,52,-419,-1790,26.3,1532.5,red,2,0.75,17,18,red
4523046488,7,3,10,1,1,0,0,16657,7,18425,231,43,1131,1518,23.1,1665.7,3,7,3,0,0,0,0,15526,6.6,16907,233,60,-1131,-1518,23.3,1552.6,red,5.67,0.86,18,19,red
4523351869,3,2,3,1,1,0,0,15951,7,19210,247,70,1151,1753,24.7,1595.1,2,3,1,1,0,1,0,14800,6.8,17457,236,45,-1151,-1753,23.6,1480,red,3,1,41,52,blue
4491630754,7,8,8,0,0,0,0,15956,6.8,17011,191,51,-1206,-963,19.1,1595.6,8,7,7,1,1,0,0,17162,7,17974,243,44,1206,963,24.3,1716.2,blue,1.88,2.14,23,24,red
4518287583,4,9,4,0,0,0,0,16184,6.8,17808,239,68,-1620,-720,23.9,1618.4,9,4,8,0,0,0,0,17804,7.2,18528,218,52,1620,720,21.8,1780.4,red,0.89,4.25,18,19,red
4525101831,9,7,7,0,0,0,0,17518,7.2,19434,212,52,731,1627,21.2,1751.8,7,9,4,1,1,0,0,16787,7,17807,192,47,-731,-1627,19.2,1678.7,blue,2.29,1.22,23,14,red
4517015396,6,6,10,0,0,0,0,16992,6.8,17775,227,53,1182,420,22.7,1699.2,6,6,8,0,0,0,0,15810,6.6,17355,203,39,-1182,-420,20.3,1581,blue,2.67,2.33,21,22,blue
4452084615,3,4,2,0,0,0,0,14317,6.8,17076,224,45,-2155,-1351,22.4,1431.7,4,3,4,1,0,1,0,16472,7,18427,239,52,2155,1351,23.9,1647.2,red,1.25,2.67,20,22,red
4522456082,3,5,2,0,0,0,0,14935,7.2,17972,220,48,-792,-9,22,1493.5,5,3,6,0,0,0,0,15727,7,17981,221,49,792,9,22.1,1572.7,blue,1,3.67,42,18,blue
4501840328,2,3,2,0,0,0,0,14736,6.4,16670,235,50,-635,-1175,23.5,1473.6,3,2,4,0,0,0,0,15371,7.2,17845,235,47,635,1175,23.5,1537.1,red,1.33,3.5,15,18,blue
4524763610,10,2,12,1,1,0,0,18444,7,18580,220,51,3711,2294,22,1844.4,2,10,2,0,0,0,0,14733,6.4,16286,234,47,-3711,-2294,23.4,1473.3,blue,11,0.4,19,19,blue
4431218839,6,4,6,1,1,0,0,17089,7.2,18072,232,52,2387,1690,23.2,1708.9,4,6,3,0,0,0,0,14702,6.6,16382,191,44,-2387,-1690,19.1,1470.2,blue,3,1.17,16,34,blue
4476255781,15,7,16,0,0,0,0,20036,7.2,19646,178,80,4060,3619,17.8,2003.6,7,15,8,0,0,0,0,15976,6.4,16027,192,44,-4060,-3619,19.2,1597.6,blue,4.43,1,17,20,blue
4524047710,8,1,11,1,0,1,1,18976,7.2,19176,259,49,4910,2573,25.9,1897.6,1,8,0,1,1,0,0,14066,6.6,16603,224,43,-4910,-2573,22.4,1406.6,blue,19,0.12,19,22,blue
4523015009,3,5,4,1,1,0,0,15257,6.6,16719,237,52,-686,-634,23.7,1525.7,5,3,8,0,0,0,0,15943,6.8,17353,208,43,686,634,20.8,1594.3,blue,1.4,4.33,21,21,blue
4511838472,5,4,4,0,0,0,0,16510,7,17844,239,44,1066,528,23.9,1651,4,5,3,0,0,0,0,15444,7,17316,231,36,-1066,-528,23.1,1544.4,red,2.25,1.4,21,19,blue
4521191385,8,2,10,0,0,0,0,17754,7,18653,239,39,3880,2784,23.9,1775.4,2,8,1,0,0,0,0,13874,6.4,15869,204,40,-3880,-2784,20.4,1387.4,blue,9,0.38,17,20,blue
4459009838,6,6,7,0,0,0,0,16339,7,17799,205,54,297,1283,20.5,1633.9,6,6,7,0,0,0,0,16042,6.4,16516,225,47,-297,-1283,22.5,1604.2,blue,2.17,2.17,58,34,red
4501443265,7,9,7,0,0,0,0,17309,6.8,17384,231,46,334,-302,23.1,1730.9,9,7,12,1,1,0,0,16975,7,17686,191,52,-334,302,19.1,1697.5,blue,1.56,3,16,17,red
4522271198,6,5,3,1,1,0,0,15712,6.8,17676,216,48,267,745,21.6,1571.2,5,6,7,0,0,0,0,15445,6.8,16931,203,44,-267,-745,20.3,1544.5,blue,1.8,2,17,20,blue
4514501540,7,4,10,1,0,1,0,16008,7.2,18460,210,49,178,1499,21,1600.8,4,7,5,0,0,0,0,15830,6.6,16961,227,44,-178,-1499,22.7,1583,red,4.25,1.29,22,22,red
4500179611,1,2,2,0,0,0,0,13772,6.6,16974,231,48,-845,-571,23.1,1377.2,2,1,4,1,1,0,0,14617,7,17545,197,60,845,571,19.7,1461.7,blue,1.5,6,19,25,red
4518389976,3,8,3,0,0,0,0,14301,6.6,17009,173,52,-2482,-1576,17.3,1430.1,8,3,6,1,1,0,0,16783,7,18585,230,52,2482,1576,23,1678.3,red,0.75,4.67,20,17,red
4524725570,7,9,9,1,0,1,0,16682,7,18002,180,59,-1370,-1269,18,1668.2,9,7,14,1,1,0,0,18052,7.4,19271,221,44,1370,1269,22.1,1805.2,red,1.78,3.29,27,15,blue
4521111365,3,7,3,1,1,0,0,14849,6.8,17502,221,53,-3736,-2032,22.1,1484.9,7,3,6,1,0,1,1,18585,7.6,19534,232,60,3736,2032,23.2,1858.5,blue,0.86,4.33,19,18,blue
4459418166,9,6,8,0,0,0,0,17807,7.4,19554,229,46,1233,336,22.9,1780.7,6,9,5,2,1,1,0,16574,7.4,19218,197,53,-1233,-336,19.7,1657.4,red,2.83,1.22,19,81,red
4519183876,11,3,11,2,1,1,0,18866,7.6,20876,214,60,3650,3906,21.4,1886.6,3,11,4,0,0,0,0,15216,6.8,16970,219,44,-3650,-3906,21.9,1521.6,blue,7.33,0.64,16,12,blue
4481718331,9,6,6,1,1,0,0,17828,6.8,17917,218,54,1767,709,21.8,1782.8,6,9,7,0,0,0,0,16061,6.8,17208,202,44,-1767,-709,20.2,1606.1,red,2.5,1.44,24,23,blue
4450778903,7,5,7,1,1,0,0,16470,7,17655,216,49,632,-1247,21.6,1647,5,7,2,0,0,0,0,15838,7,18902,230,60,-632,1247,23,1583.8,blue,2.8,1,19,18,blue
4512213079,8,7,4,0,0,0,0,16865,7.4,19606,212,56,147,1133,21.2,1686.5,7,8,3,1,1,0,0,16718,7,18473,209,52,-147,-1133,20.9,1671.8,red,1.71,1.25,101,30,red
4515422041,5,8,4,0,0,0,0,15353,7,17812,189,46,-2332,-2671,18.9,1535.3,8,5,5,0,0,0,0,17685,7.6,20483,217,60,2332,2671,21.7,1768.5,red,1.12,2.6,16,15,blue
4432139971,2,6,1,0,0,0,0,14247,6.8,16785,216,56,-1179,-557,21.6,1424.7,6,2,3,0,0,0,0,15426,6.8,17342,194,52,1179,557,19.4,1542.6,red,0.5,4.5,14,15,red
4511197912,12,7,13,0,0,0,0,18278,6.8,17024,191,24,2352,707,19.1,1827.8,7,12,9,0,0,0,0,15926,6.6,16317,189,45,-2352,-707,18.9,1592.6,blue,3.57,1.33,45,22,blue
4494937598,6,7,8,0,0,0,0,16068,7.2,18240,209,54,-932,-517,20.9,1606.8,7,6,4,2,1,1,0,17000,7.2,18757,240,44,932,517,24,1700,red,2,1.83,15,16,red
4494485010,4,2,3,1,1,0,0,15966,6.8,17893,231,48,1361,1064,23.1,1596.6,2,4,1,0,0,0,0,14605,6.6,16829,208,64,-1361,-1064,20.8,1460.5,blue,3.5,0.75,23,20,blue
4508607080,10,10,12,0,0,0,0,17860,7,17673,182,52,-268,407,18.2,1786,10,10,16,0,0,0,0,18128,6.8,17266,199,40,268,-407,19.9,1812.8,blue,2.2,2.6,43,19,red
4505943275,9,6,14,0,0,0,0,17517,7.2,18612,228,44,124,-1526,22.8,1751.7,6,9,7,2,1,1,0,17393,7.4,20138,235,60,-124,1526,23.5,1739.3,red,3.83,1.44,22,43,red
4481779258,5,6,4,0,0,0,0,15815,6.8,17429,224,40,-721,-1118,22.4,1581.5,6,5,7,1,1,0,0,16536,7,18547,241,50,721,1118,24.1,1653.6,red,1.5,2.6,41,14,blue
4523619832,7,6,4,1,1,0,0,16519,7,18850,203,64,-1464,331,20.3,1651.9,6,7,4,0,0,0,0,17983,7,18519,240,60,1464,-331,24,1798.3,red,1.83,1.43,17,23,red
4524779712,7,5,11,1,0,1,0,16977,7,17852,201,44,1753,847,20.1,1697.7,5,7,9,1,1,0,0,15224,6.6,17005,186,49,-1753,-847,18.6,1522.4,blue,3.6,2,17,14,blue
4522814409,3,12,2,0,0,0,0,14769,6.4,16504,205,45,-4374,-2570,20.5,1476.9,12,3,13,0,0,0,0,19143,7,19074,209,53,4374,2570,20.9,1914.3,red,0.42,8.33,16,17,red
4477181015,7,9,5,0,0,0,0,17221,6.8,18291,229,54,194,1206,22.9,1722.1,9,7,8,1,1,0,0,17027,6.8,17085,213,44,-194,-1206,21.3,1702.7,red,1.33,2.43,22,125,blue
4500913253,10,10,12,0,0,0,0,18152,7,18364,196,56,-973,-2396,19.6,1815.2,10,10,10,0,0,0,0,19125,7.4,20760,238,68,973,2396,23.8,1912.5,blue,2.2,2,36,17,blue
4523483932,9,6,10,0,0,0,0,17118,7.2,19705,224,52,1550,3286,22.4,1711.8,6,9,8,1,1,0,0,15568,6.8,16419,182,56,-1550,-3286,18.2,1556.8,blue,3.17,1.56,17,17,red
4465556505,8,4,9,1,1,0,0,16923,6.8,18443,195,60,2504,2824,19.5,1692.3,4,8,3,0,0,0,0,14419,6.4,15619,199,29,-2504,-2824,19.9,1441.9,blue,4.25,0.88,48,19,red
4522484818,8,8,8,0,0,0,0,17698,7.2,18605,218,56,-373,-1526,21.8,1769.8,8,8,5,1,1,0,0,18071,7.4,20131,233,76,373,1526,23.3,1807.1,red,2,1.62,18,16,blue
4507803144,2,9,2,0,0,0,0,13889,6.4,16133,200,52,-4479,-2696,20,1388.9,9,2,12,0,0,0,0,18368,7,18829,239,48,4479,2696,23.9,1836.8,red,0.44,10.5,19,17,red
4524447311,2,9,1,0,0,0,0,15218,6.8,17342,227,51,-2789,-1511,22.7,1521.8,9,2,7,1,1,0,0,18007,7,18853,248,56,2789,1511,24.8,1800.7,red,0.33,8,19,19,red
4490764979,4,3,3,1,1,0,0,15876,7,18504,228,63,525,294,22.8,1587.6,3,4,2,0,0,0,0,15351,6.8,18210,227,48,-525,-294,22.7,1535.1,red,2.33,1.25,36,25,blue
4487380203,2,8,1,1,1,0,0,14476,6.6,16263,201,57,-4094,-3320,20.1,1447.6,8,2,8,0,0,0,0,18570,7.2,19583,252,66,4094,3320,25.2,1857,red,0.38,8,18,20,red
4455281479,10,3,5,1,0,1,0,18730,7.4,20389,232,58,5229,5136,23.2,1873,3,10,0,1,1,0,0,13501,6.4,15253,181,36,-5229,-5136,18.1,1350.1,blue,5,0.3,48,31,blue
4521440025,4,4,4,0,0,0,0,14788,6.6,17212,212,46,-516,-113,21.2,1478.8,4,4,5,1,1,0,0,15304,6.6,17325,212,47,516,113,21.2,1530.4,red,2,2.25,21,41,blue
4454127196,7,8,10,1,0,1,0,17257,6.8,17553,189,52,-429,-698,18.9,1725.7,8,7,9,1,1,0,0,17686,7,18251,223,60,429,698,22.3,1768.6,blue,2.12,2.43,18,91,blue
4512554301,4,5,1,1,1,0,0,16755,6.8,18760,263,68,695,1686,26.3,1675.5,5,4,4,0,0,0,0,16060,6.6,17074,225,39,-695,-1686,22.5,1606,red,1,2.25,18,19,red
4450284117,6,5,5,0,0,0,0,17160,7.4,18631,240,60,750,1304,24,1716,5,6,9,0,0,0,0,16410,6.8,17327,230,56,-750,-1304,23,1641,red,2.2,2.33,18,29,red
4506543397,9,7,11,1,0,1,0,17949,6.6,17918,234,40,1076,-845,23.4,1794.9,7,9,6,0,0,0,0,16873,7.2,18763,214,56,-1076,845,21.4,1687.3,blue,2.86,1.44,18,20,red
4478393634,4,12,2,0,0,0,0,15585,6.8,17639,224,42,-3559,-1319,22.4,1558.5,12,4,11,0,0,0,0,19144,7.2,18958,216,44,3559,1319,21.6,1914.4,red,0.5,5.75,39,32,red
4481998895,9,4,12,1,1,0,0,18055,6.8,17444,212,50,3332,2911,21.2,1805.5,4,9,8,0,0,0,0,14723,6.2,14533,186,41,-3332,-2911,18.6,1472.3,blue,5.25,1.33,16,14,red
4522664876,7,5,7,0,0,0,0,17406,7,18922,240,48,1104,183,24,1740.6,5,7,8,1,1,0,0,16302,7.2,18739,207,48,-1104,-183,20.7,1630.2,red,2.8,1.86,19,19,blue
4494742887,9,12,16,0,0,0,0,18633,6.8,18367,246,47,-1428,-433,24.6,1863.3,12,9,10,2,1,1,1,20061,7.2,18800,223,48,1428,433,22.3,2006.1,red,2.08,2.44,20,22,red
4497827663,8,6,8,0,0,0,0,17564,7.2,18892,232,40,1156,916,23.2,1756.4,6,8,5,0,0,0,0,16408,7,17976,211,65,-1156,-916,21.1,1640.8,blue,2.67,1.38,44,58,red
4516368750,9,7,8,0,0,0,0,17944,7.2,18559,255,40,1319,41,25.5,1794.4,7,9,4,1,1,0,0,16625,7,18518,234,56,-1319,-41,23.4,1662.5,red,2.43,1.22,21,21,blue
4514314077,5,7,6,0,0,0,0,15888,7,18305,239,47,-1157,-51,23.9,1588.8,7,5,7,1,0,1,0,17045,7,18356,216,56,1157,51,21.6,1704.5,red,1.57,2.8,17,18,red
4524647930,8,10,9,1,1,0,0,16650,7,18077,199,63,-1968,-469,19.9,1665,10,8,11,0,0,0,0,18618,7.2,18546,224,44,1968,469,22.4,1861.8,red,1.7,2.62,40,18,red
4518537002,10,9,15,0,0,0,0,17892,7,18021,190,48,479,52,19,1789.2,9,10,19,0,0,0,0,17413,7,17969,221,48,-479,-52,22.1,1741.3,red,2.78,2.8,17,16,blue
4477428362,3,5,3,0,0,0,0,15708,6.8,17721,226,52,-564,-1862,22.6,1570.8,5,3,5,1,1,0,0,16272,7.2,19583,243,60,564,1862,24.3,1627.2,blue,1.2,3.33,13,20,blue
4442406122,13,6,14,0,0,0,0,19324,7,19019,226,55,3110,1541,22.6,1932.4,6,13,8,1,1,0,0,16214,7,17478,206,56,-3110,-1541,20.6,1621.4,blue,4.5,1.08,16,18,blue
4523417130,7,10,10,0,0,0,0,16425,6.8,16635,207,36,-964,-1439,20.7,1642.5,10,7,7,0,0,0,0,17389,7,18074,189,44,964,1439,18.9,1738.9,red,1.7,2.43,33,15,blue
4502652617,5,5,3,1,0,1,0,16993,7,18944,241,67,1140,-531,24.1,1699.3,5,5,5,1,1,0,0,15853,7,19475,231,60,-1140,531,23.1,1585.3,red,1.6,2,11,13,blue
4523747922,2,6,3,0,0,0,0,14752,6.8,17935,228,61,-2181,-1293,22.8,1475.2,6,2,8,1,1,0,0,16933,7.2,19228,252,52,2181,1293,25.2,1693.3,red,0.83,7,19,20,red
4451962379,2,10,1,0,0,0,0,14675,6.8,17184,207,44,-3911,-2728,20.7,1467.5,10,2,10,2,1,1,0,18586,7.4,19912,254,40,3911,2728,25.4,1858.6,red,0.3,10,85,16,red
4446535819,6,3,10,0,0,0,0,16907,6.8,18072,165,56,1697,125,16.5,1690.7,3,6,1,1,1,0,0,15210,6.8,17947,242,50,-1697,-125,24.2,1521,blue,5.33,0.67,23,19,blue
4508772592,2,11,3,0,0,0,0,14384,7,17020,237,40,-6124,-4043,23.7,1438.4,11,2,8,1,1,0,0,20508,7.6,21063,252,64,6124,4043,25.2,2050.8,red,0.45,9.5,13,15,red
4496598849,3,8,3,0,0,0,0,16060,7.2,17844,213,57,-1603,-1134,21.3,1606,8,3,11,1,1,0,0,17663,7.2,18978,227,53,1603,1134,22.7,1766.3,red,0.75,6.33,22,44,red
4455649494,3,4,3,0,0,0,0,15484,7,18326,232,60,-930,185,23.2,1548.4,4,3,3,1,1,0,0,16414,7,18141,249,52,930,-185,24.9,1641.4,red,1.5,2.33,18,22,blue
4468006580,4,10,10,0,0,0,0,15064,6.2,14203,141,40,-5181,-5072,14.1,1506.4,10,4,9,2,1,1,1,20245,7.4,19275,240,60,5181,5072,24,2024.5,red,1.4,4.75,17,19,red
4476398273,8,5,8,0,0,0,1,18775,7,18390,230,40,2666,400,23,1877.5,5,8,4,1,0,1,0,16109,6.8,17990,215,49,-2666,-400,21.5,1610.9,blue,3.2,1.12,22,20,blue
4513746482,5,2,5,2,1,1,0,17665,7.4,19907,258,68,4520,5730,25.8,1766.5,2,5,0,0,0,0,0,13145,5.6,14177,210,29,-4520,-5730,21,1314.5,blue,5,0.4,19,10,blue
4518612412,7,3,10,0,0,0,0,17379,7.6,20465,265,64,1524,2071,26.5,1737.9,3,7,7,1,1,0,0,15855,7,18394,268,60,-1524,-2071,26.8,1585.5,blue,5.67,1.43,23,23,blue
4445514186,4,8,2,1,0,1,0,16266,6.6,17958,224,47,-622,-1278,22.4,1626.6,8,4,13,1,1,0,0,16888,7.2,19236,231,53,622,1278,23.1,1688.8,red,0.75,5.25,16,19,blue
4521085954,6,7,8,0,0,0,0,16260,6.8,17081,197,37,-2025,-1774,19.7,1626,7,6,11,1,0,1,1,18285,7,18855,193,59,2025,1774,19.3,1828.5,red,2,3,13,51,red
4459612181,2,7,3,0,0,0,0,14313,6.4,16259,212,57,-2276,-2192,21.2,1431.3,7,2,7,1,1,0,0,16589,6.8,18451,217,47,2276,2192,21.7,1658.9,red,0.71,7,15,15,red
4516639706,2,2,3,0,0,0,0,15397,6.8,17958,247,44,908,-79,24.7,1539.7,2,2,1,2,1,1,0,14489,6.8,18037,221,60,-908,79,22.1,1448.9,blue,2.5,1.5,15,18,red
4475775063,7,4,9,0,0,0,0,16275,6.8,17390,224,47,1606,615,22.4,1627.5,4,7,4,0,0,0,0,14669,6.4,16775,208,36,-1606,-615,20.8,1466.9,blue,4,1.14,16,47,blue
4470582176,8,9,9,0,0,0,0,18026,7,17839,198,44,726,-455,19.8,1802.6,9,8,12,0,0,0,0,17300,7,18294,186,68,-726,455,18.6,1730,red,1.89,2.62,37,19,blue
4520937414,1,8,0,0,0,0,0,13415,6.4,16177,215,43,-5048,-4231,21.5,1341.5,8,1,8,1,1,0,0,18463,7.6,20408,264,51,5048,4231,26.4,1846.3,red,0.12,16,16,23,blue
4521632835,7,7,7,1,1,0,0,16635,7,17795,215,62,544,758,21.5,1663.5,7,7,10,0,0,0,0,16091,6.6,17037,194,49,-544,-758,19.4,1609.1,red,2,2.43,18,34,red
4522659821,1,3,2,0,0,0,0,14114,6.8,17618,229,55,-1313,-6,22.9,1411.4,3,1,5,2,1,1,0,15427,6.8,17624,250,48,1313,6,25,1542.7,red,1,8,18,20,red
4512231954,5,6,2,2,1,1,0,15975,6.6,17545,222,60,-33,-559,22.2,1597.5,6,5,7,0,0,0,0,16008,7,18104,214,55,33,559,21.4,1600.8,red,1.17,2.6,21,14,red
4492253992,4,11,5,0,0,0,0,14606,6.4,16104,173,59,-4405,-3304,17.3,1460.6,11,4,16,1,1,0,0,19011,7.2,19408,193,63,4405,3304,19.3,1901.1,red,0.82,6.75,18,60,red
4472447425,10,5,13,1,1,0,0,19134,7.6,20399,227,71,3440,2199,22.7,1913.4,5,10,4,0,0,0,0,15694,6.8,18200,209,66,-3440,-2199,20.9,1569.4,blue,4.6,0.9,19,18,red
4519435886,3,3,3,0,0,0,0,15209,7,17965,201,48,-325,9,20.1,1520.9,3,3,6,0,0,0,0,15534,7,17956,246,47,325,-9,24.6,1553.4,red,2,3,18,18,blue
4490516014,6,7,9,1,0,1,0,16512,7.4,18547,207,75,-1314,-1027,20.7,1651.2,7,6,10,1,1,0,0,17826,7.2,19574,246,67,1314,1027,24.6,1782.6,blue,2.14,2.83,18,41,blue
4522142363,4,9,6,1,0,1,0,15707,6.6,16687,225,36,-1724,-1515,22.5,1570.7,9,4,12,1,1,0,0,17431,7,18202,202,39,1724,1515,20.2,1743.1,red,1.11,5.25,18,64,red
4421818869,10,3,9,1,1,0,0,17886,7.4,19530,224,62,3854,2986,22.4,1788.6,3,10,2,0,0,0,0,14032,6.6,16544,193,44,-3854,-2986,19.3,1403.2,blue,6.33,0.5,20,17,red
4524502451,4,4,3,1,1,0,0,15620,7,17974,225,52,234,-318,22.5,1562,4,4,4,0,0,0,0,15386,7,18292,227,40,-234,318,22.7,1538.6,blue,1.75,2,19,91,blue
4462463336,5,15,5,1,1,0,0,16275,7,17526,199,64,-4202,-3846,19.9,1627.5,15,5,9,0,0,0,0,20477,7.8,21372,248,44,4202,3846,24.8,2047.7,red,0.67,4.8,17,23,blue
4524587710,9,9,10,1,0,1,0,17308,6.8,16585,209,48,832,-504,20.9,1730.8,9,9,6,1,1,0,0,16476,6.6,17089,183,56,-832,504,18.3,1647.6,blue,2.11,1.67,39,16,red
4475339734,2,3,1,0,0,0,0,13875,6.4,16214,212,46,-1207,-1542,21.2,1387.5,3,2,3,0,0,0,0,15082,7,17756,227,37,1207,1542,22.7,1508.2,red,1,3,66,25,red
4470291861,12,7,19,1,1,0,1,20721,7,18605,247,49,4453,1296,24.7,2072.1,7,12,13,0,0,0,0,16268,7,17309,206,48,-4453,-1296,20.6,1626.8,blue,4.43,1.67,18,18,red
4515883864,8,4,9,1,1,0,0,16955,6.8,17434,191,56,1306,1039,19.1,1695.5,4,8,2,0,0,0,0,15649,6.6,16395,200,48,-1306,-1039,20,1564.9,blue,4.25,0.75,19,16,blue
4524901696,6,9,8,0,0,0,0,16099,6.8,17169,200,31,-1063,-1027,20,1609.9,9,6,7,1,1,0,0,17162,7.2,18196,215,49,1063,1027,21.5,1716.2,red,1.56,2.67,37,12,blue
4525072110,13,4,13,1,0,1,0,19569,7.2,19298,203,36,5148,2308,20.3,1956.9,4,13,2,1,1,0,0,14421,6.8,16990,179,51,-5148,-2308,17.9,1442.1,blue,6.5,0.46,91,46,blue
4477855283,15,7,17,1,1,0,1,20932,7.2,19304,233,48,4217,1384,23.3,2093.2,7,15,8,0,0,0,0,16715,7,17920,188,64,-4217,-1384,18.8,1671.5,blue,4.57,1,20,36,blue
4492999384,17,7,17,2,1,1,0,20983,7.2,19590,220,32,5372,4626,22,2098.3,7,17,8,0,0,0,0,15611,6.4,14964,156,40,-5372,-4626,15.6,1561.1,blue,4.86,0.88,23,16,blue
4513856190,4,6,6,0,0,0,0,15871,6.8,17242,224,56,-752,-1764,22.4,1587.1,6,4,4,2,1,1,0,16623,7,19006,228,72,752,1764,22.8,1662.3,red,1.67,2.5,40,24,blue
4514736409,10,7,11,0,0,0,0,17938,6.8,17865,219,37,2161,1731,21.9,1793.8,7,10,6,1,1,0,0,15777,6.2,16134,195,55,-2161,-1731,19.5,1577.7,blue,3,1.3,14,16,blue
4516088555,8,0,7,2,1,1,3,20685,8,21642,279,58,7761,5818,27.9,2068.5,0,8,0,0,0,0,0,12924,6.4,15824,201,44,-7761,-5818,20.1,1292.4,blue,12.03,0,21,21,blue
4524598212,11,6,8,1,0,1,0,18045,7.4,20275,227,55,2647,3204,22.7,1804.5,6,11,10,0,0,0,0,15398,6.6,17071,203,35,-2647,-3204,20.3,1539.8,blue,3.17,1.45,18,21,blue
4430925118,7,4,7,2,1,1,0,16985,7,19175,241,52,986,1194,24.1,1698.5,4,7,5,0,0,0,0,15999,7,17981,267,48,-986,-1194,26.7,1599.9,blue,3.5,1.29,92,18,red
4525021838,3,6,2,1,0,1,0,14106,6.2,15716,200,48,-2393,-1004,20,1410.6,6,3,6,1,1,0,0,16499,6.4,16720,186,40,2393,1004,18.6,1649.9,blue,0.83,4,11,17,red
4523609898,3,3,3,1,1,0,0,15474,6.8,17407,203,64,-347,-1134,20.3,1547.4,3,3,5,0,0,0,0,15821,7.2,18541,224,63,347,1134,22.4,1582.1,red,2,2.67,123,11,blue
4472684884,6,4,6,1,0,1,0,16434,7,18330,235,48,-435,574,23.5,1643.4,4,6,8,1,1,0,0,16869,6.8,17756,270,36,435,-574,27,1686.9,blue,3,2,20,25,red
4519205334,4,8,3,2,1,1,0,14885,6.8,17810,192,59,-4790,-2126,19.2,1488.5,8,4,5,0,0,0,1,19675,7.4,19936,232,67,4790,2126,23.2,1967.5,red,0.88,3.25,16,91,red
4468097327,11,2,9,1,1,0,0,19527,7.6,20653,237,52,5525,3467,23.7,1952.7,2,11,1,0,0,0,0,14002,6.8,17186,211,52,-5525,-3467,21.1,1400.2,blue,10,0.27,21,14,blue
4516741439,6,7,6,0,0,0,0,16685,6.6,17126,223,44,17,-1180,22.3,1668.5,7,6,4,1,1,0,0,16668,7,18306,175,61,-17,1180,17.5,1666.8,red,1.71,1.83,14,15,red
4435716100,14,11,16,1,0,1,0,19868,7,19587,201,58,2782,4548,20.1,1986.8,11,14,18,1,1,0,0,17086,6.4,15039,157,36,-2782,-4548,15.7,1708.6,red,2.73,2.07,21,93,red
4525141412,9,7,10,0,0,0,0,16017,6.8,17022,182,34,-58,13,18.2,1601.7,7,9,3,1,1,0,0,16075,6.8,17009,228,37,58,-13,22.8,1607.5,red,2.71,1.11,14,16,red
4521342021,0,5,0,0,0,0,0,13557,6.6,16944,213,60,-2637,-1878,21.3,1355.7,5,0,8,1,1,0,0,16194,6.8,18822,248,52,2637,1878,24.8,1619.4,red,0,12.65,111,42,red
4523881390,6,2,8,1,0,1,0,17779,7.6,20127,268,48,3206,2261,26.8,1777.9,2,6,2,0,0,0,0,14573,7,17866,225,52,-3206,-2261,22.5,1457.3,blue,7,0.67,20,19,blue
4478167956,14,2,19,1,1,0,0,19133,7.2,19406,200,56,4531,2978,20,1913.3,2,14,3,0,0,0,0,14602,6.6,16428,211,60,-4531,-2978,21.1,1460.2,blue,16.5,0.36,14,14,red
4510713167,3,3,3,1,1,0,0,14304,6,15110,199,56,-2083,-2549,19.9,1430.4,3,3,5,0,0,0,1,16387,6.8,17659,236,44,2083,2549,23.6,1638.7,red,2,2.67,13,14,blue
4515783776,1,3,0,0,0,0,0,14339,6.8,17922,234,60,-1327,-825,23.4,1433.9,3,1,5,1,1,0,0,15666,7.2,18747,241,50,1327,825,24.1,1566.6,blue,0.33,8,37,19,red
4477354923,9,9,12,1,1,0,0,17101,6.8,16986,194,47,359,-1714,19.4,1710.1,9,9,7,0,0,0,0,16742,7,18700,197,56,-359,1714,19.7,1674.2,blue,2.33,1.78,18,41,blue
4472895904,3,5,4,1,0,1,0,14731,6.6,16242,223,41,-2272,-2782,22.3,1473.1,5,3,7,1,1,0,0,17003,7.2,19024,220,84,2272,2782,22,1700.3,blue,1.4,4,20,14,blue
4518805877,8,10,10,1,1,0,0,17766,7.2,18700,229,54,-680,-703,22.9,1776.6,10,8,12,0,0,0,0,18446,7,19403,243,41,680,703,24.3,1844.6,blue,1.8,2.75,17,17,blue
4522612481,7,5,7,1,1,0,0,16747,7,18330,202,48,482,-670,20.2,1674.7,5,7,2,0,0,0,0,16265,7.2,19000,225,60,-482,670,22.5,1626.5,red,2.8,1,15,12,blue
4458474426,7,12,5,2,1,1,0,16074,6.8,16408,185,50,-3268,-4457,18.5,1607.4,12,7,10,0,0,0,0,19342,7.6,20865,206,55,3268,4457,20.6,1934.2,red,1,3.14,15,20,blue
4461787791,7,5,7,1,1,0,0,17488,7.2,18635,220,51,1902,967,22,1748.8,5,7,6,0,0,0,0,15586,7,17668,193,60,-1902,-967,19.3,1558.6,blue,2.8,1.57,92,60,blue
4519249108,0,6,0,0,0,0,0,12698,6.2,15550,195,48,-3784,-4019,19.5,1269.8,6,0,11,1,1,0,0,16482,7.4,19569,222,60,3784,4019,22.2,1648.2,red,0,12.65,19,15,red
4522858469,10,3,10,0,0,0,0,17264,7.4,19660,230,36,2474,2494,23,1726.4,3,10,2,0,0,0,0,14790,6.8,17166,230,51,-2474,-2494,23,1479,blue,6.67,0.5,17,17,red
4519809162,2,11,5,0,0,0,0,14516,6.6,17011,218,52,-3678,-3234,21.8,1451.6,11,2,12,1,1,0,0,18194,7.6,20245,246,52,3678,3234,24.6,1819.4,red,0.64,11.5,26,25,blue
4437689100,8,2,11,0,0,0,0,17666,7.4,19438,241,49,2537,1833,24.1,1766.6,2,8,2,1,1,0,0,15129,7,17605,234,54,-2537,-1833,23.4,1512.9,red,9.5,0.5,20,18,blue
4507840588,6,4,8,1,1,0,0,16521,7,17693,203,56,1490,1461,20.3,1652.1,4,6,6,0,0,0,0,15031,6.4,16232,216,39,-1490,-1461,21.6,1503.1,blue,3.5,1.67,16,16,blue
4521325400,5,9,5,1,1,0,0,15880,6.8,17975,199,56,-3840,-2835,19.9,1588,9,5,11,1,0,1,0,19720,7.6,20810,239,76,3840,2835,23.9,1972,red,1.11,4,15,14,red
4451744895,9,3,12,1,1,0,0,17020,6.8,17178,185,44,1377,-673,18.5,1702,3,9,2,0,0,0,0,15643,7,17851,232,51,-1377,673,23.2,1564.3,blue,7,0.56,19,23,blue
4514117878,7,2,9,1,1,0,0,18021,7.2,19353,246,50,4957,4440,24.6,1802.1,2,7,2,0,0,0,0,13064,6.4,14913,182,45,-4957,-4440,18.2,1306.4,blue,8,0.57,30,52,blue
4501457414,5,7,8,0,0,0,0,16334,7,18034,245,40,-1337,-1106,24.5,1633.4,7,5,9,2,1,1,0,17671,7.2,19140,245,60,1337,1106,24.5,1767.1,red,1.86,3.2,14,86,red
4467678363,2,6,1,0,0,0,0,13979,6.6,16912,203,48,-2871,-2427,20.3,1397.9,6,2,4,1,1,0,0,16850,7.4,19339,243,59,2871,2427,24.3,1685,blue,0.5,5,47,24,red
4523979585,3,3,3,0,0,0,0,15006,7,18694,230,51,-1271,-366,23,1500.6,3,3,3,0,0,0,0,16277,7.2,19060,264,52,1271,366,26.4,1627.7,red,2,2,16,40,red
4523775056,2,5,5,0,0,0,0,15696,7.2,18895,243,68,-1163,-19,24.3,1569.6,5,2,7,1,0,1,0,16859,7.2,18914,246,51,1163,19,24.6,1685.9,blue,1.4,6,39,44,red
4461035209,7,9,7,0,0,0,0,15946,6.8,16836,170,36,-833,-932,17,1594.6,9,7,10,1,0,1,0,16779,7,17768,230,44,833,932,23,1677.9,red,1.56,2.71,19,18,blue
4446051712,3,10,3,0,0,0,0,15548,6.8,17564,215,44,-2686,-2037,21.5,1554.8,10,3,15,1,1,0,0,18234,7.4,19601,212,43,2686,2037,21.2,1823.4,red,0.6,8.33,14,185,red
4519085208,4,1,5,1,1,0,0,15942,7.2,19003,232,71,486,865,23.2,1594.2,1,4,2,0,0,0,0,15456,7,18138,242,64,-486,-865,24.2,1545.6,blue,9,0.75,15,24,blue
4513299372,4,2,1,0,0,0,0,15727,7.4,18760,264,56,1441,473,26.4,1572.7,2,4,0,0,0,0,0,14286,7,18287,211,43,-1441,-473,21.1,1428.6,blue,2.5,0.5,19,16,blue
4519993636,7,5,10,0,0,0,0,16772,6.4,16548,228,42,192,-1496,22.8,1677.2,5,7,5,2,1,1,0,16580,6.8,18044,234,56,-192,1496,23.4,1658,red,3.4,1.43,19,20,red
4507704018,7,1,6,1,0,1,0,17820,7.6,20320,234,68,3462,2960,23.4,1782,1,7,1,1,1,0,0,14358,6.8,17360,205,60,-3462,-2960,20.5,1435.8,red,13,0.29,17,10,red
4442091284,5,8,6,0,0,0,0,16440,6.8,17567,238,55,-892,-255,23.8,1644,8,5,14,1,1,0,0,17332,7,17822,206,44,892,255,20.6,1733.2,red,1.38,4.4,24,19,blue
4524982143,10,6,15,2,1,1,1,19890,6.8,18304,214,56,3290,1398,21.4,1989,6,10,7,0,0,0,1,16600,6.6,16906,214,40,-3290,-1398,21.4,1660,blue,4.17,1.3,24,16,blue
4464866964,5,4,4,0,0,0,0,15936,7,18595,234,47,254,140,23.4,1593.6,4,5,2,1,1,0,0,15682,7,18455,205,63,-254,-140,20.5,1568.2,blue,2.25,1.2,40,17,red
4515674132,6,8,8,0,0,0,0,16065,7,17606,193,50,-1823,-2149,19.3,1606.5,8,6,7,1,1,0,0,17888,7.4,19755,234,63,1823,2149,23.4,1788.8,red,1.75,2.5,39,14,red
4515863775,3,2,3,1,0,1,1,16385,6.6,17307,215,42,962,-1646,21.5,1638.5,2,3,3,1,1,0,0,15423,7,18953,261,65,-962,1646,26.1,1542.3,blue,3,1.67,17,15,blue
4468929593,3,7,4,1,1,0,0,15315,6.8,17144,210,50,-2478,-2136,21,1531.5,7,3,7,0,0,0,0,17793,7.2,19280,231,60,2478,2136,23.1,1779.3,red,1,4.67,16,17,blue
4500614731,3,5,3,0,0,0,0,15610,7.2,19049,246,57,-99,727,24.6,1561,5,3,7,0,0,0,0,15709,6.8,18322,234,48,99,-727,23.4,1570.9,blue,1.2,4,42,17,red
4524432765,3,8,3,0,0,0,0,14650,6.8,16684,192,36,-2003,-1611,19.2,1465,8,3,11,0,0,0,0,16653,7,18295,195,43,2003,1611,19.5,1665.3,blue,0.75,6.33,20,24,blue
4524326112,4,4,4,1,0,1,0,16209,7,18146,254,52,316,-597,25.4,1620.9,4,4,4,1,1,0,0,15893,7,18743,237,57,-316,597,23.7,1589.3,red,2,2,15,16,blue
4477419321,7,6,6,0,0,0,0,16254,6.8,17374,200,47,-908,-1806,20,1625.4,6,7,8,0,0,0,0,17162,7.2,19180,227,52,908,1806,22.7,1716.2,red,2.17,2,19,24,blue
4524968728,5,11,7,0,0,0,0,15881,6.8,17927,214,39,-1943,-1582,21.4,1588.1,11,5,7,1,1,0,0,17824,7.2,19509,216,45,1943,1582,21.6,1782.4,red,1.09,3.6,19,63,red
4465123889,8,11,11,0,0,0,0,17554,6.6,16706,227,43,-1548,-1988,22.7,1755.4,11,8,13,2,1,1,0,19102,7,18694,225,58,1548,1988,22.5,1910.2,blue,1.73,3,19,27,red
4522164250,2,7,2,0,0,0,0,14329,6.6,16330,211,47,-1966,-3591,21.1,1432.9,7,2,1,1,1,0,0,16295,7.2,19921,217,64,1966,3591,21.7,1629.5,red,0.57,4,21,19,red
4426518452,5,4,4,1,1,0,0,15712,6.8,17969,221,46,-169,282,22.1,1571.2,4,5,4,0,0,0,0,15881,6.8,17687,235,50,169,-282,23.5,1588.1,blue,2.25,1.6,34,27,red
4484044944,4,11,9,0,0,0,0,16121,6.6,16956,169,65,-1587,-1578,16.9,1612.1,11,4,12,1,1,0,0,17708,6.8,18534,221,40,1587,1578,22.1,1770.8,red,1.18,5.75,89,16,red
4522781547,1,2,1,1,1,0,0,14471,6.8,17810,241,55,-355,-400,24.1,1447.1,2,1,2,0,0,0,0,14826,7.2,18210,232,56,355,400,23.2,1482.6,red,1,4,29,43,red
4506595531,5,4,5,0,0,0,0,14797,6.6,16703,195,40,-1576,-1720,19.5,1479.7,4,5,2,1,1,0,0,16373,6.8,18423,259,48,1576,1720,25.9,1637.3,blue,2.5,1.2,17,17,blue
4511868118,5,3,9,0,0,0,0,15692,6.4,16690,206,51,482,-2053,20.6,1569.2,3,5,2,1,0,1,0,15210,7.2,18743,235,54,-482,2053,23.5,1521,red,4.67,1,17,43,blue
4521042540,8,7,7,1,1,0,0,18271,7.4,19689,223,55,938,181,22.3,1827.1,7,8,6,1,0,1,0,17333,7.2,19508,204,52,-938,-181,20.4,1733.3,blue,2.14,1.62,16,11,blue
4470118865,1,4,0,0,0,0,0,14928,7,18640,229,81,-360,331,22.9,1492.8,4,1,2,1,1,0,0,15288,7,18309,213,46,360,-331,21.3,1528.8,red,0.25,6,18,18,red
4524144902,6,8,13,0,0,0,0,15835,6.8,17352,217,40,-1973,-1497,21.7,1583.5,8,6,8,0,0,0,0,17808,7.2,18849,236,60,1973,1497,23.6,1780.8,blue,2.38,2.67,14,15,blue
4494412133,10,4,10,1,0,1,1,19598,7,18704,242,44,4864,1938,24.2,1959.8,4,10,5,0,0,0,0,14734,6.8,16766,204,44,-4864,-1938,20.4,1473.4,blue,5,0.9,16,19,blue
4515511619,7,2,9,1,1,0,0,16664,7.2,18875,244,49,2543,965,24.4,1666.4,2,7,0,0,0,0,0,14121,7,17910,204,59,-2543,-965,20.4,1412.1,blue,8,0.29,16,19,red
4516768381,6,10,6,1,0,1,0,15826,7,17062,196,42,-2296,-1677,19.6,1582.6,10,6,9,1,1,0,0,18122,6.8,18739,243,45,2296,1677,24.3,1812.2,blue,1.2,3.17,22,21,blue
4521772648,6,4,7,0,0,0,0,16517,7,18263,216,57,954,570,21.6,1651.7,4,6,5,1,1,0,0,15563,6.6,17693,216,44,-954,-570,21.6,1556.3,red,3.25,1.5,15,19,blue
4523321677,5,4,5,1,0,1,1,16888,7.2,18334,225,40,1063,-391,22.5,1688.8,4,5,2,1,1,0,0,15825,7,18725,231,55,-1063,391,23.1,1582.5,red,2.5,1.2,12,15,red
4505369566,13,3,19,1,1,0,2,21872,7.2,19671,225,36,7404,5156,22.5,2187.2,3,13,3,0,0,0,0,14468,6.2,14515,169,50,-7404,-5156,16.9,1446.8,blue,10.67,0.46,19,14,blue
4519680477,8,3,7,1,1,0,0,17828,7.2,19155,242,65,3642,3850,24.2,1782.8,3,8,3,0,0,0,0,14186,6.2,15305,179,34,-3642,-3850,17.9,1418.6,blue,5,0.75,20,44,blue
4489152949,6,7,11,0,0,0,0,16535,6.8,17913,199,45,-847,11,19.9,1653.5,7,6,10,1,1,0,0,17382,6.8,17902,227,46,847,-11,22.7,1738.2,blue,2.43,2.83,23,18,blue
4487526235,4,5,4,0,0,0,0,16194,6.8,17871,238,76,376,-194,23.8,1619.4,5,4,10,2,1,1,0,15818,7,18065,215,52,-376,194,21.5,1581.8,blue,1.6,3.75,18,23,red
4519445793,5,6,2,2,1,1,0,15304,6.6,17175,195,44,-1469,116,19.5,1530.4,6,5,8,0,0,0,0,16773,6.8,17059,238,46,1469,-116,23.8,1677.3,red,1.17,2.8,24,20,blue
4523717454,2,0,4,1,0,1,0,14931,6.6,17257,215,53,1295,-80,21.5,1493.1,0,2,0,1,1,0,0,13636,7,17337,230,51,-1295,80,23,1363.6,red,12.03,0,23,20,blue
4484723064,5,7,7,0,0,0,0,15175,6.4,16256,170,60,-1243,-1229,17,1517.5,7,5,6,1,1,0,0,16418,6.8,17485,219,37,1243,1229,21.9,1641.8,red,1.71,2.6,53,18,red
4521612568,4,11,4,1,1,0,0,15089,7.2,17882,219,48,-3426,-2754,21.9,1508.9,11,4,15,0,0,0,0,18515,7.6,20636,227,48,3426,2754,22.7,1851.5,blue,0.73,6.5,17,24,red
4523737577,11,5,12,0,0,0,0,19057,7,19088,236,64,2455,1940,23.6,1905.7,5,11,10,0,0,0,0,16602,6.8,17148,226,43,-2455,-1940,22.6,1660.2,blue,4.6,1.36,20,15,blue
4516779664,7,2,10,0,0,0,0,17198,7.4,19868,233,62,1926,2119,23.3,1719.8,2,7,2,0,0,0,0,15272,6.8,17749,219,73,-1926,-2119,21.9,1527.2,blue,8.5,0.57,17,52,red
4504871499,2,7,4,1,1,0,0,14206,7,17591,210,56,-2865,-1866,21,1420.6,7,2,7,0,0,0,0,17071,7.2,19457,248,60,2865,1866,24.8,1707.1,red,0.86,7,16,16,red
4520889753,6,7,9,1,1,0,0,15303,6.6,16803,209,28,-1154,-1629,20.9,1530.3,7,6,8,0,0,0,0,16457,7,18432,207,44,1154,1629,20.7,1645.7,red,2.14,2.5,21,22,blue
4505015625,7,8,6,0,0,0,0,15257,6.4,16021,191,25,-1860,-720,19.1,1525.7,8,7,9,1,1,0,0,17117,6.6,16741,211,32,1860,720,21.1,1711.7,blue,1.62,2.43,19,18,red
4467893176,8,5,9,1,1,0,0,17643,6.6,17308,226,48,2331,25,22.6,1764.3,5,8,4,0,0,0,0,15312,6.8,17283,193,36,-2331,-25,19.3,1531.2,blue,3.4,1.12,15,19,blue
4447643758,1,1,2,0,0,0,0,14649,7,17790,229,55,-444,-877,22.9,1464.9,1,1,1,1,0,1,0,15093,7,18667,247,55,444,877,24.7,1509.3,blue,3,2,20,23,red
4379661286,5,9,3,1,1,0,0,15101,6.4,16888,187,48,-3014,-357,18.7,1510.1,9,5,13,0,0,0,0,18115,6.6,17245,252,49,3014,357,25.2,1811.5,red,0.89,4.4,17,28,red
4493819835,8,2,8,0,0,0,0,18288,7.2,18800,223,56,4377,1719,22.3,1828.8,2,8,0,0,0,0,0,13911,6.8,17081,220,48,-4377,-1719,22,1391.1,blue,8,0.25,17,17,blue
4475685776,6,1,9,0,0,0,0,17357,7.4,20069,236,56,2030,1411,23.6,1735.7,1,6,2,0,0,0,0,15327,7,18658,252,69,-2030,-1411,25.2,1532.7,blue,15,0.5,17,19,blue
4459406549,4,3,3,0,0,0,0,16101,7.4,19176,266,56,884,1028,26.6,1610.1,3,4,3,1,1,0,0,15217,7,18148,236,36,-884,-1028,23.6,1521.7,blue,2.33,1.5,18,17,red
4520611653,6,11,5,0,0,0,0,16864,7,18758,219,49,-1406,-1006,21.9,1686.4,11,6,12,0,0,0,0,18270,7.2,19764,195,67,1406,1006,19.5,1827,red,1,3.83,20,16,red
4516732122,5,9,3,0,0,0,0,14470,6.6,15760,175,36,-4259,-4262,17.5,1447,9,5,9,1,1,0,0,18729,7.4,20022,246,60,4259,4262,24.6,1872.9,red,0.89,3.6,15,25,red
4524162182,6,2,8,1,1,0,0,18027,7.2,19090,252,53,3909,1938,25.2,1802.7,2,6,1,0,0,0,0,14118,6.6,17152,219,37,-3909,-1938,21.9,1411.8,blue,7,0.5,20,17,blue
4501342795,9,7,12,1,1,0,0,18920,7.4,19580,238,44,2339,625,23.8,1892,7,9,5,0,0,0,0,16581,7,18955,220,39,-2339,-625,22,1658.1,blue,3,1.33,21,16,blue
4508799879,3,6,5,1,0,1,0,15521,6.6,16916,202,60,-1187,-714,20.2,1552.1,6,3,6,1,1,0,0,16708,7,17630,219,53,1187,714,21.9,1670.8,red,1.33,4,13,73,red
4509836530,6,8,10,0,0,0,0,15579,6.8,16638,198,38,-1314,-566,19.8,1557.9,8,6,8,1,1,0,0,16893,6.8,17204,215,48,1314,566,21.5,1689.3,blue,2,2.67,39,19,blue
4452577229,10,8,8,0,0,0,0,18602,7.4,20068,200,64,123,1313,20,1860.2,8,10,6,1,0,1,1,18479,7.2,18755,226,46,-123,-1313,22.6,1847.9,blue,2.25,1.4,20,32,blue
4507320032,6,10,9,0,0,0,0,15325,6.6,16317,192,36,-2964,-2587,19.2,1532.5,10,6,12,2,1,1,0,18289,7.2,18904,208,56,2964,2587,20.8,1828.9,red,1.5,3.67,15,17,red
4511223295,4,13,3,0,0,0,0,15161,6.6,16945,196,60,-7089,-2815,19.6,1516.1,13,4,13,0,0,0,1,22250,7.2,19760,237,55,7089,2815,23.7,2225,red,0.54,6.5,13,16,red
4512891613,8,3,10,0,0,0,0,17818,7.2,19558,238,44,2534,1730,23.8,1781.8,3,8,2,0,0,0,0,15284,7,17828,223,60,-2534,-1730,22.3,1528.4,red,6,0.62,19,14,blue
4454836834,3,13,2,0,0,0,0,14066,6.4,16007,178,46,-6966,-4723,17.8,1406.6,13,3,12,1,0,1,1,21032,7.6,20730,246,44,6966,4723,24.6,2103.2,red,0.38,8.33,16,27,red
4475524558,5,12,3,0,0,0,0,16143,6.6,17759,212,47,-3283,-582,21.2,1614.3,12,5,8,0,0,0,0,19426,6.8,18341,194,56,3283,582,19.4,1942.6,red,0.67,4,17,18,red
4512939837,4,11,3,0,0,0,0,15431,7,17705,214,54,-3460,-2389,21.4,1543.1,11,4,10,1,1,0,0,18891,7.6,20094,233,56,3460,2389,23.3,1889.1,red,0.64,5.25,20,22,blue
4513962663,8,7,5,1,0,1,0,16815,7,18326,207,41,10,223,20.7,1681.5,7,8,8,0,0,0,0,16805,6.8,18103,241,48,-10,-223,24.1,1680.5,red,1.86,1.88,22,25,blue
4469891121,7,3,5,1,0,1,0,17060,7.2,19600,242,61,2207,2836,24.2,1706,3,7,3,1,1,0,0,14853,6.6,16764,219,68,-2207,-2836,21.9,1485.3,blue,4,0.86,18,18,red
4448445178,4,10,3,0,0,0,0,15341,6.8,17802,204,44,-2310,-1604,20.4,1534.1,10,4,11,1,1,0,0,17651,7.2,19406,220,56,2310,1604,22,1765.1,red,0.7,5.25,21,20,red
4521177221,7,4,9,2,1,1,0,17012,7.2,19316,230,57,1456,1433,23,1701.2,4,7,4,0,0,0,0,15556,7,17883,220,60,-1456,-1433,22,1555.6,red,4,1.14,14,17,blue
4478343793,6,7,4,1,0,1,1,17805,7,17597,218,40,1446,-1351,21.8,1780.5,7,6,9,1,1,0,0,16359,7,18948,212,45,-1446,1351,21.2,1635.9,blue,1.43,2.67,18,39,blue
4458567616,6,12,2,0,0,0,0,16425,6.8,17934,205,60,-4561,-1835,20.5,1642.5,12,6,16,1,1,0,0,20986,7.6,19769,271,60,4561,1835,27.1,2098.6,red,0.67,4.67,21,12,red
4523704429,12,10,12,1,1,0,0,17804,6.6,16151,168,29,-612,-1019,16.8,1780.4,10,12,13,0,0,0,0,18416,6.6,17170,171,52,612,1019,17.1,1841.6,red,2.4,1.92,23,19,blue
4502093227,2,5,1,0,0,0,0,14449,6.4,16336,220,45,-1979,-338,22,1444.9,5,2,8,1,1,0,0,16428,6.8,16674,186,68,1979,338,18.6,1642.8,red,0.6,6.5,43,29,red
4516904725,10,6,15,0,0,0,0,17687,7,18169,203,52,1484,-24,20.3,1768.7,6,10,8,0,0,0,0,16203,7.2,18193,216,56,-1484,24,21.6,1620.3,blue,4.17,1.4,20,36,blue
4474588712,9,4,8,0,0,0,0,18471,7.4,19497,225,65,3252,2304,22.5,1847.1,4,9,3,1,1,0,0,15219,6.8,17193,201,62,-3252,-2304,20.1,1521.9,red,4.25,0.78,18,18,blue
4524264529,5,8,5,1,1,0,0,16245,7,17547,206,52,-1051,753,20.6,1624.5,8,5,11,0,0,0,0,17296,6.8,16794,206,48,1051,-753,20.6,1729.6,blue,1.25,3.8,16,20,red
4507707842,6,9,2,1,1,0,0,15054,6.4,16819,209,26,-2018,-1345,20.9,1505.4,9,6,14,0,0,0,0,17072,7.2,18164,169,57,2018,1345,16.9,1707.2,blue,0.89,3.83,23,21,red
4518963809,9,8,10,0,0,0,0,17216,6.6,17264,207,48,1462,1290,20.7,1721.6,8,9,9,0,0,0,0,15754,6.4,15974,165,39,-1462,-1290,16.5,1575.4,blue,2.38,1.89,16,43,blue
4499732263,4,12,2,0,0,0,0,14997,6.8,17191,218,44,-3401,-2179,21.8,1499.7,12,4,15,2,1,1,0,18398,7.4,19370,219,40,3401,2179,21.9,1839.8,blue,0.5,6.75,20,20,red
4509682522,2,6,1,0,0,0,0,14804,7,17613,239,44,-1645,-1076,23.9,1480.4,6,2,7,1,1,0,0,16449,6.8,18689,245,47,1645,1076,24.5,1644.9,blue,0.5,6.5,14,29,red
4513245442,4,3,3,1,0,1,0,15645,7.2,18594,227,56,929,1095,22.7,1564.5,3,4,2,1,1,0,0,14716,6.6,17499,205,67,-929,-1095,20.5,1471.6,red,2.33,1.25,17,18,blue
4505535527,3,9,3,0,0,0,0,15365,6.8,17435,221,55,-2450,-1150,22.1,1536.5,9,3,12,0,0,0,0,17815,7.2,18585,233,40,2450,1150,23.3,1781.5,red,0.67,7,21,21,red
4524343705,8,10,11,0,0,0,0,17524,6.8,16577,209,41,-293,-1855,20.9,1752.4,10,8,11,1,1,0,0,17817,7.2,18432,211,57,293,1855,21.1,1781.7,red,1.9,2.62,16,18,blue
4522682981,10,1,9,0,0,0,0,18324,7.4,19267,199,54,4545,3714,19.9,1832.4,1,10,1,0,0,0,0,13779,6.2,15553,195,46,-4545,-3714,19.5,1377.9,blue,19,0.2,16,16,blue
4518526662,7,6,9,2,1,1,0,17140,6.8,18226,221,68,597,875,22.1,1714,6,7,7,0,0,0,0,16543,6.8,17351,226,57,-597,-875,22.6,1654.3,blue,2.67,1.86,33,18,blue
4523631613,9,7,9,0,0,0,0,17756,7,18384,211,40,1975,969,21.1,1775.6,7,9,4,0,0,0,0,15781,6.6,17415,210,38,-1975,-969,21,1578.1,blue,2.57,1.22,23,25,blue
4516946022,14,8,12,1,1,0,0,19094,7.2,19076,196,56,1693,1287,19.6,1909.4,8,14,6,0,0,0,0,17401,6.8,17789,214,43,-1693,-1287,21.4,1740.1,red,3.25,1,26,19,red
4512078045,5,5,5,1,0,1,0,15963,7.2,18713,218,62,-985,-93,21.8,1596.3,5,5,5,1,1,0,0,16948,7.2,18806,262,61,985,93,26.2,1694.8,red,2,2,40,24,red
4524220083,14,5,10,2,1,1,1,21266,7.4,19884,231,56,7427,6558,23.1,2126.6,5,14,3,0,0,0,0,13839,5.6,13326,129,47,-7427,-6558,12.9,1383.9,blue,4.8,0.57,16,10,blue
4500135002,10,8,10,0,0,0,0,17692,7.2,18587,203,63,1018,1319,20.3,1769.2,8,10,10,1,1,0,0,16674,6.8,17268,201,38,-1018,-1319,20.1,1667.4,blue,2.5,1.8,15,13,blue
4490790295,4,7,4,1,1,0,0,14562,6.2,15997,206,35,-1857,-1976,20.6,1456.2,7,4,6,0,0,0,0,16419,7,17973,214,53,1857,1976,21.4,1641.9,red,1.14,3.25,19,21,red
4475950279,5,13,5,0,0,0,0,15881,6.6,16662,215,52,-3438,-2574,21.5,1588.1,13,5,9,1,1,0,0,19319,7.2,19236,222,52,3438,2574,22.2,1931.9,red,0.77,4.4,13,22,red
4459498926,9,8,9,0,0,0,0,17649,7,17906,207,40,1579,578,20.7,1764.9,8,9,8,0,0,0,0,16070,6.8,17328,209,36,-1579,-578,20.9,1607,red,2.25,1.78,19,13,blue
4521752199,1,5,1,1,1,0,0,14358,6.6,16468,203,56,-3071,-2267,20.3,1435.8,5,1,2,1,0,1,1,17429,7,18735,242,56,3071,2267,24.2,1742.9,red,0.4,7,21,17,red
4523323986,8,6,10,0,0,0,0,17828,7,18836,229,43,1042,-31,22.9,1782.8,6,8,3,0,0,0,0,16786,7,18867,231,52,-1042,31,23.1,1678.6,red,3,1.12,22,20,blue
4524913906,9,4,10,0,0,0,0,17495,7.4,19387,178,60,1871,2897,17.8,1749.5,4,9,3,0,0,0,0,15624,6.6,16490,227,40,-1871,-2897,22.7,1562.4,blue,4.75,0.78,12,14,blue
4516998276,3,4,2,0,0,0,0,15519,7,18382,256,58,-546,1078,25.6,1551.9,4,3,6,1,1,0,0,16065,6.8,17304,227,48,546,-1078,22.7,1606.5,red,1.25,3.33,18,24,red
4465014054,3,3,3,0,0,0,0,15365,6.8,17502,250,49,-528,-1130,25,1536.5,3,3,4,1,1,0,0,15893,7,18632,259,55,528,1130,25.9,1589.3,red,2,2.33,28,25,blue
4523556317,6,8,9,0,0,0,0,15582,6.6,16182,190,45,-1780,-1378,19,1558.2,8,6,7,1,0,1,0,17362,7,17560,229,43,1780,1378,22.9,1736.2,red,1.88,2.5,20,20,red
4482467049,4,3,5,1,1,0,0,15054,6.6,16861,223,56,-387,-725,22.3,1505.4,3,4,5,0,0,0,0,15441,6.6,17586,210,56,387,725,21,1544.1,red,3,2,22,20,blue
4522683845,3,7,5,0,0,0,0,15052,6.6,16956,204,48,-2077,-2457,20.4,1505.2,7,3,5,1,1,0,0,17129,7.2,19413,242,72,2077,2457,24.2,1712.9,red,1.14,4,13,18,red
4524557404,4,9,4,0,0,0,0,15608,6.6,16536,197,50,-1690,-2943,19.7,1560.8,9,4,8,0,0,0,0,17298,7.2,19479,220,54,1690,2943,22,1729.8,red,0.89,4.25,18,41,red
4510552697,7,9,7,2,1,1,0,16578,6.8,18186,220,50,-987,-741,22,1657.8,9,7,9,0,0,0,0,17565,7.4,18927,206,44,987,741,20.6,1756.5,blue,1.56,2.57,17,20,blue
4524530613,4,12,3,0,0,0,0,16361,6.8,17937,225,68,-2902,-1196,22.5,1636.1,12,4,16,1,1,0,0,19263,7.2,19133,231,56,2902,1196,23.1,1926.3,blue,0.58,7,18,56,red
4491776589,4,10,3,0,0,0,0,14709,6.4,16206,209,29,-2923,-1079,20.9,1470.9,10,4,12,2,1,1,0,17632,6.8,17285,232,53,2923,1079,23.2,1763.2,blue,0.7,5.5,20,18,red
4479650121,5,4,4,1,1,0,1,17457,7,18205,225,52,1495,-413,22.5,1745.7,4,5,3,0,0,0,0,15962,6.8,18618,248,53,-1495,413,24.8,1596.2,red,2.25,1.4,19,16,blue
4462420747,3,11,3,0,0,0,0,14179,6.4,16052,205,36,-4927,-3950,20.5,1417.9,11,3,11,1,1,0,0,19106,7.6,20002,230,64,4927,3950,23,1910.6,red,0.55,7.33,15,21,red
4509730924,7,5,8,0,0,0,0,16294,6.8,18342,214,50,-18,252,21.4,1629.4,5,7,4,0,0,0,0,16312,7,18090,229,45,18,-252,22.9,1631.2,blue,3,1.29,17,18,red
4495369305,2,6,2,0,0,0,0,15392,7,18126,238,60,-1045,406,23.8,1539.2,6,2,7,2,1,1,0,16437,6.8,17720,205,64,1045,-406,20.5,1643.7,red,0.67,6.5,14,16,red
4519196581,5,9,4,1,1,0,0,15534,6.6,16209,204,40,-2212,-1548,20.4,1553.4,9,5,8,0,0,0,0,17746,6.8,17757,215,60,2212,1548,21.5,1774.6,red,1,3.4,63,21,blue
4455416243,7,6,6,0,0,0,1,17462,7,18011,210,52,1323,1994,21,1746.2,6,7,8,0,0,0,0,16139,6.4,16017,215,54,-1323,-1994,21.5,1613.9,blue,2.17,2,19,19,blue
4522656427,9,10,6,0,0,0,0,17346,7.4,19356,197,59,-220,1427,19.7,1734.6,10,9,9,0,0,0,0,17566,7.2,17929,186,63,220,-1427,18.6,1756.6,red,1.5,2.11,41,14,red
4520362854,3,0,3,0,0,0,0,16248,7,18185,239,60,2086,1397,23.9,1624.8,0,3,0,1,1,0,0,14162,6.6,16788,241,56,-2086,-1397,24.1,1416.2,blue,12.03,0,39,19,blue
4512089912,5,6,4,0,0,0,0,15218,6.4,16539,211,48,-828,421,21.1,1521.8,6,5,10,0,0,0,0,16046,6.6,16118,206,34,828,-421,20.6,1604.6,blue,1.5,3.2,24,18,blue
4446235910,13,6,13,0,0,0,0,20329,7.6,20692,264,48,4227,3892,26.4,2032.9,6,13,7,0,0,0,0,16102,6.6,16800,174,40,-4227,-3892,17.4,1610.2,blue,4.33,1,27,21,blue
4481919426,9,6,13,1,1,0,0,17235,6.8,17249,196,47,1177,-691,19.6,1723.5,6,9,7,0,0,0,0,16058,6.8,17940,232,37,-1177,691,23.2,1605.8,red,3.67,1.44,16,20,red
4523064318,6,7,4,2,1,1,1,17433,6.8,17931,221,48,263,342,22.1,1743.3,7,6,9,0,0,0,0,17170,7,17589,206,48,-263,-342,20.6,1717,red,1.43,2.67,47,31,red
4495598638,3,3,5,0,0,0,0,15480,7,19018,243,61,-816,-27,24.3,1548,3,3,3,1,1,0,0,16296,7,19045,278,63,816,27,27.8,1629.6,red,2.67,2,22,23,red
4524603410,8,7,6,1,1,0,0,17850,7.2,19943,238,71,1097,1914,23.8,1785,7,8,6,0,0,0,0,16753,7,18029,224,40,-1097,-1914,22.4,1675.3,blue,2,1.62,16,18,blue
4524775982,7,5,7,0,0,0,0,16590,7,19121,210,60,1057,1295,21,1659,5,7,5,1,1,0,0,15533,7,17826,227,48,-1057,-1295,22.7,1553.3,blue,2.8,1.43,39,17,blue
4468111504,10,6,12,2,1,1,0,17706,7,18096,214,41,145,-1102,21.4,1770.6,6,10,8,0,0,0,0,17561,7,19198,221,64,-145,1102,22.1,1756.1,blue,3.67,1.4,20,12,blue
4505913217,10,5,11,1,0,1,0,18972,7.2,19388,231,36,3559,2227,23.1,1897.2,5,10,4,0,0,0,0,15413,6.6,17161,189,55,-3559,-2227,18.9,1541.3,blue,4.2,0.9,15,13,red
4523024529,6,10,8,0,0,0,0,16530,7,18808,205,54,-1726,-267,20.5,1653,10,6,12,1,1,0,0,18256,7,19075,238,46,1726,267,23.8,1825.6,red,1.4,3.67,40,23,red
4524174567,1,4,1,1,1,0,0,14911,6.8,18362,238,60,-626,895,23.8,1491.1,4,1,4,0,0,0,0,15537,6.8,17467,230,39,626,-895,23,1553.7,blue,0.5,8,16,21,red
4518140055,11,4,7,1,1,0,1,20543,7.6,20964,233,57,6529,4484,23.3,2054.3,4,11,2,0,0,0,0,14014,6.8,16480,161,60,-6529,-4484,16.1,1401.4,blue,4.5,0.55,17,12,blue
4522688388,12,6,16,2,1,1,1,21437,7.2,20067,229,60,7370,5454,22.9,2143.7,6,12,11,0,0,0,0,14067,5.8,14613,133,39,-7370,-5454,13.3,1406.7,blue,4.67,1.42,19,19,blue
4517660206,2,3,2,1,1,0,0,15185,6.8,18437,231,70,-419,-428,23.1,1518.5,3,2,2,1,0,1,0,15604,7,18865,241,53,419,428,24.1,1560.4,blue,1.33,2.5,41,25,blue
4486642684,3,3,3,0,0,0,0,15275,6.8,17812,217,56,-701,346,21.7,1527.5,3,3,5,1,1,0,0,15976,6.8,17466,214,56,701,-346,21.4,1597.6,red,2,2.67,20,13,red
4489343082,9,2,12,1,1,0,0,18581,6.8,17855,229,55,4279,1907,22.9,1858.1,2,9,3,0,0,0,0,14302,6.4,15948,239,44,-4279,-1907,23.9,1430.2,blue,10.5,0.56,19,15,blue
4522571135,8,6,11,1,1,0,0,17072,7.2,18825,205,42,-164,851,20.5,1707.2,6,8,8,1,0,1,0,17236,7,17974,244,45,164,-851,24.4,1723.6,blue,3.17,1.75,47,19,blue
4501039898,5,6,10,1,1,0,0,15758,6.4,16364,190,72,-882,-1760,19,1575.8,6,5,5,0,0,0,0,16640,7,18124,253,40,882,1760,25.3,1664,red,2.5,2.2,23,22,blue
4491473852,3,7,5,0,0,0,0,15144,6.8,17285,224,50,-2283,-1969,22.4,1514.4,7,3,9,1,1,0,0,17427,7.2,19254,259,62,2283,1969,25.9,1742.7,red,1.14,5.33,21,49,red
4455553618,4,4,4,1,1,0,0,15742,7.2,18562,244,52,-896,-1292,24.4,1574.2,4,4,4,0,0,0,0,16638,7.4,19854,252,72,896,1292,25.2,1663.8,blue,2,2,81,16,red
4504703082,6,10,6,0,0,0,0,15161,6.6,16711,187,36,-3312,-3119,18.7,1516.1,10,6,11,1,0,1,0,18473,7.4,19830,223,48,3312,3119,22.3,1847.3,red,1.2,3.5,15,14,blue
4522523284,5,8,3,0,0,0,0,16554,6.8,18076,216,56,-505,-580,21.6,1655.4,8,5,13,1,0,1,0,17059,7,18656,193,71,505,580,19.3,1705.9,red,1,4.2,18,37,red
4486940002,3,7,4,1,1,0,0,14384,6.2,15955,199,36,-3388,-3025,19.9,1438.4,7,3,9,0,0,0,0,17772,7.2,18980,256,52,3388,3025,25.6,1777.2,red,1,5.33,20,25,red
4445410783,10,7,8,0,0,0,0,17183,7,17906,208,45,1100,170,20.8,1718.3,7,10,5,1,1,0,0,16083,7,17736,166,47,-1100,-170,16.6,1608.3,blue,2.57,1.2,42,18,blue
4514023677,3,6,3,0,0,0,0,15165,6.8,17462,218,62,-1995,-1194,21.8,1516.5,6,3,13,0,0,0,0,17160,7.2,18656,251,55,1995,1194,25.1,1716,red,1,6.33,18,23,blue
4523728834,6,10,5,0,0,0,0,16747,6.8,18099,214,52,-1391,-16,21.4,1674.7,10,6,12,1,1,0,0,18138,6.8,18115,189,72,1391,16,18.9,1813.8,blue,1.1,3.67,19,12,red
4470382093,6,8,5,0,0,0,0,16625,7.2,18202,226,48,-810,-730,22.6,1662.5,8,6,9,0,0,0,0,17435,7.4,18932,234,48,810,730,23.4,1743.5,red,1.38,2.83,20,21,blue
4478763628,5,8,5,0,0,0,0,15738,6.8,16964,215,42,-1769,-1859,21.5,1573.8,8,5,15,1,1,0,0,17507,7.2,18823,185,81,1769,1859,18.5,1750.7,red,1.25,4.6,16,21,red
4499439386,6,3,7,2,1,1,0,16326,7,18447,232,44,1165,744,23.2,1632.6,3,6,3,0,0,0,0,15161,7,17703,231,53,-1165,-744,23.1,1516.1,red,4.33,1,19,17,red
4517062497,5,8,2,0,0,0,0,15334,7,18085,204,63,-2564,-35,20.4,1533.4,8,5,12,0,0,0,0,17898,7,18120,227,44,2564,35,22.7,1789.8,red,0.88,4,17,104,red
4467411161,9,8,7,1,0,1,1,18490,6.8,16745,215,33,479,-658,21.5,1849,8,9,15,1,1,0,0,18011,6.8,17403,230,47,-479,658,23,1801.1,red,2,2.56,20,17,blue
4493142787,5,8,5,0,0,0,0,15542,6.6,16959,188,59,-2118,-2048,18.8,1554.2,8,5,8,1,1,0,0,17660,7.2,19007,238,44,2118,2048,23.8,1766,red,1.25,3.2,18,73,blue
4497865298,3,4,2,0,0,0,0,15409,6.8,17883,240,44,-729,-900,24,1540.9,4,3,4,0,0,0,0,16138,7,18783,250,44,729,900,25,1613.8,red,1.25,2.67,16,35,blue
4473264225,6,15,9,0,0,0,0,16205,6.4,15951,171,44,-3719,-3695,17.1,1620.5,15,6,14,1,1,0,0,19924,7.4,19646,216,48,3719,3695,21.6,1992.4,red,1,4.83,19,45,blue
4525063445,8,8,8,1,0,1,0,16836,6.8,17998,228,49,-52,-301,22.8,1683.6,8,8,12,0,0,0,0,16888,7,18299,186,52,52,301,18.6,1688.8,blue,2,2.5,17,17,red
4439408623,1,2,1,1,1,0,0,14862,7,18359,237,56,9,-172,23.7,1486.2,2,1,2,1,0,1,0,14853,7.2,18531,199,80,-9,172,19.9,1485.3,blue,1,4,19,15,red
4522834412,8,7,11,1,1,0,0,17971,7,19666,209,64,523,-69,20.9,1797.1,7,8,9,0,0,0,0,17448,7.2,19735,237,61,-523,69,23.7,1744.8,blue,2.71,2,47,29,blue
4519649944,4,4,8,1,1,0,0,15689,7,18377,211,64,673,1681,21.1,1568.9,4,4,5,0,0,0,0,15016,6.6,16696,210,43,-673,-1681,21,1501.6,blue,3,2.25,36,17,red
4484693756,3,3,2,0,0,0,0,15751,6.8,17685,252,46,926,328,25.2,1575.1,3,3,3,0,0,0,0,14825,6.8,17357,215,49,-926,-328,21.5,1482.5,blue,1.67,2,18,50,red
4453021099,11,10,11,0,0,0,0,17535,6.8,17282,200,23,-400,-1684,20,1753.5,10,11,9,1,1,0,0,17935,7.2,18966,211,69,400,1684,21.1,1793.5,red,2.2,1.73,54,46,blue
4521600378,3,0,5,0,0,0,0,16419,7,19867,276,61,1783,1420,27.6,1641.9,0,3,0,1,1,0,0,14636,6.8,18447,257,68,-1783,-1420,25.7,1463.6,blue,12.03,0,36,17,blue
4508648367,2,3,4,0,0,0,0,13757,6.4,16461,220,34,-1752,-1746,22,1375.7,3,2,6,0,0,0,0,15509,7.2,18207,238,60,1752,1746,23.8,1550.9,blue,2,4.5,59,21,red
4475027319,10,4,12,1,1,0,0,18491,7.2,19416,237,55,3517,2881,23.7,1849.1,4,10,4,0,0,0,0,14974,6.8,16535,211,48,-3517,-2881,21.1,1497.4,blue,5.5,0.8,21,17,red
4520853310,4,4,7,0,0,0,0,15536,6.6,17282,190,43,-680,410,19,1553.6,4,4,8,1,1,0,0,16216,6.6,16872,215,53,680,-410,21.5,1621.6,blue,2.75,3,37,62,red
4509014561,7,1,3,2,1,1,0,16817,7.2,19506,237,64,3021,2386,23.7,1681.7,1,7,0,0,0,0,0,13796,6.8,17120,214,44,-3021,-2386,21.4,1379.6,blue,10,0.14,27,37,blue
4469572120,6,7,5,2,1,1,0,16683,7,18169,213,58,-73,333,21.3,1668.3,7,6,11,0,0,0,0,16756,6.8,17836,213,47,73,-333,21.3,1675.6,blue,1.57,3,13,14,blue
4525175959,8,4,10,1,1,0,0,17161,7.2,18145,206,48,1577,-50,20.6,1716.1,4,8,2,0,0,0,0,15584,7,18195,214,48,-1577,50,21.4,1558.4,red,4.5,0.75,20,20,blue
4505058404,2,5,1,0,0,0,0,14815,7,17728,226,59,-2116,-2156,22.6,1481.5,5,2,6,1,0,1,0,16931,7.2,19884,237,80,2116,2156,23.7,1693.1,red,0.6,5.5,17,21,red
4463256999,11,5,11,0,0,0,0,18180,7,18464,190,47,2575,1454,19,1818,5,11,6,1,1,0,0,15605,6.6,17010,203,48,-2575,-1454,20.3,1560.5,blue,4.4,1,16,34,blue
4500087956,6,3,6,0,0,0,0,16993,7.4,19908,230,60,1886,1688,23,1699.3,3,6,4,0,0,0,0,15107,7,18220,230,48,-1886,-1688,23,1510.7,red,4,1.17,23,20,blue
4500463152,2,11,4,0,0,0,0,14023,6.4,15096,187,59,-4659,-3268,18.7,1402.3,11,2,18,1,1,0,0,18682,7.2,18364,225,44,4659,3268,22.5,1868.2,red,0.55,14.5,19,24,red
4510577994,5,7,2,0,0,0,0,16256,6.8,17771,247,48,-862,-406,24.7,1625.6,7,5,10,1,1,0,0,17118,7,18177,200,60,862,406,20,1711.8,blue,1,3.4,13,19,red
4424593685,3,3,4,0,0,0,0,14462,6.6,15785,197,47,-360,-1748,19.7,1446.2,3,3,2,1,0,1,0,14822,6.8,17533,209,56,360,1748,20.9,1482.2,red,2.33,1.67,17,24,red
4523518605,4,5,5,2,1,1,0,15825,6.8,17561,225,58,460,-1107,22.5,1582.5,5,4,3,0,0,0,0,15365,7,18668,218,54,-460,1107,21.8,1536.5,blue,1.8,2,18,19,blue
4521703092,8,5,16,1,1,0,0,17616,7,18517,235,68,1790,1220,23.5,1761.6,5,8,7,0,0,0,0,15826,6.8,17297,231,36,-1790,-1220,23.1,1582.6,blue,4.8,1.5,20,23,blue
4511623078,1,4,1,1,1,0,0,14322,6.8,17759,236,48,-1970,-1177,23.6,1432.2,4,1,5,1,0,1,0,16292,7,18936,222,77,1970,1177,22.2,1629.2,blue,0.5,9,45,33,red
4523305351,5,4,6,1,0,1,0,16033,6.8,17303,211,51,1073,103,21.1,1603.3,4,5,2,1,1,0,0,14960,6.8,17200,225,50,-1073,-103,22.5,1496,blue,2.75,1.2,22,19,red
4495664229,3,7,7,0,0,0,0,14887,6.6,16190,214,48,-1725,-2004,21.4,1488.7,7,3,6,1,1,0,0,16612,6.8,18194,242,48,1725,2004,24.2,1661.2,blue,1.43,4.33,48,22,blue
4518870205,12,6,12,0,0,0,0,18688,7,18316,199,40,2936,1143,19.9,1868.8,6,12,7,2,1,1,0,15752,6.8,17173,207,64,-2936,-1143,20.7,1575.2,blue,4,1.08,17,16,blue
4511166126,4,7,6,0,0,0,0,15074,6.8,17596,214,52,-2054,-731,21.4,1507.4,7,4,10,2,1,1,0,17128,7,18327,211,50,2054,731,21.1,1712.8,blue,1.43,4.25,37,16,red
4483111734,3,6,3,0,0,0,0,14647,7.2,17841,185,68,-2084,-851,18.5,1464.7,6,3,6,2,1,1,0,16731,7,18692,251,40,2084,851,25.1,1673.1,red,1,4,14,15,red
4506060701,5,4,3,0,0,0,0,15678,7,18321,221,65,-394,1166,22.1,1567.8,4,5,6,0,0,0,0,16072,6.6,17155,230,46,394,-1166,23,1607.2,blue,2,2,33,17,red
4519451852,1,9,1,0,0,0,0,13627,6.4,15650,206,48,-3366,-1822,20.6,1362.7,9,1,9,1,1,0,0,16993,6.8,17472,205,45,3366,1822,20.5,1699.3,red,0.22,18,16,18,red
4457086177,9,2,12,2,1,1,0,18890,7.2,19533,236,48,4237,2338,23.6,1889,2,9,4,0,0,0,0,14653,6.6,17195,226,59,-4237,-2338,22.6,1465.3,blue,10.5,0.67,67,23,blue
4524274738,2,8,0,0,0,0,0,13636,6.6,16872,190,46,-3455,-2405,19,1363.6,8,2,8,0,0,0,0,17091,7,19277,217,42,3455,2405,21.7,1709.1,blue,0.25,8,16,62,red
4434706257,14,2,16,0,0,0,0,19339,7.4,18982,197,39,5578,3447,19.7,1933.9,2,14,2,0,0,0,0,13761,6.2,15535,179,48,-5578,-3447,17.9,1376.1,blue,15,0.29,14,19,blue
4521341731,5,5,8,0,0,0,0,15473,6.8,17268,219,36,-130,-423,21.9,1547.3,5,5,7,0,0,0,0,15603,7,17691,221,51,130,423,22.1,1560.3,red,2.6,2.4,105,18,blue
4498093464,3,5,4,0,0,0,0,14535,6.6,16967,182,52,-2491,-1771,18.2,1453.5,5,3,5,1,1,0,0,17026,7.2,18738,241,55,2491,1771,24.1,1702.6,red,1.4,3.33,16,14,red
4494603900,2,7,1,1,0,1,0,14752,6.8,17234,239,48,-2406,-2686,23.9,1475.2,7,2,8,1,1,0,0,17158,7.2,19920,218,72,2406,2686,21.8,1715.8,red,0.43,7.5,25,18,blue
4518160396,3,5,4,1,1,0,0,14323,6.6,16834,184,55,-2546,-2542,18.4,1432.3,5,3,5,1,0,1,0,16869,7.6,19376,243,70,2546,2542,24.3,1686.9,blue,1.4,3.33,15,17,blue
4502442635,6,5,8,0,0,0,0,15890,6.4,15995,178,36,237,-1307,17.8,1589,5,6,5,1,1,0,0,15653,7,17302,202,44,-237,1307,20.2,1565.3,red,2.8,1.67,19,41,blue
4426899779,12,7,11,0,0,0,0,18028,6.8,16592,179,46,411,1075,17.9,1802.8,7,12,11,2,1,1,1,17617,6.2,15517,176,34,-411,-1075,17.6,1761.7,blue,3.29,1.5,23,29,red
4515649293,4,8,8,0,0,0,0,15352,6.4,15672,193,46,-1702,-1490,19.3,1535.2,8,4,13,1,1,0,0,17054,6.6,17162,191,44,1702,1490,19.1,1705.4,blue,1.5,5.25,14,16,blue
4525051331,8,4,12,1,1,0,0,17306,6.8,18073,237,43,2170,1383,23.7,1730.6,4,8,5,0,0,0,0,15136,6.4,16690,218,44,-2170,-1383,21.8,1513.6,blue,5,1.12,20,16,red
4486777926,6,6,8,0,0,0,0,15380,7,17373,193,55,-2064,-2639,19.3,1538,6,6,5,0,0,0,0,17444,7.6,20012,242,60,2064,2639,24.2,1744.4,red,2.33,1.83,22,41,blue
4496990681,4,5,7,1,1,0,0,15376,6.6,16496,225,40,-733,-784,22.5,1537.6,5,4,6,0,0,0,0,16109,6.6,17280,201,52,733,784,20.1,1610.9,red,2.2,2.75,22,16,red
4517750009,6,7,9,1,1,0,0,16815,7.2,17824,235,48,683,-208,23.5,1681.5,7,6,12,1,0,1,0,16132,6.8,18032,179,48,-683,208,17.9,1613.2,blue,2.14,3.17,14,15,blue
4506462868,4,6,5,0,0,0,0,15364,7,18063,210,51,-946,630,21,1536.4,6,4,8,1,1,0,0,16310,6.8,17433,229,40,946,-630,22.9,1631,blue,1.5,3.5,26,23,red
4508715619,5,4,3,0,0,0,0,16199,7,18624,205,65,512,858,20.5,1619.9,4,5,4,0,0,0,0,15687,6.8,17766,218,61,-512,-858,21.8,1568.7,red,2,1.6,20,20,blue
4452404347,12,7,7,0,0,0,0,17539,7.6,20178,189,46,686,765,18.9,1753.9,7,12,7,0,0,0,0,16853,7,19413,208,63,-686,-765,20.8,1685.3,blue,2.71,1.17,18,29,red
4517523977,8,10,5,1,0,1,0,16781,6.8,17736,180,42,-1611,-1624,18,1678.1,10,8,13,1,1,0,0,18392,7.4,19360,188,53,1611,1624,18.8,1839.2,red,1.3,2.88,13,16,red
4515520189,11,8,10,0,0,0,0,17819,7,18112,232,34,811,376,23.2,1781.9,8,11,14,0,0,0,0,17008,7,17736,222,40,-811,-376,22.2,1700.8,blue,2.62,2,43,28,red
4524400852,14,8,14,2,1,1,1,21927,7.4,20604,250,57,5263,3213,25,2192.7,8,14,11,0,0,0,0,16664,7,17391,174,51,-5263,-3213,17.4,1666.4,blue,3.5,1.36,18,25,blue
4489597845,6,7,3,0,0,0,0,16621,7,19161,231,60,-249,1420,23.1,1662.1,7,6,6,1,1,0,0,16870,6.8,17741,203,60,249,-1420,20.3,1687,red,1.29,2.17,16,20,red
4472951560,13,8,16,1,1,0,0,19865,7.2,18655,225,39,2819,1294,22.5,1986.5,8,13,8,0,0,0,0,17046,6.8,17361,210,44,-2819,-1294,21,1704.6,blue,3.62,1.23,25,18,red
4521903062,8,8,7,0,0,0,0,17208,7.2,18748,197,48,87,435,19.7,1720.8,8,8,5,0,0,0,0,17121,7,18313,222,47,-87,-435,22.2,1712.1,blue,1.88,1.62,42,13,blue
4510868167,1,8,0,1,1,0,0,13631,6.6,16334,220,48,-3839,-3318,22,1363.1,8,1,7,1,0,1,0,17470,7.4,19652,233,55,3839,3318,23.3,1747,red,0.12,15,146,41,red
4459302014,10,5,10,0,0,0,0,18588,7.2,18890,229,48,2824,1346,22.9,1858.8,5,10,3,0,0,0,0,15764,6.8,17544,214,44,-2824,-1346,21.4,1576.4,blue,4,0.8,17,17,blue
4468404862,5,7,8,1,1,0,0,15173,6.6,17549,186,60,-2159,-1280,18.6,1517.3,7,5,9,0,0,0,0,17332,7.2,18829,227,47,2159,1280,22.7,1733.2,red,1.86,3.2,27,16,red
4522853770,6,6,5,0,0,0,0,17188,7.4,19429,250,56,326,1163,25,1718.8,6,6,6,0,0,0,0,16862,7.2,18266,219,72,-326,-1163,21.9,1686.2,blue,1.83,2,45,30,red
4506557116,6,12,8,0,0,0,0,15511,6.4,15296,171,50,-4775,-4080,17.1,1551.1,12,6,12,1,1,0,0,20286,7.4,19376,237,52,4775,4080,23.7,2028.6,red,1.17,4,21,17,red
4472443604,5,13,8,0,0,0,0,15642,6.4,15825,214,35,-3811,-3107,21.4,1564.2,13,5,12,1,1,0,0,19453,7.2,18932,210,59,3811,3107,21,1945.3,red,1,5,19,16,red
4522164881,5,3,1,1,1,0,0,15620,7.2,18429,187,72,896,1396,18.7,1562,3,5,2,0,0,0,0,14724,6.6,17033,227,54,-896,-1396,22.7,1472.4,red,2,1,44,19,blue
4469947346,5,6,8,0,0,0,0,15577,6.6,16572,197,45,-1218,-1528,19.7,1557.7,6,5,11,2,1,1,0,16795,7,18100,239,64,1218,1528,23.9,1679.5,blue,2.17,3.4,16,18,red
4498876812,3,10,1,0,0,0,0,14689,6.6,16533,195,52,-3089,-2151,19.5,1468.9,10,3,16,1,1,0,0,17778,7,18684,219,48,3089,2151,21.9,1777.8,red,0.4,8.67,16,16,red
4515228681,1,5,1,0,0,0,0,14758,6.8,17522,245,49,-1277,-1357,24.5,1475.8,5,1,9,2,1,1,0,16035,7.2,18879,223,60,1277,1357,22.3,1603.5,red,0.4,14,20,23,red
4500634961,14,3,20,1,1,0,0,20028,7.4,20153,229,51,5885,4694,22.9,2002.8,3,14,3,0,0,0,0,14143,6.2,15459,160,60,-5885,-4694,16,1414.3,blue,11.33,0.43,38,23,blue
4477238060,13,2,18,1,0,1,2,22212,7.4,19473,257,40,8977,5411,25.7,2221.2,2,13,3,0,0,0,0,13235,6,14062,161,52,-8977,-5411,16.1,1323.5,blue,15.5,0.38,39,62,blue
4465222745,4,6,9,0,0,0,0,15858,7,17780,215,54,-1050,522,21.5,1585.8,6,4,10,0,0,0,0,16908,6.8,17258,213,52,1050,-522,21.3,1690.8,blue,2.17,4,16,13,red
4481698613,5,5,1,0,0,0,0,16109,7.2,19122,237,64,-1599,332,23.7,1610.9,5,5,3,2,1,1,1,17708,7.2,18790,248,60,1599,-332,24.8,1770.8,red,1.2,1.6,18,15,blue
4438293749,4,7,4,0,0,0,0,15381,7.2,18597,222,56,-758,313,22.2,1538.1,7,4,5,0,0,0,0,16139,7.2,18284,194,51,758,-313,19.4,1613.9,blue,1.14,3,15,16,red
4454098285,2,4,5,0,0,0,0,14680,7,17305,222,52,-1413,-729,22.2,1468,4,2,7,1,0,1,0,16093,7.2,18034,234,60,1413,729,23.4,1609.3,red,1.75,5.5,14,10,red
4440743974,11,10,9,2,1,1,0,18504,7.4,19524,226,40,1011,480,22.6,1850.4,10,11,12,0,0,0,0,17493,7.2,19044,187,52,-1011,-480,18.7,1749.3,blue,2,2,17,19,blue
4520357816,7,4,2,0,0,0,0,15911,7,17640,219,38,428,1015,21.9,1591.1,4,7,5,1,1,0,0,15483,6.6,16625,234,45,-428,-1015,23.4,1548.3,red,2.25,1.29,17,14,blue
4461216989,8,4,12,0,0,0,0,18340,7.2,18170,250,56,3206,1437,25,1834,4,8,7,0,0,0,0,15134,6.6,16733,180,63,-3206,-1437,18,1513.4,blue,5,1.38,41,22,blue
4524629083,8,4,11,1,1,0,0,17008,7.2,18943,197,65,2135,1653,19.7,1700.8,4,8,3,0,0,0,0,14873,6.8,17290,205,40,-2135,-1653,20.5,1487.3,blue,4.75,0.88,18,19,blue
4517934723,8,12,6,0,0,0,0,16760,7.2,18264,217,36,-1302,73,21.7,1676,12,8,8,1,1,0,0,18062,7,18191,199,36,1302,-73,19.9,1806.2,red,1.17,2.5,41,149,red
4523059751,4,4,3,0,0,0,0,16669,7.4,19026,266,51,565,275,26.6,1666.9,4,4,5,1,1,0,0,16104,7.2,18751,238,56,-565,-275,23.8,1610.4,blue,1.75,2.25,18,23,red
4515840054,7,4,7,0,0,0,0,17771,7.8,20856,217,81,1958,3140,21.7,1777.1,4,7,6,1,1,0,0,15813,6.8,17716,239,49,-1958,-3140,23.9,1581.3,blue,3.5,1.43,42,24,blue
4465445670,9,1,5,0,0,0,0,17773,7.2,18937,236,46,4257,2902,23.6,1777.3,1,9,1,0,0,0,0,13516,6.4,16035,204,53,-4257,-2902,20.4,1351.6,red,14,0.22,18,17,blue
4524597902,10,9,13,1,1,0,0,18217,6.6,16663,190,44,1674,-648,19,1821.7,9,10,7,0,0,0,0,16543,7,17311,192,36,-1674,648,19.2,1654.3,blue,2.56,1.6,16,19,blue
4433180879,5,7,6,1,1,0,0,15408,7,17993,209,52,-928,-1753,20.9,1540.8,7,5,3,0,0,0,0,16336,7.4,19746,237,56,928,1753,23.7,1633.6,blue,1.57,2,40,21,red
4486514272,7,6,10,0,0,0,0,16360,6.4,16497,218,44,-75,144,21.8,1636,6,7,8,0,0,0,0,16435,6.8,16353,207,40,75,-144,20.7,1643.5,red,2.83,2,18,16,blue
4521693462,1,8,1,0,0,0,0,13141,6.6,16162,202,39,-4046,-2777,20.2,1314.1,8,1,5,1,0,1,0,17187,7.2,18939,214,52,4046,2777,21.4,1718.7,red,0.25,13,13,13,red
4487298777,2,9,3,0,0,0,0,13860,6.8,16225,195,39,-4138,-3792,19.5,1386,9,2,7,1,0,1,0,17998,7.4,20017,229,52,4138,3792,22.9,1799.8,red,0.56,8,20,43,red
4515568453,8,10,6,0,0,0,0,15995,6.8,17109,172,57,-3535,-1199,17.2,1599.5,10,8,13,1,1,0,1,19530,7.2,18308,220,44,3535,1199,22,1953,red,1.4,2.88,16,11,red
4458587612,2,9,1,0,0,0,0,14442,6.6,16650,202,48,-4719,-2129,20.2,1444.2,9,2,10,1,1,0,1,19161,7,18779,225,48,4719,2129,22.5,1916.1,red,0.33,9.5,15,19,red
4518705910,13,3,16,2,1,1,1,20125,7.4,20117,226,43,5900,5188,22.6,2012.5,3,13,8,0,0,0,0,14225,6.2,14929,179,45,-5900,-5188,17.9,1422.5,blue,9.67,0.85,19,18,red
4482429113,6,2,5,1,1,0,0,16542,7,19007,227,56,1818,1992,22.7,1654.2,2,6,0,0,0,0,0,14724,6.6,17015,234,44,-1818,-1992,23.4,1472.4,red,5.5,0.33,20,21,blue
4520529503,1,4,1,0,0,0,0,13943,6.4,17306,229,50,-3461,-1353,22.9,1394.3,4,1,6,2,1,1,1,17404,7,18659,244,60,3461,1353,24.4,1740.4,blue,0.5,10,14,20,red
4499941811,8,11,6,1,1,0,0,16836,6.6,16495,215,41,-1521,-2096,21.5,1683.6,11,8,12,0,0,0,0,18357,7,18591,215,51,1521,2096,21.5,1835.7,blue,1.27,2.88,12,21,blue
4471276142,9,7,14,1,1,0,0,17631,7,17645,199,38,1328,1043,19.9,1763.1,7,9,7,0,0,0,0,16303,6.6,16602,188,56,-1328,-1043,18.8,1630.3,blue,3.29,1.56,14,16,blue
4507014159,9,6,12,0,0,0,0,16765,6.6,16518,181,34,911,-276,18.1,1676.5,6,9,4,1,1,0,0,15854,6.8,16794,182,50,-911,276,18.2,1585.4,blue,3.5,1.11,20,25,red
4495813537,8,4,9,1,0,1,0,18001,7.2,19477,233,55,2111,1390,23.3,1800.1,4,8,5,1,1,0,0,15890,6.8,18087,228,71,-2111,-1390,22.8,1589,blue,4.25,1.12,20,22,blue
4494408624,13,13,14,0,0,0,0,19580,7,18977,201,45,935,2197,20.1,1958,13,13,14,0,0,0,0,18645,6.6,16780,179,32,-935,-2197,17.9,1864.5,blue,2.08,2.08,47,16,red
4521989550,4,10,2,0,0,0,0,14774,6.6,16999,214,40,-3032,-2816,21.4,1477.4,10,4,11,2,1,1,0,17806,7.2,19815,215,52,3032,2816,21.5,1780.6,red,0.6,5.25,15,40,red
4520787933,8,7,11,1,1,0,0,17525,7,17738,202,61,-425,-1057,20.2,1752.5,7,8,6,0,0,0,0,17950,7,18795,264,54,425,1057,26.4,1795,blue,2.71,1.62,29,25,blue
4458756399,10,8,7,0,0,0,0,19280,7.2,19831,240,52,2365,2052,24,1928,8,10,8,0,0,0,0,16915,7,17779,211,40,-2365,-2052,21.1,1691.5,blue,2.12,1.6,30,43,red
4500392073,7,4,5,1,1,0,0,17929,7.4,20365,233,59,3140,3364,23.3,1792.9,4,7,4,1,0,1,0,14789,6.6,17001,201,52,-3140,-3364,20.1,1478.9,blue,3,1.14,97,21,red
4517787854,5,5,6,0,0,0,0,15988,6.8,17843,215,43,-779,-1837,21.5,1598.8,5,5,3,0,0,0,0,16767,7.4,19680,235,71,779,1837,23.5,1676.7,blue,2.2,1.6,19,32,red
4525240556,10,7,5,1,1,0,0,17214,7.2,18566,200,62,1690,1316,20,1721.4,7,10,9,0,0,0,0,15524,6.8,17250,162,42,-1690,-1316,16.2,1552.4,blue,2.14,1.6,16,40,blue
4516127508,6,2,6,2,1,1,0,15897,6.8,18168,188,68,1433,522,18.8,1589.7,2,6,1,0,0,0,0,14464,6.8,17646,215,51,-1433,-522,21.5,1446.4,blue,6,0.5,42,20,red
4517940231,7,4,16,1,1,0,1,18539,7,18188,253,53,3466,1525,25.3,1853.9,4,7,2,1,0,1,0,15073,6.6,16663,222,42,-3466,-1525,22.2,1507.3,blue,5.75,0.86,22,27,red
4503044010,10,4,14,2,1,1,0,18132,6.8,17869,212,42,1947,136,21.2,1813.2,4,10,3,0,0,0,0,16185,6.6,17733,219,49,-1947,-136,21.9,1618.5,blue,6,0.7,23,27,blue
4480429391,13,2,11,2,1,1,1,21382,7.2,20346,246,48,6624,4865,24.6,2138.2,2,13,4,0,0,0,0,14758,6.2,15481,185,51,-6624,-4865,18.5,1475.8,blue,12,0.46,15,16,blue
4503648979,8,2,7,1,1,0,0,17011,7.2,17776,194,55,2659,2757,19.4,1701.1,2,8,2,0,0,0,0,14352,6,15019,201,37,-2659,-2757,20.1,1435.2,blue,7.5,0.5,25,41,blue
4524341789,11,3,12,1,1,0,1,20206,7.4,19702,221,52,6275,4789,22.1,2020.6,3,11,2,0,0,0,0,13931,6.2,14913,187,40,-6275,-4789,18.7,1393.1,blue,7.67,0.45,22,15,blue
4521194149,9,6,6,2,1,1,0,17673,7.2,19727,208,68,1369,2756,20.8,1767.3,6,9,7,0,0,0,0,16304,6.6,16971,216,48,-1369,-2756,21.6,1630.4,blue,2.5,1.44,21,22,blue
4517064230,9,7,10,1,0,1,0,16983,6.8,17424,183,40,422,-308,18.3,1698.3,7,9,6,1,1,0,0,16561,7,17732,200,64,-422,308,20,1656.1,blue,2.71,1.44,15,17,blue
4521349358,4,7,4,0,0,0,0,15139,7,18041,216,56,-2281,-42,21.6,1513.9,7,4,8,1,1,0,0,17420,7,18083,244,48,2281,42,24.4,1742,red,1.14,3.75,13,18,red
4519052446,10,6,11,2,1,1,0,18132,7.6,19522,232,47,1722,1514,23.2,1813.2,6,10,8,0,0,0,0,16410,7.2,18008,211,44,-1722,-1514,21.1,1641,blue,3.5,1.4,43,25,blue
4473786370,4,4,6,1,1,0,0,15867,6.6,17723,186,71,-1595,-1648,18.6,1586.7,4,4,4,0,0,0,0,17462,7.2,19371,253,64,1595,1648,25.3,1746.2,red,2.5,2,23,22,red
4485591192,4,6,6,1,1,0,0,15931,6.8,17539,222,52,-730,-251,22.2,1593.1,6,4,7,0,0,0,0,16661,7,17790,213,64,730,251,21.3,1666.1,blue,1.67,3.25,23,20,red
4509007045,8,9,9,1,0,1,0,17610,6.8,17779,212,52,-1168,-674,21.2,1761,9,8,17,1,1,0,0,18778,7.2,18453,229,54,1168,674,22.9,1877.8,blue,1.89,3.25,27,57,blue
4523507519,9,4,14,0,0,0,0,17495,7,18537,208,40,2546,1928,20.8,1749.5,4,9,2,0,0,0,0,14949,6.6,16609,211,50,-2546,-1928,21.1,1494.9,blue,5.75,0.67,18,17,blue
4459277927,5,6,6,0,0,0,0,16230,7.4,19157,228,44,-839,-833,22.8,1623,6,5,3,2,1,1,0,17069,7.4,19990,239,88,839,833,23.9,1706.9,red,1.83,1.8,36,20,red
4485957777,3,8,1,0,0,0,0,14496,6.8,16623,230,48,-2317,-1330,23,1449.6,8,3,11,2,1,1,0,16813,7,17953,223,44,2317,1330,22.3,1681.3,red,0.5,6.33,20,21,red
4461961055,6,5,7,1,0,1,0,16008,6.8,17798,216,44,-904,-178,21.6,1600.8,5,6,4,0,0,0,0,16912,7,17976,257,47,904,178,25.7,1691.2,red,2.6,1.5,26,92,blue
4454039126,7,10,9,0,0,0,0,16923,6.8,17782,224,36,-673,568,22.4,1692.3,10,7,13,1,1,0,0,17596,7,17214,199,42,673,-568,19.9,1759.6,red,1.6,3.29,22,50,red
4480259472,9,4,9,1,1,0,0,19462,7.6,19955,239,68,4444,2813,23.9,1946.2,4,9,3,0,0,0,0,15018,6.6,17142,209,48,-4444,-2813,20.9,1501.8,blue,4.5,0.78,52,40,blue
4479666137,7,6,6,0,0,0,0,16482,7,17266,229,43,-1243,-604,22.9,1648.2,6,7,15,0,0,0,0,17725,7,17870,194,56,1243,604,19.4,1772.5,red,2.17,3,14,68,red
4513258080,5,9,5,1,0,1,0,15592,7,17700,218,39,-2078,-1506,21.8,1559.2,9,5,6,0,0,0,0,17670,7.6,19206,205,51,2078,1506,20.5,1767,blue,1.11,3,19,25,blue
4516357947,8,9,12,1,1,0,1,17268,6.6,15979,194,48,-952,-1337,19.4,1726.8,9,8,7,1,0,1,0,18220,6.6,17316,214,55,952,1337,21.4,1822,red,2.22,2,20,20,blue
4503839400,5,9,4,0,0,0,0,15167,6.6,16733,195,56,-2132,-1088,19.5,1516.7,9,5,7,0,0,0,0,17299,7,17821,215,42,2132,1088,21.5,1729.9,red,1,3.2,19,20,red
4463214221,5,5,10,1,1,0,0,15847,6.8,17480,203,68,-1015,-1395,20.3,1584.7,5,5,9,1,0,1,0,16862,7.2,18875,256,52,1015,1395,25.6,1686.2,red,3,2.8,21,19,red
4489499692,7,4,8,1,0,1,0,16333,7.2,18737,204,44,517,585,20.4,1633.3,4,7,4,1,1,0,0,15816,6.8,18152,234,60,-517,-585,23.4,1581.6,red,3.75,1.14,22,19,blue
4518416008,5,9,6,0,0,0,0,16032,6.8,17171,220,45,-2222,-1252,22,1603.2,9,5,10,1,1,0,0,18254,7,18423,225,40,2222,1252,22.5,1825.4,blue,1.22,3.8,21,16,red
4525236524,5,6,3,1,1,0,0,15762,7,18318,216,52,-208,-353,21.6,1576.2,6,5,5,0,0,0,0,15970,7,18671,221,48,208,353,22.1,1597,blue,1.33,2.2,16,18,red
4449091810,3,6,4,0,0,0,0,14749,6.8,17146,200,49,-2513,-3419,20,1474.9,6,3,5,0,0,0,0,17262,7.4,20565,246,70,2513,3419,24.6,1726.2,red,1.17,3.67,54,15,red
4495119818,4,4,9,1,0,1,0,15405,6.8,17336,215,57,-601,-1965,21.5,1540.5,4,4,5,1,1,0,0,16006,7.2,19301,249,71,601,1965,24.9,1600.6,blue,3.25,2.25,19,17,blue
4521615656,7,4,4,1,1,0,0,16775,7,18235,221,55,1753,2303,22.1,1677.5,4,7,7,0,0,0,0,15022,6.4,15932,213,45,-1753,-2303,21.3,1502.2,blue,2.75,1.57,14,22,red
4522289326,2,3,1,1,1,0,0,14667,6.8,18007,202,55,-751,-1229,20.2,1466.7,3,2,5,0,0,0,0,15418,7.2,19236,239,60,751,1229,23.9,1541.8,red,1,4,15,15,blue
4522419081,7,6,6,1,0,1,0,17409,6.8,18063,241,51,1430,107,24.1,1740.9,6,7,7,1,1,0,0,15979,7,17956,173,54,-1430,-107,17.3,1597.9,blue,2.17,1.86,20,20,blue
4524709324,5,6,5,1,1,0,0,15706,6.6,17219,228,43,-469,-1237,22.8,1570.6,6,5,4,0,0,0,0,16175,7,18456,229,56,469,1237,22.9,1617.5,blue,1.67,2,17,24,blue
4505305847,9,7,7,1,1,0,0,16466,6.6,16716,188,44,-1099,-1318,18.8,1646.6,7,9,7,0,0,0,0,17565,7,18034,232,40,1099,1318,23.2,1756.5,blue,2.29,1.56,24,53,blue
4463534767,12,5,12,0,0,0,1,20190,7.2,19713,200,64,5553,3915,20,2019,5,12,4,1,1,0,0,14637,6.4,15798,149,46,-5553,-3915,14.9,1463.7,blue,4.8,0.75,18,18,red
4497843332,9,4,13,0,0,0,0,17408,7.2,19121,204,56,2091,1359,20.4,1740.8,4,9,2,0,0,0,0,15317,6.8,17762,227,48,-2091,-1359,22.7,1531.7,blue,5.5,0.67,20,82,blue
4500092661,4,8,5,1,1,0,0,15591,7,17848,228,59,-1951,-1575,22.8,1559.1,8,4,6,0,0,0,0,17542,7.4,19423,236,42,1951,1575,23.6,1754.2,red,1.12,3.5,21,23,red
4522839614,6,6,7,1,1,0,0,16410,7.2,18288,211,60,96,-24,21.1,1641,6,6,5,0,0,0,0,16314,7,18312,203,48,-96,24,20.3,1631.4,blue,2.17,1.83,17,17,blue
4520990343,9,6,9,0,0,0,0,17854,7.2,18784,219,43,1762,2377,21.9,1785.4,6,9,7,1,0,1,0,16092,6.6,16407,202,40,-1762,-2377,20.2,1609.2,red,3,1.44,20,18,red
4461377893,8,2,9,1,0,1,0,17243,7.2,19173,233,50,3082,1360,23.3,1724.3,2,8,0,0,0,0,0,14161,6.6,17813,222,45,-3082,-1360,22.2,1416.1,blue,8.5,0.25,18,51,blue
4514817366,9,3,17,1,1,0,0,16987,7.2,18514,189,40,2608,3387,18.9,1698.7,3,9,5,0,0,0,0,14379,6.4,15127,172,43,-2608,-3387,17.2,1437.9,blue,8.67,0.89,72,26,blue
4522792539,5,3,3,0,0,0,0,14818,6.4,16417,204,28,-1460,-2414,20.4,1481.8,3,5,3,0,0,0,0,16278,7.4,18831,231,59,1460,2414,23.1,1627.8,red,2.67,1.2,18,15,blue
4521560262,11,3,11,1,1,0,0,18633,7.4,19659,232,49,3784,2577,23.2,1863.3,3,11,3,0,0,0,0,14849,6.8,17082,209,57,-3784,-2577,20.9,1484.9,blue,7.33,0.55,18,16,blue
4513629766,10,12,8,0,0,0,0,17566,6.8,17314,202,44,-2053,-1784,20.2,1756.6,12,10,12,2,1,1,0,19619,7,19098,214,55,2053,1784,21.4,1961.9,red,1.5,2.4,17,18,blue
4475629470,4,7,4,0,0,0,0,14956,6.6,16196,198,41,-2020,-2716,19.8,1495.6,7,4,2,0,0,0,0,16976,7.2,18912,246,55,2020,2716,24.6,1697.6,red,1.14,2.25,17,20,red
4460560219,8,6,9,1,1,0,0,18206,7.2,19094,224,56,1137,-92,22.4,1820.6,6,8,6,0,0,0,0,17069,7.4,19186,220,68,-1137,92,22,1706.9,red,2.83,1.5,16,16,red
4522403826,6,8,11,0,0,0,0,15758,7,16369,204,34,-1561,-1578,20.4,1575.8,8,6,9,0,0,0,0,17319,7,17947,213,48,1561,1578,21.3,1731.9,red,2.12,2.83,19,18,blue
4513255821,1,4,1,0,0,0,0,15632,7.2,18155,268,60,-598,-1285,26.8,1563.2,4,1,6,2,1,1,0,16230,7.2,19440,238,78,598,1285,23.8,1623,red,0.5,10,22,20,red
4517057084,7,9,8,0,0,0,0,16278,6.6,16530,181,36,-1829,-1668,18.1,1627.8,9,7,10,1,1,0,0,18107,7,18198,212,52,1829,1668,21.2,1810.7,red,1.67,2.71,14,16,red
4525066184,11,4,10,1,1,0,0,17131,7.2,18732,215,44,2036,1891,21.5,1713.1,4,11,3,0,0,0,0,15095,6.8,16841,188,56,-2036,-1891,18.8,1509.5,blue,5.25,0.64,59,18,blue
4482482069,8,10,9,1,1,0,0,16795,6.8,18177,203,43,-1381,-907,20.3,1679.5,10,8,9,0,0,0,0,18176,7.2,19084,221,60,1381,907,22.1,1817.6,blue,1.7,2.38,12,14,blue
4515777597,12,7,20,1,1,0,0,19070,7,17872,210,56,2247,1367,21,1907,7,12,9,0,0,0,0,16823,6.6,16505,205,38,-2247,-1367,20.5,1682.3,blue,4.57,1.33,27,23,blue
4523469931,5,5,5,1,1,0,0,15993,7,18392,227,62,-800,72,22.7,1599.3,5,5,6,0,0,0,0,16793,7.2,18320,243,46,800,-72,24.3,1679.3,blue,2,2.2,16,18,blue
4485800348,6,6,6,0,0,0,0,15715,6.6,16563,188,44,-826,-979,18.8,1571.5,6,6,7,1,0,1,0,16541,7,17542,237,36,826,979,23.7,1654.1,red,2,2.17,14,13,blue
4450484115,11,3,9,1,1,0,0,18583,7.2,18852,204,55,4280,2681,20.4,1858.3,3,11,2,0,0,0,0,14303,6.4,16171,202,48,-4280,-2681,20.2,1430.3,blue,6.67,0.45,20,18,blue
4477885741,9,9,11,1,1,0,0,16848,6.6,16664,200,35,-973,-2691,20,1684.8,9,9,12,0,0,0,0,17821,7,19355,214,54,973,2691,21.4,1782.1,red,2.22,2.33,16,19,blue
4520615634,8,4,11,1,1,0,0,17903,7.2,19715,206,71,1970,1999,20.6,1790.3,4,8,4,0,0,0,0,15933,7,17716,234,43,-1970,-1999,23.4,1593.3,blue,4.75,1,39,16,blue
4486662543,3,6,5,1,0,1,0,14724,6.6,16522,195,52,-1858,-1476,19.5,1472.4,6,3,7,1,1,0,0,16582,7,17998,225,52,1858,1476,22.5,1658.2,blue,1.33,4.33,21,18,red
4378558412,8,11,9,0,0,0,0,16371,6.6,16354,201,40,-1867,-2002,20.1,1637.1,11,8,11,1,1,0,0,18238,7.2,18356,190,52,1867,2002,19,1823.8,red,1.55,2.75,19,20,red
4515245246,7,9,14,2,1,1,0,16571,6.2,14758,192,32,-684,-2401,19.2,1657.1,9,7,16,0,0,0,0,17255,6.8,17159,187,54,684,2401,18.7,1725.5,blue,2.33,3.57,18,15,blue
4489091340,4,9,6,0,0,0,0,15445,6.8,17126,225,44,-3056,-2938,22.5,1544.5,9,4,8,1,1,0,0,18501,7.4,20064,221,68,3056,2938,22.1,1850.1,blue,1.11,4.25,21,48,blue
4523527545,4,10,2,0,0,0,0,13980,6.2,15464,181,43,-4330,-4347,18.1,1398,10,4,12,0,0,0,0,18310,7.4,19811,228,44,4330,4347,22.8,1831,red,0.6,5.5,16,25,blue
4491680252,11,13,6,0,0,0,0,17984,7,18165,178,50,-1348,105,17.8,1798.4,13,11,10,1,1,0,0,19332,6.8,18060,210,50,1348,-105,21,1933.2,blue,1.31,2.09,20,21,red
4515671582,8,6,11,0,0,0,0,17588,7.2,18523,238,47,1800,713,23.8,1758.8,6,8,9,1,1,0,0,15788,6.8,17810,192,48,-1800,-713,19.2,1578.8,blue,3.17,1.88,33,14,red
4513177860,6,5,8,0,0,0,0,16326,7.2,18838,222,50,509,595,22.2,1632.6,5,6,1,1,1,0,0,15817,6.8,18243,231,56,-509,-595,23.1,1581.7,red,2.8,1,17,18,blue
4495407654,7,4,9,0,0,0,0,17610,6.8,17644,233,48,1883,973,23.3,1761,4,7,4,0,0,0,0,15727,6.6,16671,212,62,-1883,-973,21.2,1572.7,red,4,1.14,21,18,red
4525128614,8,8,9,0,0,0,0,17238,6.8,17944,209,44,894,-3,20.9,1723.8,8,8,10,0,0,0,0,16344,7,17947,187,44,-894,3,18.7,1634.4,red,2.12,2.25,26,17,blue
4513317903,6,10,3,1,1,0,0,15602,6.4,16415,206,45,-3060,-2937,20.6,1560.2,10,6,7,0,0,0,0,18662,7.4,19352,238,48,3060,2937,23.8,1866.2,red,0.9,2.83,22,26,red
4467307786,7,9,8,0,0,0,0,15615,6.8,17025,188,39,-3370,-2779,18.8,1561.5,9,7,7,1,0,1,0,18985,7.2,19804,250,52,3370,2779,25,1898.5,red,1.67,2.29,18,22,red
4524750008,6,5,7,1,1,0,0,15138,6.6,16193,191,43,-452,-1060,19.1,1513.8,5,6,5,0,0,0,0,15590,7,17253,206,56,452,1060,20.6,1559,red,2.6,1.67,19,21,blue
4517836612,8,5,8,1,1,0,0,18021,7.2,19358,253,52,1790,1764,25.3,1802.1,5,8,4,0,0,0,0,16231,7,17594,237,47,-1790,-1764,23.7,1623.1,blue,3.2,1.12,18,26,blue
4497823613,2,1,5,1,0,1,0,15063,6.6,17160,227,56,790,-1155,22.7,1506.3,1,2,0,1,1,0,0,14273,7,18315,217,68,-790,1155,21.7,1427.3,red,7,0.5,21,21,blue
4517750444,7,5,8,1,1,0,0,17561,6.6,17813,215,64,545,411,21.5,1756.1,5,7,1,1,0,1,1,17016,6.6,17402,218,44,-545,-411,21.8,1701.6,blue,3,0.86,21,17,blue
4500140173,7,1,10,1,0,1,0,17696,7.2,19541,257,56,3518,2503,25.7,1769.6,1,7,1,1,1,0,0,14178,6.6,17038,239,47,-3518,-2503,23.9,1417.8,blue,17,0.29,48,32,red
4498589837,5,4,5,2,1,1,0,16548,6.8,18505,226,64,780,523,22.6,1654.8,4,5,5,0,0,0,0,15768,7,17982,226,52,-780,-523,22.6,1576.8,blue,2.5,1.8,18,34,blue
4515298308,3,2,2,1,1,0,0,14610,6.6,17048,206,53,-758,-1310,20.6,1461,2,3,2,0,0,0,0,15368,7,18358,249,57,758,1310,24.9,1536.8,red,2.5,1.33,16,33,blue
4521756971,17,6,26,0,0,0,0,20604,6.8,18469,194,51,4565,2632,19.4,2060.4,6,17,6,1,1,0,0,16039,6.4,15837,202,32,-4565,-2632,20.2,1603.9,blue,7.17,0.71,60,28,blue
4520706769,9,6,8,1,1,0,0,17698,7.2,19290,206,56,726,1104,20.6,1769.8,6,9,5,0,0,0,0,16972,6.8,18186,229,52,-726,-1104,22.9,1697.2,red,2.83,1.22,57,18,blue
4522322962,4,4,3,0,0,0,0,15021,6.8,16981,207,44,-1254,-956,20.7,1502.1,4,4,5,2,1,1,0,16275,7,17937,249,48,1254,956,24.9,1627.5,red,1.75,2.25,15,39,blue
4510687386,3,7,2,0,0,0,0,15226,6.8,17102,210,64,-1207,-218,21,1522.6,7,3,7,0,0,0,0,16433,6.6,17320,215,44,1207,218,21.5,1643.3,red,0.71,4.67,16,23,red
4518172684,3,4,4,1,0,1,1,17064,7,18451,263,52,1167,-1436,26.3,1706.4,4,3,5,1,1,0,0,15897,7.2,19887,214,72,-1167,1436,21.4,1589.7,red,1.75,3,32,16,blue
4464183105,1,3,1,0,0,0,0,15221,6.8,17418,266,45,-179,-463,26.6,1522.1,3,1,4,1,1,0,0,15400,6.6,17881,240,46,179,463,24,1540,red,0.67,7,22,18,blue
4456900643,10,4,9,1,0,1,0,17972,7.2,19155,206,44,2363,1314,20.6,1797.2,4,10,3,0,0,0,0,15609,6.8,17841,226,59,-2363,-1314,22.6,1560.9,red,4.75,0.7,34,18,blue
4516791797,9,7,9,0,0,0,0,18151,7.2,19393,227,44,847,1606,22.7,1815.1,7,9,9,0,0,0,0,17304,7,17787,226,60,-847,-1606,22.6,1730.4,blue,2.57,1.78,20,19,red
4455128161,13,2,16,1,1,0,0,19773,7.6,20507,240,40,5622,3964,24,1977.3,2,13,4,0,0,0,0,14151,6.6,16543,203,64,-5622,-3964,20.3,1415.1,blue,14.5,0.46,20,16,blue
4511208354,5,4,5,0,0,0,0,16262,7,18089,235,62,467,850,23.5,1626.2,4,5,4,0,0,0,0,15795,6.8,17239,228,43,-467,-850,22.8,1579.5,blue,2.5,1.6,16,16,blue
4505180174,7,7,8,1,1,0,0,17044,7,17819,200,55,-115,141,20,1704.4,7,7,7,0,0,0,0,17159,7,17678,209,56,115,-141,20.9,1715.9,red,2.14,2,20,12,blue
4457518581,7,1,9,0,0,0,0,17562,7.2,19532,213,59,3512,2161,21.3,1756.2,1,7,2,1,1,0,0,14050,6.8,17371,215,62,-3512,-2161,21.5,1405,blue,16,0.43,25,18,blue
4522167652,3,6,4,0,0,0,0,14364,6.8,16898,204,48,-2845,-1461,20.4,1436.4,6,3,5,1,1,0,0,17209,7,18359,208,55,2845,1461,20.8,1720.9,red,1.17,3.67,18,20,red
4524923771,9,2,10,0,0,0,0,17855,7.2,18853,211,60,4076,2996,21.1,1785.5,2,9,1,1,1,0,0,13779,6.6,15857,211,44,-4076,-2996,21.1,1377.9,blue,9.5,0.33,26,46,blue
4523304085,6,9,6,2,1,1,0,15874,6.4,16649,195,48,-1806,-2407,19.5,1587.4,9,6,11,0,0,0,0,17680,7.2,19056,228,58,1806,2407,22.8,1768,blue,1.33,3.33,23,25,blue
4470749064,6,7,6,0,0,0,0,16881,7,18851,228,56,-216,301,22.8,1688.1,7,6,6,0,0,0,0,17097,7,18550,233,44,216,-301,23.3,1709.7,blue,1.71,2.17,17,15,red
4523605131,11,5,8,1,0,1,0,18060,7.2,18502,192,44,1635,416,19.2,1806,5,11,3,0,0,0,0,16425,6.6,18086,204,56,-1635,-416,20.4,1642.5,red,3.8,0.73,18,15,blue
4510700294,4,10,2,0,0,0,0,15106,6.8,16691,201,44,-3081,-1236,20.1,1510.6,10,4,14,0,0,0,0,18187,6.8,17927,192,51,3081,1236,19.2,1818.7,red,0.6,6,19,21,red
4515457790,4,1,3,0,0,0,0,16454,7.6,19703,241,60,2711,2693,24.1,1645.4,1,4,1,0,0,0,0,13743,6.6,17010,211,55,-2711,-2693,21.1,1374.3,blue,7,0.5,32,123,blue
4486240093,8,1,13,1,1,0,0,18078,6.8,18559,247,50,5354,4695,24.7,1807.8,1,8,0,0,0,0,0,12724,6,13864,166,46,-5354,-4695,16.6,1272.4,blue,21,0.12,19,19,blue
4503747242,4,5,4,0,0,0,0,15300,6.6,17024,212,43,-188,-535,21.2,1530,5,4,5,0,0,0,0,15488,6.8,17559,232,48,188,535,23.2,1548.8,red,1.6,2.5,19,22,red
4476477033,7,3,1,2,1,1,1,18919,7.6,20248,252,73,3983,3375,25.2,1891.9,3,7,5,0,0,0,0,14936,6.8,16873,230,38,-3983,-3375,23,1493.6,blue,2.67,1.14,15,59,blue
4518570301,2,4,4,1,0,1,0,15565,6.4,17312,251,64,-1185,-2402,25.1,1556.5,4,2,8,1,1,0,0,16750,7.4,19714,267,62,1185,2402,26.7,1675,blue,1.5,6,19,23,blue
4459757488,11,2,17,1,1,0,0,18553,7,18514,204,49,4260,1422,20.4,1855.3,2,11,1,0,0,0,0,14293,6.8,17092,210,60,-4260,-1422,21,1429.3,blue,14,0.27,14,15,blue
4506187431,3,3,2,0,0,0,0,16639,7.2,19375,269,64,835,1506,26.9,1663.9,3,3,4,1,1,0,0,15804,7,17869,216,56,-835,-1506,21.6,1580.4,blue,1.67,2.33,18,41,red
4513970902,8,6,7,0,0,0,0,18273,7,18951,211,49,2879,2522,21.1,1827.3,6,8,7,0,0,0,0,15394,6.4,16429,195,32,-2879,-2522,19.5,1539.4,blue,2.5,1.62,25,18,blue
4461214115,6,8,5,0,0,0,0,16560,7,18074,203,65,-407,-1257,20.3,1656,8,6,7,1,1,0,0,16967,7.4,19331,223,52,407,1257,22.3,1696.7,blue,1.38,2.5,13,49,blue
4524840446,5,10,7,0,0,0,0,13742,5.6,12556,123,18,-5705,-5364,12.3,1374.2,10,5,11,1,1,0,0,19447,6.8,17920,218,40,5705,5364,21.8,1944.7,red,1.2,4.2,13,14,red
4497854220,9,5,12,1,1,0,0,17525,7,19083,221,40,1270,365,22.1,1752.5,5,9,2,0,0,0,0,16255,7.4,18718,218,60,-1270,-365,21.8,1625.5,red,4.2,0.78,19,39,red
4493955025,4,9,5,1,1,0,0,15123,6.8,17144,210,45,-3204,-779,21,1512.3,9,4,16,1,0,1,0,18327,7,17923,216,36,3204,779,21.6,1832.7,red,1,6.25,22,15,blue
4492581081,4,7,4,0,0,0,0,14686,6.4,15538,184,32,-3927,-3207,18.4,1468.6,7,4,4,1,0,1,1,18613,7,18745,262,46,3927,3207,26.2,1861.3,red,1.14,2.75,15,16,red
4489707726,8,7,12,1,1,0,0,16957,6.6,17656,215,42,78,658,21.5,1695.7,7,8,11,0,0,0,0,16879,6.8,16998,207,40,-78,-658,20.7,1687.9,blue,2.86,2.25,32,18,red
4518120338,4,2,3,0,0,0,0,16796,7.2,19731,276,56,1789,2100,27.6,1679.6,2,4,4,0,0,0,0,15007,6.8,17631,232,59,-1789,-2100,23.2,1500.7,blue,3.5,1.5,13,19,red
4506208717,10,7,12,0,0,0,0,18592,7.2,19027,212,47,1577,678,21.2,1859.2,7,10,4,2,1,1,0,17015,7,18349,233,44,-1577,-678,23.3,1701.5,red,3.14,1.1,86,17,blue
4523066845,8,4,10,0,0,0,0,16411,6.6,17513,176,43,590,1002,17.6,1641.1,4,8,4,0,0,0,0,15821,6.6,16511,208,47,-590,-1002,20.8,1582.1,red,4.5,1,41,21,red
4474824262,5,4,4,0,0,0,0,15730,6.6,16849,223,49,-384,-1408,22.3,1573,4,5,3,1,1,0,0,16114,7,18257,220,61,384,1408,22,1611.4,red,2.25,1.4,29,11,blue
4525227627,4,5,2,1,1,0,0,16302,7.2,18728,256,56,315,667,25.6,1630.2,5,4,3,1,0,1,0,15987,6.8,18061,224,52,-315,-667,22.4,1598.7,blue,1.2,2,26,16,red
4463141174,4,2,2,1,0,1,0,15447,6.6,16928,217,52,580,-1033,21.7,1544.7,2,4,2,1,1,0,0,14867,6.8,17961,228,64,-580,1033,22.8,1486.7,red,3,1,21,24,blue
4517807085,6,3,7,1,0,1,1,17299,6.6,17431,223,36,1870,-729,22.3,1729.9,3,6,4,1,1,0,0,15429,7,18160,226,60,-1870,729,22.6,1542.9,blue,4.33,1.17,18,19,blue
4515215762,8,3,8,2,1,1,0,17500,6.8,18340,229,55,3308,2114,22.9,1750,3,8,3,0,0,0,0,14192,6.6,16226,215,28,-3308,-2114,21.5,1419.2,blue,5.33,0.75,20,9,red
4454996740,4,7,5,1,1,0,0,15659,7.2,19051,210,83,-2542,1134,21,1565.9,7,4,15,1,0,1,1,18201,7,17917,233,48,2542,-1134,23.3,1820.1,red,1.29,5.5,15,14,red
4519099479,7,6,8,0,0,0,0,16286,7,17910,223,40,369,561,22.3,1628.6,6,7,8,0,0,0,0,15917,7,17349,196,52,-369,-561,19.6,1591.7,red,2.5,2,18,16,red
4499598970,3,2,6,1,1,0,0,15335,6.8,17847,239,47,187,-954,23.9,1533.5,2,3,1,0,0,0,0,15148,6.8,18801,248,63,-187,954,24.8,1514.8,red,4.5,1,26,21,blue
4525110748,8,5,6,2,1,1,0,17744,7.2,19502,237,59,1109,735,23.7,1774.4,5,8,3,0,0,0,0,16635,7.2,18767,231,60,-1109,-735,23.1,1663.5,red,2.8,1,18,15,red
4441457542,9,6,10,1,1,0,0,17592,7.4,19457,213,52,1572,2134,21.3,1759.2,6,9,9,1,0,1,0,16020,6.8,17323,211,42,-1572,-2134,21.1,1602,blue,3.17,1.67,17,20,blue
4521097121,3,9,4,1,1,0,0,15732,7,17644,201,72,-2080,-202,20.1,1573.2,9,3,12,1,0,1,0,17812,7.2,17846,202,48,2080,202,20.2,1781.2,red,0.78,7,24,16,red
4524920237,5,11,6,0,0,0,0,16544,7,17851,222,53,-2929,-1731,22.2,1654.4,11,5,17,1,1,0,0,19473,7.2,19582,227,48,2929,1731,22.7,1947.3,red,1,5.6,27,16,blue
4524404839,11,11,14,0,0,0,0,18913,7,18431,215,31,1441,922,21.5,1891.3,11,11,11,1,1,0,0,17472,7,17509,200,24,-1441,-922,20,1747.2,blue,2.27,2,86,18,red
4466952270,6,5,5,0,0,0,0,16757,7.2,18596,225,46,873,2194,22.5,1675.7,5,6,7,0,0,0,0,15884,6.6,16402,205,65,-873,-2194,20.5,1588.4,blue,2.2,2,21,15,red
4521716722,4,8,2,0,0,0,0,16152,7,18347,212,59,-633,-502,21.2,1615.2,8,4,14,1,1,0,0,16785,7,18849,196,53,633,502,19.6,1678.5,blue,0.75,5.5,18,141,blue
4512957425,2,2,2,1,0,1,0,14505,7,18312,224,48,-838,-593,22.4,1450.5,2,2,1,1,1,0,0,15343,7.2,18905,253,67,838,593,25.3,1534.3,red,2,1.5,90,21,blue
4477903272,4,6,6,0,0,0,0,15575,6.8,17478,236,44,-1098,271,23.6,1557.5,6,4,10,0,0,0,0,16673,6.8,17207,245,39,1098,-271,24.5,1667.3,blue,1.67,4,14,18,blue
4451606008,6,5,12,1,0,1,0,18187,7.2,19397,257,40,1909,1010,25.7,1818.7,5,6,4,1,1,0,0,16278,7,18387,248,52,-1909,-1010,24.8,1627.8,red,3.6,1.5,54,19,blue
4516924172,8,10,3,1,0,1,0,16674,6.8,18357,223,40,-1577,-716,22.3,1667.4,10,8,11,0,0,0,0,18251,7,19073,209,50,1577,716,20.9,1825.1,blue,1.1,2.62,16,82,blue
4520919497,8,8,8,1,1,0,0,16028,6.6,16233,187,36,-728,-608,18.7,1602.8,8,8,7,0,0,0,0,16756,6.8,16841,184,43,728,608,18.4,1675.6,red,2,1.88,15,16,red
4502814468,5,6,6,0,0,0,0,16157,7,17878,221,51,142,1215,22.1,1615.7,6,5,6,1,1,0,0,16015,6.8,16663,199,41,-142,-1215,19.9,1601.5,red,1.83,2.4,14,117,blue
4518564856,6,9,5,0,0,0,0,15773,7,18578,228,44,-2069,-22,22.8,1577.3,9,6,11,1,1,0,0,17842,7,18600,222,56,2069,22,22.2,1784.2,red,1.22,3.33,16,14,red
4495636315,4,3,5,0,0,0,0,17262,7,18608,248,52,1673,1200,24.8,1726.2,3,4,2,2,1,1,0,15589,6.8,17408,197,69,-1673,-1200,19.7,1558.9,blue,3,1.25,14,13,blue
4483701739,3,10,3,1,1,0,0,14367,6.4,15957,192,53,-5085,-3236,19.2,1436.7,10,3,13,0,0,0,0,19452,7.4,19193,249,48,5085,3236,24.9,1945.2,red,0.6,7.67,22,22,red
4497602150,5,4,10,1,1,0,0,15387,7,17708,174,66,337,1346,17.4,1538.7,4,5,4,0,0,0,0,15050,6.8,16362,213,48,-337,-1346,21.3,1505,blue,3.75,1.6,22,27,red
4472647396,3,4,1,1,1,0,0,15326,7.2,18992,226,59,-233,1969,22.6,1532.6,4,3,5,0,0,0,0,15559,6.6,17023,222,43,233,-1969,22.2,1555.9,blue,1,3,51,23,red
4524677634,7,4,11,0,0,0,0,16867,7.2,18904,219,57,920,1488,21.9,1686.7,4,7,6,1,1,0,0,15947,7,17416,210,54,-920,-1488,21,1594.7,blue,4.5,1.43,20,20,blue
4446210050,3,3,0,1,1,0,0,14162,6.8,17402,201,54,-1078,692,20.1,1416.2,3,3,4,0,0,0,0,15240,6.8,16710,240,45,1078,-692,24,1524,blue,1,2.33,41,15,blue
4523810614,5,5,6,1,1,0,0,16253,6.8,18163,212,46,-17,-1171,21.2,1625.3,5,5,2,0,0,0,0,16270,7.2,19334,243,55,17,1171,24.3,1627,red,2.2,1.4,18,17,red
4523592716,1,9,2,1,1,0,0,14041,6.6,16529,229,49,-4377,-4323,22.9,1404.1,9,1,5,0,0,0,0,18418,7.4,20852,234,79,4377,4323,23.4,1841.8,red,0.33,14,16,19,red
4471271254,8,4,9,0,0,0,0,18051,7.2,19471,247,64,2563,2910,24.7,1805.1,4,8,4,0,0,0,0,15488,6.6,16561,233,40,-2563,-2910,23.3,1548.8,blue,4.25,1,16,16,blue
4459614716,4,3,5,0,0,0,0,16441,7,18447,244,52,1254,400,24.4,1644.1,3,4,4,0,0,0,0,15187,6.8,18047,218,60,-1254,-400,21.8,1518.7,blue,3,1.75,59,21,blue
4509531529,4,4,7,1,1,0,0,16157,6.8,18679,239,64,-521,97,23.9,1615.7,4,4,3,0,0,0,0,16678,7,18582,255,57,521,-97,25.5,1667.8,red,2.75,1.75,21,26,red
4484505320,10,6,9,1,0,1,1,19793,7.4,19966,243,65,3387,1454,24.3,1979.3,6,10,9,1,1,0,0,16406,7,18512,239,50,-3387,-1454,23.9,1640.6,red,3.17,1.5,16,56,blue
4494902684,7,8,8,1,1,0,0,16284,7.4,19396,197,44,-496,604,19.7,1628.4,8,7,7,0,0,0,0,16780,7,18792,209,48,496,-604,20.9,1678,blue,1.88,2.14,34,41,red
4511505654,5,11,4,0,0,0,0,15617,6.6,17334,202,63,-3516,-2677,20.2,1561.7,11,5,6,1,0,1,0,19133,7.4,20011,237,52,3516,2677,23.7,1913.3,red,0.82,3.4,108,14,red
4507096347,6,7,4,1,1,0,0,17261,7,18583,206,56,1579,1615,20.6,1726.1,7,6,9,0,0,0,0,15682,6.6,16968,184,36,-1579,-1615,18.4,1568.2,blue,1.43,2.67,23,22,blue
4459235569,8,9,9,1,1,0,0,17385,7.2,18439,185,70,-747,-782,18.5,1738.5,9,8,12,0,0,0,0,18132,7.4,19221,214,50,747,782,21.4,1813.2,red,1.89,2.62,18,20,blue
4471303802,15,9,14,0,0,0,0,20134,7.4,19414,183,52,2445,1767,18.3,2013.4,9,15,7,0,0,0,0,17689,7,17647,221,36,-2445,-1767,22.1,1768.9,blue,3.22,1.07,21,14,red
4524284970,3,2,4,1,1,0,0,14867,7,17875,205,52,-178,738,20.5,1486.7,2,3,2,0,0,0,0,15045,6.8,17137,245,49,178,-738,24.5,1504.5,blue,3.5,1.33,19,21,red
4496870934,4,7,5,0,0,0,0,15312,6.6,16387,203,48,-1844,-2222,20.3,1531.2,7,4,10,0,0,0,0,17156,7.2,18609,227,48,1844,2222,22.7,1715.6,red,1.29,4.25,13,16,blue
4520783162,2,3,2,2,1,1,0,14815,6.8,18140,246,56,-980,-1488,24.6,1481.5,3,2,0,0,0,0,0,15795,7.4,19628,259,62,980,1488,25.9,1579.5,blue,1.33,1.5,17,18,red
4521693404,5,2,6,1,0,1,0,17511,7.4,20020,253,59,2795,2702,25.3,1751.1,2,5,2,1,1,0,0,14716,7,17318,244,52,-2795,-2702,24.4,1471.6,red,5.5,0.8,16,14,blue
4450965514,8,14,10,0,0,0,0,17157,6.6,17475,200,36,-2095,-2096,20,1715.7,14,8,15,0,0,0,0,19252,7.4,19571,206,44,2095,2096,20.6,1925.2,red,1.29,3.62,23,22,red
4502662072,12,12,16,0,0,0,0,18714,6.8,18333,199,37,801,262,19.9,1871.4,12,12,12,0,0,0,0,17913,6.8,18071,182,37,-801,-262,18.2,1791.3,red,2.33,2,15,19,blue
4467297984,8,10,5,1,1,0,0,17136,6.8,18329,224,60,-506,-700,22.4,1713.6,10,8,7,0,0,0,0,17642,7.2,19029,218,34,506,700,21.8,1764.2,blue,1.3,2.12,15,17,blue
4503251133,8,7,7,0,0,0,0,16966,7.4,19266,228,55,705,2576,22.8,1696.6,7,8,5,1,1,0,0,16261,6.6,16690,198,47,-705,-2576,19.8,1626.1,blue,2.14,1.5,20,20,red
4518566693,7,6,7,0,0,0,0,16948,7,18437,222,44,707,1131,22.2,1694.8,6,7,6,0,0,0,0,16241,6.8,17306,221,32,-707,-1131,22.1,1624.1,blue,2.33,1.71,22,15,red
4521258237,7,3,8,0,0,0,0,17552,7.4,19684,233,53,2098,2184,23.3,1755.2,3,7,3,2,1,1,0,15454,6.8,17500,236,46,-2098,-2184,23.6,1545.4,blue,5,0.86,58,16,blue
4467363451,10,5,13,0,0,0,0,17941,6.8,17529,206,52,1680,1254,20.6,1794.1,5,10,5,0,0,0,0,16261,6.4,16275,215,36,-1680,-1254,21.5,1626.1,blue,4.6,1,25,23,blue
4495074473,4,8,2,0,0,0,1,16334,6.4,15901,218,36,-300,-1937,21.8,1633.4,8,4,7,1,1,0,0,16634,7,17838,224,52,300,1937,22.4,1663.4,red,0.75,3.75,22,19,blue
4522847001,1,10,2,0,0,0,0,13342,6.4,15464,177,48,-6540,-4772,17.7,1334.2,10,1,13,2,1,1,0,19882,7.4,20236,234,56,6540,4772,23.4,1988.2,red,0.3,23,17,36,red
4492394631,8,5,9,1,1,0,0,18014,7.2,19778,238,68,1388,973,23.8,1801.4,5,8,5,0,0,0,0,16626,7.2,18805,225,60,-1388,-973,22.5,1662.6,blue,3.4,1.25,13,37,blue
4518436678,2,7,2,0,0,0,0,15114,6.8,17597,219,64,-1158,-1281,21.9,1511.4,7,2,6,2,1,1,0,16272,7.2,18878,231,44,1158,1281,23.1,1627.2,red,0.57,6.5,17,18,red
4521907618,6,8,8,1,0,1,1,18234,6.6,17526,205,59,1619,-575,20.5,1823.4,8,6,5,0,0,0,0,16615,7,18101,209,46,-1619,575,20.9,1661.5,red,1.75,2.17,16,20,red
4522689643,4,6,3,1,1,0,0,16061,7.2,18335,228,73,-299,454,22.8,1606.1,6,4,5,0,0,0,0,16360,6.6,17881,225,37,299,-454,22.5,1636,red,1.17,2.75,18,14,blue
4426908175,6,2,4,0,0,0,0,15828,6.8,17834,218,48,1176,763,21.8,1582.8,2,6,2,1,1,0,0,14652,6.8,17071,218,49,-1176,-763,21.8,1465.2,red,5,0.67,14,17,red
4477165590,3,5,3,0,0,0,0,15767,7.2,18720,233,56,-943,140,23.3,1576.7,5,3,5,1,1,0,0,16710,7.2,18580,249,48,943,-140,24.9,1671,red,1.2,3.33,15,18,red
4466254312,7,8,5,1,1,0,0,16460,7,18464,202,59,-1449,-777,20.2,1646,8,7,4,1,0,1,0,17909,7.4,19241,236,56,1449,777,23.6,1790.9,red,1.5,1.71,40,15,red
4477076121,4,8,3,0,0,0,0,16138,7,17604,217,51,-1531,-2275,21.7,1613.8,8,4,7,0,0,0,0,17669,7.4,19879,228,44,1531,2275,22.8,1766.9,red,0.88,3.75,16,23,red
4521819708,7,8,6,1,1,0,0,16482,6.6,17043,229,40,-672,-335,22.9,1648.2,8,7,13,1,0,1,0,17154,6.8,17378,190,56,672,335,19,1715.4,red,1.62,3,20,19,red
4523830454,5,5,8,0,0,0,0,15656,6.6,16766,230,40,-384,-2030,23,1565.6,5,5,2,1,1,0,0,16040,7,18796,233,56,384,2030,23.3,1604,red,2.6,1.4,15,14,blue
4523561313,8,2,7,1,0,1,0,17281,7.4,20413,219,63,2485,2934,21.9,1728.1,2,8,4,1,1,0,0,14796,6.8,17479,207,60,-2485,-2934,20.7,1479.6,red,7.5,0.75,20,18,blue
4506337812,7,3,6,1,1,0,0,18195,7.4,20319,252,64,4197,3107,25.2,1819.5,3,7,1,1,0,1,0,13998,6.8,17212,187,53,-4197,-3107,18.7,1399.8,blue,4.33,0.57,42,17,blue
4522266851,1,3,2,0,0,0,0,14054,6.6,17175,205,64,-1744,-1555,20.5,1405.4,3,1,3,1,1,0,0,15798,7,18730,232,48,1744,1555,23.2,1579.8,red,1,6,15,19,red
4477995331,8,8,13,0,0,0,0,17191,6.8,17401,188,56,654,478,18.8,1719.1,8,8,9,1,1,0,0,16537,6.6,16923,191,57,-654,-478,19.1,1653.7,red,2.62,2.12,68,16,blue
4523538705,12,3,12,1,1,0,0,19226,7.4,20579,228,61,4389,5412,22.8,1922.6,3,12,5,0,0,0,0,14837,6.4,15167,217,35,-4389,-5412,21.7,1483.7,blue,8,0.67,15,19,red
4458380035,12,4,13,1,1,0,0,18705,7.4,19808,210,50,3692,4028,21,1870.5,4,12,5,0,0,0,0,15013,6.4,15780,219,36,-3692,-4028,21.9,1501.3,blue,6.25,0.75,17,14,blue
4521001903,6,4,7,1,1,0,0,16057,7,17977,231,44,172,-278,23.1,1605.7,4,6,7,1,0,1,0,15885,7,18255,242,56,-172,278,24.2,1588.5,blue,3.25,1.83,19,18,red
4465357470,5,6,3,0,0,0,0,15722,6.8,17153,224,40,-488,-98,22.4,1572.2,6,5,7,1,1,0,0,16210,6.8,17251,192,48,488,98,19.2,1621,red,1.33,2.6,21,19,red
4524910590,5,8,7,0,0,0,0,15513,6.6,17308,203,43,-1791,507,20.3,1551.3,8,5,14,2,1,1,0,17304,6.8,16801,225,41,1791,-507,22.5,1730.4,red,1.5,4.4,14,11,red
4521152732,5,9,3,0,0,0,0,14964,6.6,17465,196,48,-3225,-1705,19.6,1496.4,9,5,6,2,1,1,0,18189,7.4,19170,249,67,3225,1705,24.9,1818.9,red,0.89,3,14,15,red
4523060210,8,4,6,1,1,0,0,16678,6.6,16861,196,62,2367,-249,19.6,1667.8,4,8,3,0,0,0,0,14311,6.4,17110,219,42,-2367,249,21.9,1431.1,blue,3.5,0.88,24,29,blue
4511747596,12,8,18,0,0,0,0,18238,6.8,16827,189,32,1797,-723,18.9,1823.8,8,12,5,1,1,0,0,16441,6.8,17550,190,47,-1797,723,19,1644.1,red,3.75,1.08,17,22,blue
4513807065,6,10,9,0,0,0,0,16758,7,17743,243,43,-1356,-1064,24.3,1675.8,10,6,15,0,0,0,0,18114,7.2,18807,207,52,1356,1064,20.7,1811.4,red,1.5,4.17,23,21,blue
4469852956,5,5,4,0,0,0,0,16545,7.2,19148,235,67,-207,-251,23.5,1654.5,5,5,6,1,1,0,0,16752,7.2,19399,235,72,207,251,23.5,1675.2,blue,1.8,2.2,20,19,red
4521067380,4,10,2,1,1,0,0,14843,6.4,16207,176,45,-2691,-1778,17.6,1484.3,10,4,12,1,0,1,0,17534,7.2,17985,199,52,2691,1778,19.9,1753.4,red,0.6,5.5,23,17,red
4499977236,6,1,3,2,1,1,1,17459,7,18810,226,52,3734,2743,22.6,1745.9,1,6,1,0,0,0,0,13725,6.4,16067,198,48,-3734,-2743,19.8,1372.5,blue,9,0.33,21,25,red
4510529947,7,6,10,0,0,0,0,15878,6.6,16090,187,45,567,-789,18.7,1587.8,6,7,7,0,0,0,0,15311,6.6,16879,220,40,-567,789,22,1531.1,red,2.83,1.86,24,22,red
4521314954,2,3,2,1,1,0,0,14462,7,17760,213,56,-892,-818,21.3,1446.2,3,2,3,0,0,0,0,15354,7,18578,240,58,892,818,24,1535.4,red,1.33,3,46,16,red
4421745805,3,10,3,0,0,0,0,14788,6.4,15674,194,37,-3231,-3010,19.4,1478.8,10,3,14,1,1,0,0,18019,7.4,18684,220,46,3231,3010,22,1801.9,red,0.6,8,21,20,red
4525024153,8,8,5,0,0,0,0,17871,7.4,18848,243,52,1591,1901,24.3,1787.1,8,8,11,1,1,0,0,16280,6.6,16947,197,43,-1591,-1901,19.7,1628,blue,1.62,2.38,19,24,red
4521925963,10,6,16,0,0,0,0,18080,7,18120,219,30,1998,572,21.9,1808,6,10,8,0,0,0,0,16082,6.6,17548,225,39,-1998,-572,22.5,1608.2,red,4.33,1.4,22,19,red
4510752222,2,10,1,0,0,0,0,13268,6.2,15564,170,47,-7839,-3333,17,1326.8,10,2,12,2,1,1,2,21107,7.2,18897,253,43,7839,3333,25.3,2110.7,red,0.3,11,16,19,red
4518120419,8,3,13,1,1,0,0,18291,7,18572,235,52,3222,1012,23.5,1829.1,3,8,2,0,0,0,0,15069,7.2,17560,232,48,-3222,-1012,23.2,1506.9,blue,7,0.62,13,34,blue
4521321336,7,1,13,1,1,0,0,16795,7.2,19215,238,55,1715,1548,23.8,1679.5,1,7,1,1,0,1,0,15080,7,17667,254,55,-1715,-1548,25.4,1508,blue,20,0.29,42,38,red
4513636712,3,11,1,0,0,0,0,13602,6.4,15564,170,44,-5088,-2609,17,1360.2,11,3,16,1,1,0,0,18690,7.2,18173,231,48,5088,2609,23.1,1869,red,0.36,9,20,16,red
4521702238,9,10,8,1,0,1,2,19162,7,17841,196,36,1082,14,19.6,1916.2,10,9,16,1,1,0,0,18080,6.8,17827,203,44,-1082,-14,20.3,1808,blue,1.7,2.89,16,16,red
4492702497,8,2,12,0,0,0,0,17253,7.2,18869,218,40,1887,519,21.8,1725.3,2,8,3,1,1,0,0,15366,7,18350,233,76,-1887,-519,23.3,1536.6,blue,10,0.62,17,12,blue
4495320946,13,7,14,0,0,0,0,19713,7,18607,217,52,2795,999,21.7,1971.3,7,13,8,0,0,0,0,16918,6.8,17608,177,56,-2795,-999,17.7,1691.8,blue,3.86,1.15,27,45,blue
4483811680,5,5,8,0,0,0,0,15675,6.4,16501,218,39,549,224,21.8,1567.5,5,5,7,1,1,0,0,15126,6.6,16277,170,36,-549,-224,17,1512.6,red,2.6,2.4,43,14,red
4467502993,4,6,4,0,0,0,0,15691,7.2,18589,237,52,96,466,23.7,1569.1,6,4,2,0,0,0,0,15595,6.8,18123,221,52,-96,-466,22.1,1559.5,blue,1.33,2,22,31,red
4477027360,4,6,3,0,0,0,0,15008,6.6,16888,214,38,-1015,-1751,21.4,1500.8,6,4,4,1,1,0,0,16023,6.8,18639,208,59,1015,1751,20.8,1602.3,red,1.17,2.5,20,34,red
4492081907,7,2,10,1,1,0,0,16867,7.2,18156,232,36,2474,1015,23.2,1686.7,2,7,2,0,0,0,0,14393,6.6,17141,230,52,-2474,-1015,23,1439.3,blue,8.5,0.57,23,151,blue
4498660251,8,6,7,1,1,0,0,17104,7,18350,223,64,-111,1062,22.3,1710.4,6,8,8,1,0,1,1,17215,6.8,17288,201,48,111,-1062,20.1,1721.5,blue,2.5,1.75,19,38,red
4521602868,8,6,13,1,1,0,0,17731,6.8,18132,232,47,1375,109,23.2,1773.1,6,8,4,0,0,0,0,16356,6.8,18023,206,48,-1375,-109,20.6,1635.6,red,3.5,1.25,25,20,blue
4456493473,1,3,0,0,0,0,0,13751,6.8,17182,199,60,-2507,-1567,19.9,1375.1,3,1,3,1,1,0,0,16258,7.2,18749,269,48,2507,1567,26.9,1625.8,red,0.33,6,16,22,red
4522626149,4,4,6,1,1,0,0,15544,6.6,17440,217,56,201,-979,21.7,1554.4,4,4,3,0,0,0,0,15343,7,18419,214,49,-201,979,21.4,1534.3,red,2.5,1.75,16,49,blue
4514596756,8,4,8,1,0,1,0,18057,7,18682,231,52,3152,2104,23.1,1805.7,4,8,4,0,0,0,0,14905,6.4,16578,211,40,-3152,-2104,21.1,1490.5,red,4,1,29,18,red
4480515524,5,5,8,0,0,0,0,16321,7.4,19044,227,52,120,-497,22.7,1632.1,5,5,4,1,1,0,0,16201,7.4,19541,216,64,-120,497,21.6,1620.1,red,2.6,1.8,23,35,blue
4524604603,8,6,7,0,0,0,0,17394,6.8,17390,199,68,1377,-221,19.9,1739.4,6,8,5,2,1,1,0,16017,6.8,17611,218,55,-1377,221,21.8,1601.7,blue,2.5,1.38,22,15,blue
4421907838,7,3,7,1,0,1,0,17622,7.2,19582,230,64,3071,2643,23,1762.2,3,7,4,0,0,0,0,14551,6.6,16939,220,36,-3071,-2643,22,1455.1,blue,4.67,1,32,23,blue
4499965552,10,2,8,1,1,0,1,20127,7.2,19673,251,60,6148,3541,25.1,2012.7,2,10,1,0,0,0,0,13979,6.4,16132,196,50,-6148,-3541,19.6,1397.9,blue,9,0.3,19,15,blue
4510870586,4,2,5,1,1,0,0,15800,6.8,17445,209,47,295,791,20.9,1580,2,4,3,1,0,1,1,15505,6.8,16654,206,45,-295,-791,20.6,1550.5,blue,4.5,1.25,18,45,blue
4470775145,5,5,3,0,0,0,0,15723,6.8,17400,242,35,451,1157,24.2,1572.3,5,5,5,0,0,0,0,15272,6.8,16243,234,24,-451,-1157,23.4,1527.2,blue,1.6,2,17,18,blue
4441626945,7,5,11,0,0,0,0,16544,6.8,17758,196,32,732,280,19.6,1654.4,5,7,5,1,1,0,0,15812,6.8,17478,199,58,-732,-280,19.9,1581.2,blue,3.6,1.43,48,19,red
4480361494,8,7,14,0,0,0,0,17758,6.8,17663,233,55,920,-386,23.3,1775.8,7,8,5,1,1,0,0,16838,6.8,18049,214,63,-920,386,21.4,1683.8,red,3.14,1.5,24,19,red
4502122880,6,9,8,0,0,0,0,15890,6.6,15649,199,48,-2039,-2297,19.9,1589,9,6,11,1,1,0,0,17929,6.8,17946,223,36,2039,2297,22.3,1792.9,red,1.56,3.33,22,63,red
4520727440,2,9,2,0,0,0,0,14646,6.6,16931,219,48,-5036,-2248,21.9,1464.6,9,2,12,2,1,1,1,19682,7.4,19179,262,68,5036,2248,26.2,1968.2,red,0.44,10.5,16,19,red
4523455175,9,10,6,1,1,0,0,16898,7,17791,211,44,-540,1330,21.1,1689.8,10,9,14,0,0,0,0,17438,6.6,16461,190,36,540,-1330,19,1743.8,red,1.5,2.67,27,25,red
4455108830,9,10,12,1,0,1,0,17524,7.2,18124,203,52,-1319,-840,20.3,1752.4,10,9,13,1,1,0,0,18843,7.4,18964,223,56,1319,840,22.3,1884.3,red,2.1,2.56,29,20,red
4497700990,7,5,11,0,0,0,0,16541,6.4,17099,231,39,2555,2123,23.1,1654.1,5,7,6,0,0,0,0,13986,6.2,14976,146,40,-2555,-2123,14.6,1398.6,blue,3.6,1.57,21,47,blue
4520490742,5,8,7,1,1,0,0,14566,5.8,13119,164,37,-2663,-2578,16.4,1456.6,8,5,14,0,0,0,0,17229,6.6,15697,209,42,2663,2578,20.9,1722.9,red,1.5,4.4,24,19,blue
4462715361,3,5,2,1,0,1,0,15929,7.2,18680,250,51,17,44,25,1592.9,5,3,3,1,1,0,0,15912,7,18636,203,76,-17,-44,20.3,1591.2,blue,1,2.67,21,37,blue
4520617887,6,6,6,0,0,0,0,15866,6.6,17209,207,45,-859,-1186,20.7,1586.6,6,6,10,0,0,0,0,16725,7.2,18395,245,66,859,1186,24.5,1672.5,red,2,2.67,22,21,blue
4518190301,5,6,6,0,0,0,0,16126,7,18201,217,52,61,1120,21.7,1612.6,6,5,7,1,1,0,0,16065,6.8,17081,203,52,-61,-1120,20.3,1606.5,red,1.83,2.6,19,22,blue
4492994895,4,4,0,1,0,1,0,15620,7.2,18558,239,56,-1761,-385,23.9,1562,4,4,8,1,1,0,1,17381,7.4,18943,243,54,1761,385,24.3,1738.1,blue,1,3,13,18,blue
4524404362,9,7,12,1,1,0,0,17524,7.2,18949,185,57,1076,1282,18.5,1752.4,7,9,6,0,0,0,0,16448,6.6,17667,209,52,-1076,-1282,20.9,1644.8,blue,3,1.44,61,20,red
4458389228,11,8,9,0,0,0,0,18746,7.2,19066,225,44,2198,1355,22.5,1874.6,8,11,4,1,1,0,0,16548,6.8,17711,204,64,-2198,-1355,20.4,1654.8,blue,2.5,1.09,25,19,blue
4523558547,9,6,7,0,0,0,0,17187,7,18178,213,40,626,98,21.3,1718.7,6,9,4,0,0,0,0,16561,7,18080,231,40,-626,-98,23.1,1656.1,red,2.67,1.11,20,15,blue
4465328511,4,3,4,1,1,0,0,15181,7,17084,216,49,911,449,21.6,1518.1,3,4,4,0,0,0,0,14270,6.8,16635,223,42,-911,-449,22.3,1427,blue,2.67,1.75,22,19,red
4523062403,11,6,16,0,0,0,0,19563,7.2,19145,220,60,4666,4288,22,1956.3,6,11,12,0,0,0,0,14897,6.2,14857,155,32,-4666,-4288,15.5,1489.7,blue,4.5,1.64,17,17,blue
4519547868,10,10,12,2,1,1,1,19197,7.2,18709,222,51,1167,-431,22.2,1919.7,10,10,6,0,0,0,0,18030,7.2,19140,219,56,-1167,431,21.9,1803,blue,2.2,1.6,41,20,red
4495445064,5,8,5,0,0,0,0,14803,6.8,17434,177,37,-2454,-1437,17.7,1480.3,8,5,6,1,1,0,0,17257,7,18871,219,52,2454,1437,21.9,1725.7,red,1.25,2.8,19,41,red
4520952475,2,7,1,1,0,1,0,13508,6.2,15002,160,56,-3580,-2967,16,1350.8,7,2,6,1,1,0,0,17088,6.6,17969,193,75,3580,2967,19.3,1708.8,red,0.43,6.5,20,19,red
4438793603,10,4,13,0,0,0,0,18978,7.6,21014,262,56,4185,3377,26.2,1897.8,4,10,3,0,0,0,0,14793,6.8,17637,205,52,-4185,-3377,20.5,1479.3,red,5.75,0.7,17,56,blue
4520895239,6,2,9,0,0,0,0,16627,7,18254,247,47,1899,308,24.7,1662.7,2,6,0,1,1,0,0,14728,6.8,17946,231,60,-1899,-308,23.1,1472.8,blue,7.5,0.33,19,56,red
4499542309,4,7,3,0,0,0,0,15562,6.8,17869,225,48,-435,-427,22.5,1556.2,7,4,8,1,1,0,0,15997,7,18296,196,65,435,427,19.6,1599.7,blue,1,3.75,13,17,red
4499235579,4,7,5,1,1,0,0,14717,6.4,16410,205,38,-3025,-1823,20.5,1471.7,7,4,5,1,0,1,1,17742,7,18233,211,41,3025,1823,21.1,1774.2,red,1.29,3,17,24,red
4520857294,4,7,3,0,0,0,0,16213,7.2,18890,208,68,-3035,188,20.8,1621.3,7,4,5,2,1,1,1,19248,7,18702,217,68,3035,-188,21.7,1924.8,red,1,3,41,16,red
4523557396,8,8,11,0,0,0,0,16922,7,17511,191,44,118,-532,19.1,1692.2,8,8,12,1,1,0,0,16804,7,18043,193,62,-118,532,19.3,1680.4,red,2.38,2.5,21,23,blue
4480423528,7,5,9,0,0,0,0,17094,7,18539,220,67,1004,1446,22,1709.4,5,7,3,1,1,0,0,16090,6.6,17093,211,52,-1004,-1446,21.1,1609,red,3.2,1.14,21,21,red
4441609133,9,8,5,1,1,0,0,17232,7,17777,212,52,725,626,21.2,1723.2,8,9,7,0,0,0,0,16507,7,17151,191,47,-725,-626,19.1,1650.7,blue,1.75,1.67,18,77,red
4523017372,12,6,10,1,1,0,0,19529,7.6,19979,242,48,3316,2032,24.2,1952.9,6,12,6,0,0,0,0,16213,6.8,17947,197,64,-3316,-2032,19.7,1621.3,blue,3.67,1,18,35,blue
4497909017,7,8,2,0,0,0,0,15684,6.6,17100,203,47,-1400,-644,20.3,1568.4,8,7,10,1,1,0,0,17084,7,17744,208,40,1400,644,20.8,1708.4,red,1.12,2.57,22,26,blue
4478159300,5,1,5,1,1,0,0,16352,7.2,19028,250,52,1824,1204,25,1635.2,1,5,2,0,0,0,0,14528,7,17824,239,52,-1824,-1204,23.9,1452.8,blue,10,0.6,21,24,red
4523487666,6,5,6,1,0,1,0,16782,7,19622,238,61,817,350,23.8,1678.2,5,6,5,1,1,0,0,15965,7.2,19272,235,51,-817,-350,23.5,1596.5,red,2.4,1.67,11,18,blue
4511302072,9,4,9,0,0,0,0,17514,7,17672,236,28,3170,1984,23.6,1751.4,4,9,6,0,0,0,0,14344,6.6,15688,175,43,-3170,-1984,17.5,1434.4,blue,4.5,1.11,16,40,blue
4524637878,7,7,7,0,0,0,0,17332,7,18724,226,60,-6,1004,22.6,1733.2,7,7,9,2,1,1,0,17338,6.8,17720,188,56,6,-1004,18.8,1733.8,red,2,2.29,17,16,red
4464555183,10,6,12,0,0,0,0,18951,7,17892,204,47,2896,1330,20.4,1895.1,6,10,7,0,0,0,0,16055,6.8,16562,196,40,-2896,-1330,19.6,1605.5,blue,3.67,1.3,95,36,blue
4482189285,7,0,6,1,1,0,0,18039,7.2,18984,236,64,4991,3364,23.6,1803.9,0,7,0,0,0,0,0,13048,6.2,15620,193,44,-4991,-3364,19.3,1304.8,blue,12.03,0,16,13,blue
4523475204,2,7,3,1,0,1,0,14487,7,17499,229,56,-2639,-953,22.9,1448.7,7,2,5,1,1,0,0,17126,7,18452,227,62,2639,953,22.7,1712.6,red,0.71,6,18,18,red
4518185070,8,5,13,2,1,1,0,18398,7,19201,234,71,2087,650,23.4,1839.8,5,8,3,0,0,0,0,16311,7,18551,226,56,-2087,-650,22.6,1631.1,blue,4.2,1,55,17,red
4520593786,1,5,1,1,0,1,0,15007,6.8,17592,251,55,-1933,15,25.1,1500.7,5,1,10,1,1,0,1,16940,7,17577,215,44,1933,-15,21.5,1694,blue,0.4,15,40,19,red
4447263506,5,1,0,1,1,0,0,16117,7.2,19109,221,60,2975,3977,22.1,1611.7,1,5,1,0,0,0,0,13142,6.2,15132,182,42,-2975,-3977,18.2,1314.2,red,5,0.4,17,15,blue
4456555871,6,5,8,0,0,0,0,17457,7,18210,251,64,2783,1603,25.1,1745.7,5,6,8,2,1,1,0,14674,6.6,16607,190,52,-2783,-1603,19,1467.4,red,2.8,2.17,20,124,blue
4478004780,4,4,5,1,1,0,0,15716,6.8,17691,235,53,-1555,-1025,23.5,1571.6,4,4,4,1,0,1,1,17271,7,18716,237,54,1555,1025,23.7,1727.1,red,2.25,2,38,20,blue
4446753486,6,8,8,1,1,0,0,15980,7,17313,207,48,-2565,-1593,20.7,1598,8,6,9,1,0,1,0,18545,7,18906,235,56,2565,1593,23.5,1854.5,blue,1.75,2.83,21,29,red
4459701274,1,5,1,1,1,0,0,15364,7,18462,233,72,-673,-48,23.3,1536.4,5,1,6,0,0,0,0,16037,7,18510,206,48,673,48,20.6,1603.7,red,0.4,11,21,15,red
4520967053,11,2,13,1,0,1,0,19082,7.6,20858,244,60,4012,3080,24.4,1908.2,2,11,2,0,0,0,0,15070,6.8,17778,230,60,-4012,-3080,23,1507,blue,12,0.36,21,20,blue
4518569254,5,7,6,1,1,0,0,15671,6.8,17411,205,44,-981,-994,20.5,1567.1,7,5,8,0,0,0,0,16652,6.8,18405,219,53,981,994,21.9,1665.2,blue,1.57,3,42,19,blue
4496867693,2,9,0,0,0,0,0,14321,6.8,16982,208,44,-4557,-3571,20.8,1432.1,9,2,8,0,0,0,0,18878,7.2,20553,260,59,4557,3571,26,1887.8,red,0.22,8.5,42,21,red
4415420855,5,5,7,0,0,0,0,15903,6.8,17896,206,55,811,241,20.6,1590.3,5,5,2,0,0,0,0,15092,7,17655,199,52,-811,-241,19.9,1509.2,red,2.4,1.4,16,17,red
4521076774,15,4,17,0,0,0,1,20828,7.2,19032,250,28,6375,3949,25,2082.8,4,15,5,0,0,0,0,14453,6.2,15083,164,54,-6375,-3949,16.4,1445.3,blue,8,0.6,15,15,blue
4434527560,9,9,7,1,1,0,0,17442,7,18411,219,33,557,1853,21.9,1744.2,9,9,8,0,0,0,0,16885,6.6,16558,190,42,-557,-1853,19,1688.5,blue,1.78,1.89,20,17,red
4459271455,13,6,19,1,0,1,0,20617,7.4,19936,240,56,3183,1321,24,2061.7,6,13,7,1,1,0,0,17434,7,18615,235,72,-3183,-1321,23.5,1743.4,blue,5.33,1,18,20,red
4496999459,0,3,0,0,0,0,0,13691,6.8,16957,229,54,-1148,-818,22.9,1369.1,3,0,2,0,0,0,0,14839,6.8,17775,221,51,1148,818,22.1,1483.9,blue,0,12.65,23,21,red
4518651197,3,4,2,1,0,1,0,14909,6.8,17001,208,59,-447,676,20.8,1490.9,4,3,6,0,0,0,0,15356,6.6,16325,197,40,447,-676,19.7,1535.6,red,1.25,3.33,16,18,red
4519394715,5,8,5,0,0,0,0,16372,6.6,16747,230,43,53,-48,23,1637.2,8,5,8,1,1,0,0,16319,6.8,16795,186,42,-53,48,18.6,1631.9,red,1.25,3.2,20,75,red
4520599588,8,10,15,1,1,0,0,17134,6.8,17579,171,66,-840,949,17.1,1713.4,10,8,11,0,0,0,0,17974,6.8,16630,214,49,840,-949,21.4,1797.4,red,2.3,2.62,34,17,red
4470015740,4,2,7,1,0,1,0,15648,6.8,17420,216,65,1187,285,21.6,1564.8,2,4,2,1,1,0,0,14461,6.6,17135,215,60,-1187,-285,21.5,1446.1,blue,5.5,1,22,24,blue
4509254722,6,10,6,1,1,0,0,16279,7,18734,226,56,-1753,-1095,22.6,1627.9,10,6,6,0,0,0,0,18032,7,19829,253,52,1753,1095,25.3,1803.2,blue,1.2,2.67,16,21,red
4487124026,7,7,9,0,0,0,0,17251,7,19522,225,60,-172,1613,22.5,1725.1,7,7,9,0,0,0,0,17423,6.8,17909,224,48,172,-1613,22.4,1742.3,blue,2.29,2.29,25,21,red
4472987459,6,7,6,1,1,0,0,17330,7.2,18821,226,63,777,1580,22.6,1733,7,6,13,0,0,0,0,16553,6.8,17241,195,44,-777,-1580,19.5,1655.3,blue,1.71,3.33,19,16,blue
4457232742,11,3,13,1,1,0,0,17655,7.2,18905,208,44,1906,1369,20.8,1765.5,3,11,3,0,0,0,0,15749,7,17536,221,57,-1906,-1369,22.1,1574.9,blue,8,0.55,17,13,blue
4520349175,8,5,10,0,0,0,0,17258,6.8,17683,216,52,2310,1946,21.6,1725.8,5,8,5,0,0,0,0,14948,6.6,15737,176,40,-2310,-1946,17.6,1494.8,blue,3.6,1.25,22,20,red
4479828060,3,5,0,0,0,0,0,13729,6.2,14661,180,36,-1213,-276,18,1372.9,5,3,10,2,1,1,0,14942,6.4,14937,161,48,1213,276,16.1,1494.2,red,0.6,5,21,17,red
4514280719,10,6,8,1,0,1,0,18555,7.4,20361,246,52,2488,2722,24.6,1855.5,6,10,6,1,1,0,0,16067,6.8,17639,185,67,-2488,-2722,18.5,1606.7,blue,3,1.2,14,17,red
4515398027,9,6,5,1,0,1,0,17025,7.4,19492,214,52,1399,2616,21.4,1702.5,6,9,5,0,0,0,0,15626,6.6,16876,181,45,-1399,-2616,18.1,1562.6,blue,2.33,1.22,18,40,red
4520552077,6,6,9,0,0,0,0,17528,6.8,18106,216,55,1376,1018,21.6,1752.8,6,6,5,1,1,0,0,16152,6.8,17088,217,38,-1376,-1018,21.7,1615.2,blue,2.5,1.83,19,19,red
4458138022,6,3,5,1,1,0,0,15829,7.2,17888,205,61,265,241,20.5,1582.9,3,6,1,1,0,1,0,15564,6.8,17647,204,48,-265,-241,20.4,1556.4,blue,3.67,0.67,45,20,blue
4481832485,4,7,6,1,0,1,0,16135,7,18177,234,47,-1782,-1311,23.4,1613.5,7,4,8,1,1,0,0,17917,7.2,19488,264,53,1782,1311,26.4,1791.7,red,1.43,3.75,25,20,red
4520033534,5,5,5,1,1,0,0,15781,6.8,17957,221,56,-535,-691,22.1,1578.1,5,5,7,0,0,0,0,16316,7,18648,240,54,535,691,24,1631.6,blue,2,2.4,17,18,blue
4522501943,7,6,8,0,0,0,0,16533,7,17850,198,60,-727,-675,19.8,1653.3,6,7,7,1,1,0,0,17260,7,18525,224,60,727,675,22.4,1726,red,2.5,1.86,20,16,blue
4502271212,10,4,9,1,1,0,0,18270,7.4,19486,238,59,3805,3162,23.8,1827,4,10,4,0,0,0,0,14465,6.6,16324,199,32,-3805,-3162,19.9,1446.5,blue,4.75,0.8,17,13,blue
4449098709,11,1,10,1,1,0,1,19673,7.6,21261,209,68,5797,4456,20.9,1967.3,1,11,0,0,0,0,0,13876,6.8,16805,218,56,-5797,-4456,21.8,1387.6,blue,21,0.09,14,13,blue
4515616629,8,3,8,0,0,0,0,17628,7.2,18793,231,61,3539,2952,23.1,1762.8,3,8,4,0,0,0,0,14089,6.4,15841,195,46,-3539,-2952,19.5,1408.9,blue,5.33,0.88,13,125,blue
4464352676,7,10,7,1,0,1,0,16375,6.8,17469,177,51,-3183,-1884,17.7,1637.5,10,7,9,0,0,0,1,19558,7.2,19353,236,72,3183,1884,23.6,1955.8,blue,1.4,2.71,20,20,red
4521458621,3,8,2,0,0,0,0,14533,6.8,17818,198,56,-4033,-1850,19.8,1453.3,8,3,9,1,1,0,0,18566,7.2,19668,220,64,4033,1850,22,1856.6,red,0.62,5.67,107,16,red
4517957834,6,7,8,0,0,0,0,16067,6.8,17256,190,48,-1176,-671,19,1606.7,7,6,7,2,1,1,0,17243,7.2,17927,220,47,1176,671,22,1724.3,red,2,2.33,21,20,blue
4494013671,3,6,2,2,1,1,0,14740,6.6,16655,201,44,-1402,-2295,20.1,1474,6,3,9,0,0,0,0,16142,7,18950,233,51,1402,2295,23.3,1614.2,blue,0.83,5,30,23,blue
4451947704,5,5,7,0,0,0,0,16560,7,18547,225,50,761,830,22.5,1656,5,5,8,1,1,0,0,15799,6.8,17717,225,47,-761,-830,22.5,1579.9,red,2.4,2.6,85,41,blue
4524990772,7,8,8,0,0,0,0,16979,6.8,17700,228,34,1038,454,22.8,1697.9,8,7,4,1,1,0,0,15941,6.8,17246,174,56,-1038,-454,17.4,1594.1,red,1.88,1.71,15,13,blue
4446773786,3,16,5,0,0,0,0,14081,6.4,15129,207,30,-6402,-4189,20.7,1408.1,16,3,22,1,1,0,0,20483,7.2,19318,233,47,6402,4189,23.3,2048.3,red,0.5,12.67,19,25,red
4523726698,3,11,7,0,0,0,0,13511,5.8,14048,164,39,-5427,-4559,16.4,1351.1,11,3,14,1,1,0,0,18938,7.2,18607,239,57,5427,4559,23.9,1893.8,red,0.91,8.33,42,43,red
4525061543,8,9,11,0,0,0,0,17951,6.8,17922,226,39,-194,431,22.6,1795.1,9,8,12,0,0,0,0,18145,6.8,17491,227,48,194,-431,22.7,1814.5,red,2.11,2.62,63,51,blue
4521050859,3,4,1,0,0,0,0,14202,6.8,16773,212,37,-2263,-1397,21.2,1420.2,4,3,4,1,1,0,0,16465,6.8,18170,240,60,2263,1397,24,1646.5,blue,1,2.67,23,20,red
4472625849,12,9,10,1,0,1,0,18291,6.8,17873,208,56,1693,1979,20.8,1829.1,9,12,11,0,0,0,0,16598,6.4,15894,180,47,-1693,-1979,18,1659.8,red,2.44,1.67,24,14,red
4500515300,4,9,5,1,0,1,0,15599,6.4,16288,219,45,-2231,-857,21.9,1559.9,9,4,16,1,1,0,0,17830,6.8,17145,214,44,2231,857,21.4,1783,red,1,6.25,23,26,red
4523957220,11,4,7,1,1,0,0,18265,7.6,20351,237,52,3362,3874,23.7,1826.5,4,11,2,0,0,0,0,14903,6.6,16477,187,50,-3362,-3874,18.7,1490.3,blue,4.5,0.55,18,46,blue
4518145521,11,5,10,1,0,1,1,18888,7,18915,204,44,2840,1792,20.4,1888.8,5,11,8,1,1,0,0,16048,6.8,17123,205,52,-2840,-1792,20.5,1604.8,blue,4.2,1.18,27,18,red
4513978363,7,9,7,0,0,0,0,16422,6.8,17598,206,46,-2606,-3164,20.6,1642.2,9,7,8,1,1,0,0,19028,7.6,20762,243,75,2606,3164,24.3,1902.8,red,1.56,2.43,18,44,red
4524919654,9,7,11,0,0,0,0,18090,7.2,18642,216,58,1884,1452,21.6,1809,7,9,8,0,0,0,0,16206,7,17190,190,41,-1884,-1452,19,1620.6,blue,2.86,1.67,19,170,red
4521438360,6,3,3,1,1,0,0,17602,7.4,19787,251,73,2849,1925,25.1,1760.2,3,6,3,0,0,0,0,14753,6.8,17862,196,54,-2849,-1925,19.6,1475.3,blue,3,1,17,42,blue
4486208789,3,7,4,0,0,0,0,13991,6.4,16073,203,21,-3756,-3280,20.3,1399.1,7,3,4,0,0,0,0,17747,7.2,19353,256,53,3756,3280,25.6,1774.7,blue,1,3.67,21,56,red
4462766288,11,2,7,1,1,0,0,17389,7.2,18459,221,52,2577,2588,22.1,1738.9,2,11,2,1,0,1,0,14812,6.6,15871,218,53,-2577,-2588,21.8,1481.2,blue,9,0.36,20,20,red
4443464607,4,7,3,1,1,0,0,15586,7,18599,229,52,-1777,52,22.9,1558.6,7,4,7,0,0,0,0,17363,7.2,18547,244,49,1777,-52,24.4,1736.3,blue,1,3.5,15,24,red
4515658862,2,7,2,1,0,1,0,15279,7,18355,236,59,-1526,-1082,23.6,1527.9,7,2,10,1,1,0,0,16805,7.4,19437,236,40,1526,1082,23.6,1680.5,red,0.57,8.5,41,20,red
4520558243,9,6,7,1,1,0,0,17016,7.2,18560,210,60,338,-232,21,1701.6,6,9,7,0,0,0,0,16678,7,18792,212,56,-338,232,21.2,1667.8,blue,2.67,1.44,20,14,blue
4522587007,4,7,5,0,0,0,0,16171,7,18471,240,57,-758,920,24,1617.1,7,4,8,0,0,0,0,16929,6.8,17551,208,57,758,-920,20.8,1692.9,blue,1.29,3.75,19,13,red
4450756044,9,1,12,1,1,0,1,19127,7.2,19350,253,56,5062,1996,25.3,1912.7,1,9,1,1,0,1,0,14065,6.6,17354,215,56,-5062,-1996,21.5,1406.5,blue,21,0.22,22,16,blue
4489864950,11,5,10,2,1,1,0,17962,7,17698,191,48,3367,1963,19.1,1796.2,5,11,6,0,0,0,0,14595,6.4,15735,185,24,-3367,-1963,18.5,1459.5,red,4.2,1,24,21,blue
4515508152,3,8,4,1,1,0,0,14580,6.6,16446,203,55,-4591,-1620,20.3,1458,8,3,6,0,0,0,1,19171,6.8,18066,241,45,4591,1620,24.1,1917.1,red,0.88,4.67,14,15,red
4516433412,3,2,3,1,0,1,0,15716,7.2,19033,251,56,121,264,25.1,1571.6,2,3,1,1,1,0,0,15595,7,18769,255,76,-121,-264,25.5,1559.5,red,3,1,81,17,blue
4471187696,2,6,1,0,0,0,0,13962,6.8,16214,215,28,-1635,-1467,21.5,1396.2,6,2,3,1,0,1,0,15597,7,17681,193,50,1635,1467,19.3,1559.7,red,0.5,4.5,19,20,red
4524676649,9,3,11,1,1,0,0,18519,7.2,18891,260,49,4756,3562,26,1851.9,3,9,3,0,0,0,0,13763,6.4,15329,196,24,-4756,-3562,19.6,1376.3,blue,6.67,0.67,16,18,blue
4503269239,10,3,12,2,1,1,0,18557,7.2,19603,235,47,3848,2704,23.5,1855.7,3,10,3,0,0,0,0,14709,6.6,16899,200,40,-3848,-2704,20,1470.9,blue,7.33,0.6,25,20,blue
4507906243,6,5,6,0,0,0,0,16793,7,19426,233,62,463,275,23.3,1679.3,5,6,7,1,1,0,0,16330,7.4,19151,224,62,-463,-275,22.4,1633,blue,2.4,2,20,20,blue
4445378393,10,5,8,1,0,1,0,19169,7.4,19642,235,48,3305,2586,23.5,1916.9,5,10,6,1,1,0,0,15864,7,17056,215,44,-3305,-2586,21.5,1586.4,red,3.6,1.1,20,18,red
4521803146,12,7,15,1,1,0,0,19933,7.2,18730,219,60,2473,565,21.9,1993.3,7,12,8,0,0,0,0,17460,7,18165,200,39,-2473,-565,20,1746,blue,3.86,1.25,17,18,blue
4523282194,4,5,5,1,1,0,0,16391,7.2,18597,233,60,153,713,23.3,1639.1,5,4,8,0,0,0,0,16238,7,17884,236,45,-153,-713,23.6,1623.8,red,1.8,3.25,18,17,red
4517700680,7,2,12,1,1,0,0,17340,7.2,19234,229,52,3125,1784,22.9,1734,2,7,2,0,0,0,0,14215,6.8,17450,219,50,-3125,-1784,21.9,1421.5,blue,9.5,0.57,57,17,blue
4443104744,12,11,16,0,0,0,0,19861,7.2,18934,220,43,2352,133,22,1986.1,11,12,12,2,1,1,0,17509,7.2,18801,183,48,-2352,-133,18.3,1750.9,blue,2.55,1.92,33,17,blue
4521692876,4,9,3,2,1,1,0,16273,7.2,18638,246,71,-454,23,24.6,1627.3,9,4,6,0,0,0,0,16727,7.2,18615,204,43,454,-23,20.4,1672.7,red,0.78,3.75,13,38,red
4472954314,5,7,6,1,0,1,0,15595,6.8,17384,206,45,-1840,-2402,20.6,1559.5,7,5,11,1,1,0,0,17435,7.4,19786,242,50,1840,2402,24.2,1743.5,red,1.57,3.6,19,48,red
4511365418,8,7,10,2,1,1,0,17429,7,17332,209,51,900,-802,20.9,1742.9,7,8,6,0,0,0,0,16529,7,18134,217,36,-900,802,21.7,1652.9,red,2.57,1.62,20,25,blue
4515850930,5,5,7,0,0,0,0,16524,7,18962,245,59,96,-21,24.5,1652.4,5,5,6,2,1,1,0,16428,7,18983,257,56,-96,21,25.7,1642.8,red,2.4,2.2,22,24,blue
4478061108,4,9,5,0,0,0,0,15293,6.6,16350,226,46,-2004,-1407,22.6,1529.3,9,4,12,1,0,1,0,17297,6.8,17757,227,39,2004,1407,22.7,1729.7,red,1,5.25,20,22,red
4482488363,3,5,3,0,0,0,0,13988,6.2,15917,174,44,-2761,-2185,17.4,1398.8,5,3,11,1,1,0,0,16749,7,18102,242,43,2761,2185,24.2,1674.9,red,1.2,5.33,20,27,red
4466982463,4,5,2,1,1,0,0,15557,6.8,17180,234,53,-633,-1323,23.4,1555.7,5,4,6,0,0,0,0,16190,7,18503,206,54,633,1323,20.6,1619,blue,1.2,2.75,17,15,blue
4515297257,3,6,4,0,0,0,0,15227,7,17701,231,59,-1558,-1782,23.1,1522.7,6,3,6,2,1,1,0,16785,7,19483,244,44,1558,1782,24.4,1678.5,red,1.17,4,21,23,red
4472103382,8,3,8,1,1,0,0,16378,6.8,16837,178,44,393,-1055,17.8,1637.8,3,8,3,0,0,0,0,15985,6.8,17892,227,56,-393,1055,22.7,1598.5,red,5.33,0.75,17,18,blue
4472652986,7,8,6,1,1,0,0,16007,7,17830,204,47,-873,308,20.4,1600.7,8,7,7,0,0,0,0,16880,6.8,17522,215,44,873,-308,21.5,1688,red,1.62,2.14,21,20,red
4508266227,8,7,11,2,1,1,0,17937,7,18340,227,65,1063,553,22.7,1793.7,7,8,7,0,0,0,0,16874,7.2,17787,226,48,-1063,-553,22.6,1687.4,blue,2.71,1.75,23,21,blue
4476300500,0,8,0,0,0,0,0,13537,6.2,15367,208,52,-3752,-3349,20.8,1353.7,8,0,10,1,1,0,0,17289,7.4,18716,242,40,3752,3349,24.2,1728.9,red,0,12.65,19,18,red
4494516063,9,7,5,1,1,0,0,17907,7.2,19438,231,49,1550,2512,23.1,1790.7,7,9,10,0,0,0,0,16357,6.6,16926,192,40,-1550,-2512,19.2,1635.7,red,2,1.89,21,50,blue
4522599017,6,5,7,0,0,0,0,16053,6.8,18228,216,48,611,381,21.6,1605.3,5,6,5,1,1,0,0,15442,6.8,17847,208,46,-611,-381,20.8,1544.2,red,2.6,1.67,17,21,blue
4495413330,5,8,4,0,0,0,0,16616,7.4,19302,240,64,-616,728,24,1661.6,8,5,9,1,1,0,0,17232,7.2,18574,234,48,616,-728,23.4,1723.2,blue,1.12,3.4,47,21,red
4524640589,8,8,12,2,1,1,0,16367,6.6,16065,202,40,151,1281,20.2,1636.7,8,8,18,0,0,0,0,16216,6.2,14784,201,8,-151,-1281,20.1,1621.6,blue,2.5,3.25,19,19,red
4514457087,9,4,11,0,0,0,0,17494,7,18057,205,56,1518,-5,20.5,1749.4,4,9,5,1,1,0,0,15976,7,18062,199,72,-1518,5,19.9,1597.6,blue,5,1,15,13,blue
4523526937,9,5,10,2,1,1,0,17704,7.2,19789,200,52,1241,2416,20,1770.4,5,9,6,0,0,0,0,16463,6.8,17373,230,52,-1241,-2416,23,1646.3,blue,3.8,1.22,86,20,blue
4499336831,10,9,8,0,0,0,0,17817,6.8,17747,188,40,780,74,18.8,1781.7,9,10,7,0,0,0,0,17037,7,17673,212,44,-780,-74,21.2,1703.7,blue,2,1.6,14,15,blue
4524374262,12,13,15,0,0,0,0,17940,6.8,16927,162,41,-2725,-3568,16.2,1794,13,12,15,1,1,0,0,20665,7.6,20495,252,48,2725,3568,25.2,2066.5,blue,2.08,2.33,17,19,blue
4514266490,6,6,8,1,0,1,0,16988,6.8,18153,223,45,37,-905,22.3,1698.8,6,6,5,1,1,0,0,16951,7.4,19058,216,59,-37,905,21.6,1695.1,red,2.33,1.83,16,22,blue
4516933345,9,7,8,1,1,0,0,17661,6.6,17077,233,40,815,590,23.3,1766.1,7,9,10,0,0,0,0,16846,6.8,16487,191,38,-815,-590,19.1,1684.6,blue,2.43,1.89,19,20,red
4494398674,4,3,4,0,0,0,0,15755,7.2,19845,225,64,951,2193,22.5,1575.5,3,4,2,2,1,1,0,14804,7,17652,197,48,-951,-2193,19.7,1480.4,blue,2.67,1.25,20,19,red
4516930956,6,15,6,0,0,0,0,15392,6.4,16156,175,45,-4885,-3111,17.5,1539.2,15,6,17,1,0,1,0,20277,7.4,19267,233,46,4885,3111,23.3,2027.7,red,0.8,5.33,14,19,red
4479819493,2,8,3,0,0,0,0,13925,6.6,16354,198,43,-4527,-3126,19.8,1392.5,8,2,8,1,1,0,0,18452,7.2,19480,229,55,4527,3126,22.9,1845.2,red,0.62,8,21,21,red
4511791303,5,3,2,1,1,0,0,16421,7,18152,241,48,1239,-1051,24.1,1642.1,3,5,2,0,0,0,0,15182,7.2,19203,219,73,-1239,1051,21.9,1518.2,blue,2.33,1,16,43,blue
4475259574,2,3,2,1,1,0,0,14535,6.4,16699,234,35,-988,-1427,23.4,1453.5,3,2,4,1,0,1,0,15523,7,18126,241,48,988,1427,24.1,1552.3,blue,1.33,3.5,18,17,blue
4519350434,7,2,6,1,0,1,0,17082,7,18373,221,40,2216,1580,22.1,1708.2,2,7,3,1,1,0,0,14866,6.6,16793,208,64,-2216,-1580,20.8,1486.6,blue,6.5,0.71,17,15,blue
4521669931,4,5,4,2,1,1,0,15711,6.6,17255,208,59,-101,-1320,20.8,1571.1,5,4,6,0,0,0,0,15812,7.2,18575,210,65,101,1320,21,1581.2,red,1.6,2.75,12,12,blue
4481775600,4,4,3,1,0,1,0,16087,7.2,19195,224,66,225,824,22.4,1608.7,4,4,5,1,1,0,0,15862,7,18371,208,68,-225,-824,20.8,1586.2,blue,1.75,2.25,18,166,blue
4522586300,0,7,0,0,0,0,0,13358,6.2,15566,199,59,-4737,-3600,19.9,1335.8,7,0,7,1,1,0,0,18095,7.2,19166,253,58,4737,3600,25.3,1809.5,red,0,12.65,26,23,red
4502626777,11,4,9,1,1,0,0,18438,7.2,18924,212,60,3742,3229,21.2,1843.8,4,11,6,0,0,0,0,14696,6.2,15695,184,56,-3742,-3229,18.4,1469.6,blue,5,0.91,20,19,blue
4464794186,2,5,2,1,1,0,0,14485,6.8,17287,220,63,-1866,-1885,22,1448.5,5,2,4,0,0,0,0,16351,7.4,19172,253,56,1866,1885,25.3,1635.1,red,0.8,4.5,19,14,blue
4516066047,5,1,3,1,1,0,0,16222,7,18746,241,60,1997,1560,24.1,1622.2,1,5,0,0,0,0,0,14225,7,17186,234,48,-1997,-1560,23.4,1422.5,blue,8,0.2,23,46,blue
4440210667,2,7,1,0,0,0,0,14624,6.8,17333,225,44,-2794,-2624,22.5,1462.4,7,2,13,0,0,0,0,17418,7.4,19957,231,60,2794,2624,23.1,1741.8,red,0.43,10,17,44,blue
4495401040,11,8,18,1,1,0,0,17568,6.6,16755,206,46,1236,1018,20.6,1756.8,8,11,9,0,0,0,0,16332,6.4,15737,183,45,-1236,-1018,18.3,1633.2,blue,3.62,1.55,16,16,blue
4447457186,2,4,2,1,1,0,0,15198,6.8,17316,235,47,-13,-1792,23.5,1519.8,4,2,3,1,0,1,0,15211,7,19108,207,39,13,1792,20.7,1521.1,red,1,3.5,18,20,blue
4516861860,4,3,4,0,0,0,0,16313,6.8,17824,240,47,1128,498,24,1631.3,3,4,5,0,0,0,0,15185,6.8,17326,220,41,-1128,-498,22,1518.5,blue,2.67,2,21,31,blue
4464918638,5,7,6,0,0,0,0,16560,7.2,19116,235,57,-529,-54,23.5,1656,7,5,8,1,1,0,0,17089,7,19170,223,63,529,54,22.3,1708.9,red,1.57,3,125,66,blue
4524558517,5,6,6,0,0,0,0,15693,6.8,17777,210,51,-486,-137,21,1569.3,6,5,5,1,1,0,0,16179,7,17914,216,52,486,137,21.6,1617.9,red,1.83,2.2,29,36,red
4472644738,8,10,7,0,0,0,0,16403,7,18111,218,33,-1445,-736,21.8,1640.3,10,8,9,1,0,1,0,17848,7,18847,210,54,1445,736,21,1784.8,blue,1.5,2.38,21,63,blue
4488573145,0,4,0,0,0,0,0,13720,6.6,16815,230,52,-2727,-4122,23,1372,4,0,1,1,1,0,0,16447,7.6,20937,263,69,2727,4122,26.3,1644.7,red,0,12.65,17,40,red
4521992457,7,4,10,1,1,0,0,16599,6.6,16723,201,40,1036,-663,20.1,1659.9,4,7,1,0,0,0,0,15563,6.8,17386,251,52,-1036,663,25.1,1556.3,red,4.25,0.71,16,12,blue
4516576822,5,5,5,0,0,0,0,15364,6.8,17090,198,48,-799,-588,19.8,1536.4,5,5,6,0,0,0,0,16163,6.8,17678,242,44,799,588,24.2,1616.3,red,2,2.2,20,17,red
4518094361,6,10,7,0,0,0,0,14978,6.6,16243,147,40,-4413,-1993,14.7,1497.8,10,6,16,2,1,1,1,19391,7,18236,237,55,4413,1993,23.7,1939.1,red,1.3,4.33,16,24,red
4505841827,6,6,4,1,0,1,0,16970,6.8,17984,236,56,-153,79,23.6,1697,6,6,9,1,1,0,0,17123,7,17905,223,55,153,-79,22.3,1712.3,red,1.67,2.5,106,17,blue
4518963462,6,12,7,0,0,0,0,16851,6.8,17931,201,48,-2286,-976,20.1,1685.1,12,6,15,0,0,0,0,19137,7,18907,199,52,2286,976,19.9,1913.7,red,1.08,4.5,26,71,red
4519178537,4,5,3,0,0,0,0,14893,6.8,17322,203,48,-1002,-378,20.3,1489.3,5,4,4,1,1,0,0,15895,6.8,17700,233,48,1002,378,23.3,1589.5,red,1.4,2.25,19,18,red
4489955666,18,6,16,2,1,1,0,21893,7.6,21511,243,56,7125,3657,24.3,2189.3,6,18,0,0,0,0,0,14768,7.2,17854,176,42,-7125,-3657,17.6,1476.8,blue,5.67,0.33,20,11,blue
4468031280,5,3,8,1,1,0,0,15574,6.8,17788,230,45,840,196,23,1557.4,3,5,1,0,0,0,0,14734,7,17592,203,59,-840,-196,20.3,1473.4,blue,4.33,0.8,22,16,red
4519619414,6,8,7,1,0,1,1,18155,7,19429,231,65,468,558,23.1,1815.5,8,6,11,1,1,0,0,17687,7,18871,194,56,-468,-558,19.4,1768.7,blue,1.62,3.17,13,15,red
4475955014,8,5,8,1,1,0,0,16469,7,18105,192,46,248,582,19.2,1646.9,5,8,10,0,0,0,0,16221,6.6,17523,225,52,-248,-582,22.5,1622.1,blue,3.2,1.88,19,17,red
4496519223,1,5,2,0,0,0,0,13983,6.4,15892,214,53,-3832,-3324,21.4,1398.3,5,1,4,2,1,1,1,17815,7,19216,276,47,3832,3324,27.6,1781.5,red,0.6,9,18,18,red
4509908881,14,3,19,1,1,0,1,22472,7.6,20870,251,54,8284,4654,25.1,2247.2,3,14,5,0,0,0,0,14188,6.6,16216,202,34,-8284,-4654,20.2,1418.8,blue,11,0.57,16,17,blue
4520631494,6,2,3,0,0,0,0,16807,7.4,19637,222,57,1295,1167,22.2,1680.7,2,6,2,1,1,0,0,15512,7.2,18470,237,60,-1295,-1167,23.7,1551.2,blue,4.5,0.67,27,64,blue
4453648603,5,9,4,1,1,0,0,14996,6.4,15901,188,44,-3331,-3464,18.8,1499.6,9,5,11,1,0,1,0,18327,7.2,19365,218,63,3331,3464,21.8,1832.7,blue,1,4,14,18,red
4480078875,7,5,8,2,1,1,0,17477,6.8,18070,186,62,1049,811,18.6,1747.7,5,7,4,0,0,0,0,16428,6.6,17259,228,41,-1049,-811,22.8,1642.8,blue,3,1.29,28,19,red
4423246769,7,8,5,1,1,0,0,15810,6.6,16837,193,48,-1305,-2023,19.3,1581,8,7,5,0,0,0,1,17115,7.2,18860,189,62,1305,2023,18.9,1711.5,red,1.5,1.86,14,12,blue
4471229287,3,8,5,0,0,0,0,13980,6.2,15030,193,44,-3739,-3541,19.3,1398,8,3,9,2,1,1,0,17719,7.2,18571,246,48,3739,3541,24.6,1771.9,red,1,5.67,23,40,red
4525099132,5,5,7,2,1,1,0,15726,7,17245,203,56,-252,77,20.3,1572.6,5,5,9,0,0,0,0,15978,6.6,17168,212,48,252,-77,21.2,1597.8,blue,2.4,2.8,19,17,blue
4473558954,5,5,3,0,0,0,0,15153,7.2,18629,191,51,-809,411,19.1,1515.3,5,5,5,1,1,0,0,15962,7,18218,216,44,809,-411,21.6,1596.2,red,1.6,2,17,16,red
4522194078,2,5,2,0,0,0,0,14695,6.8,17431,228,56,-2062,-1466,22.8,1469.5,5,2,6,1,1,0,0,16757,7,18897,246,58,2062,1466,24.6,1675.7,red,0.8,5.5,17,16,blue
4463332138,7,7,8,1,1,0,0,16106,7,18323,207,52,-84,570,20.7,1610.6,7,7,4,0,0,0,0,16190,7,17753,207,49,84,-570,20.7,1619,red,2.14,1.57,17,107,red
4489878526,6,4,6,0,0,0,0,16493,7.2,18450,231,46,628,-243,23.1,1649.3,4,6,6,1,1,0,0,15865,7,18693,212,67,-628,243,21.2,1586.5,blue,3,1.67,16,20,blue
4518060637,9,5,13,0,0,0,0,17099,7.2,19592,225,48,1344,2079,22.5,1709.9,5,9,2,1,1,0,0,15755,6.8,17513,238,48,-1344,-2079,23.8,1575.5,blue,4.4,0.78,16,17,red
4464565821,4,9,3,1,1,0,0,15211,6.8,17951,225,56,-3848,-2091,22.5,1521.1,9,4,14,1,0,1,0,19059,7.2,20042,238,68,3848,2091,23.8,1905.9,red,0.78,5.75,25,18,red
4502255242,6,4,7,1,1,0,0,16643,7,18300,215,51,1515,590,21.5,1664.3,4,6,4,0,0,0,0,15128,6.8,17710,207,56,-1515,-590,20.7,1512.8,red,3.25,1.33,18,27,blue
4509558169,7,7,4,0,0,0,0,16581,7,18360,198,54,462,1726,19.8,1658.1,7,7,8,0,0,0,0,16119,6.6,16634,200,47,-462,-1726,20,1611.9,red,1.57,2.14,21,14,red
4468238235,10,7,16,1,1,0,0,17953,7,18823,190,60,1058,1196,19,1795.3,7,10,9,0,0,0,0,16895,6.6,17627,206,47,-1058,-1196,20.6,1689.5,blue,3.71,1.6,35,49,blue
4521525873,6,8,4,0,0,0,0,16112,6.8,17371,197,50,-554,-483,19.7,1611.2,8,6,10,1,1,0,0,16666,7,17854,206,41,554,483,20.6,1666.6,red,1.25,3,14,20,blue
4518930107,5,7,4,0,0,0,0,15637,6.6,16107,201,50,-460,-842,20.1,1563.7,7,5,9,0,0,0,0,16097,6.8,16949,218,31,460,842,21.8,1609.7,blue,1.29,3.2,14,20,blue
4480194384,5,7,4,0,0,0,0,15977,6.8,18136,206,71,-1130,-347,20.6,1597.7,7,5,8,1,1,0,0,17107,7.2,18483,230,56,1130,347,23,1710.7,red,1.29,3,17,17,blue
4515500466,2,9,2,1,0,1,0,13932,6,14927,197,40,-3919,-3135,19.7,1393.2,9,2,16,0,0,0,0,17851,7,18062,205,55,3919,3135,20.5,1785.1,red,0.44,12.5,15,51,red
4519480977,6,6,10,0,0,0,0,16206,6.8,17669,221,49,-677,-67,22.1,1620.6,6,6,10,1,1,0,0,16883,6.8,17736,245,45,677,67,24.5,1688.3,blue,2.67,2.67,47,26,red
4494773466,5,9,7,0,0,0,0,16163,6.8,16772,190,52,-819,-1926,19,1616.3,9,5,8,0,0,0,0,16982,7,18698,225,50,819,1926,22.5,1698.2,red,1.33,3.4,16,54,blue
4524332447,5,4,3,1,1,0,0,15296,6.8,16908,187,56,733,810,18.7,1529.6,4,5,1,0,0,0,0,14563,6.2,16098,204,32,-733,-810,20.4,1456.3,blue,2,1,22,28,red
4512351336,5,8,9,0,0,0,0,15966,7,18157,209,47,-847,-267,20.9,1596.6,8,5,8,1,1,0,0,16813,7.2,18424,203,60,847,267,20.3,1681.3,blue,1.75,3.2,68,58,red
4494787893,4,2,0,0,0,0,0,15555,7.4,19704,214,70,737,1094,21.4,1555.5,2,4,2,1,1,0,0,14818,7.2,18610,235,51,-737,-1094,23.5,1481.8,red,2,1,11,38,blue
4524443617,4,1,5,1,1,0,0,16041,7,18214,233,44,1891,603,23.3,1604.1,1,4,1,0,0,0,0,14150,7,17611,214,47,-1891,-603,21.4,1415,blue,9,0.5,20,41,red
4517953840,5,9,7,0,0,0,0,15239,6.6,16561,194,50,-3130,-2448,19.4,1523.9,9,5,13,1,1,0,0,18369,7.2,19009,236,44,3130,2448,23.6,1836.9,red,1.33,4.4,28,22,red
4521530707,9,8,11,1,1,0,0,17049,6.8,17343,180,49,147,-1425,18,1704.9,8,9,8,0,0,0,0,16902,7.2,18768,193,63,-147,1425,19.3,1690.2,blue,2.5,1.78,9,14,blue
4496627466,9,5,9,1,1,0,0,17492,6.8,18028,219,40,687,563,21.9,1749.2,5,9,7,0,0,0,0,16805,7,17465,224,58,-687,-563,22.4,1680.5,blue,3.6,1.33,73,15,blue
4472271945,2,8,2,0,0,0,0,14370,6.4,16473,228,48,-3180,-3196,22.8,1437,8,2,8,1,1,0,0,17550,7.6,19669,211,53,3180,3196,21.1,1755,red,0.5,8,92,19,red
4452983788,7,8,9,0,0,0,0,17543,7.2,18967,246,48,-144,-867,24.6,1754.3,8,7,10,2,1,1,0,17687,7.4,19834,225,64,144,867,22.5,1768.7,red,2,2.57,29,58,red
4521397420,2,9,4,1,1,0,0,13570,6.6,15970,195,41,-6374,-4421,19.5,1357,9,2,8,1,0,1,1,19944,7.8,20391,262,56,6374,4421,26.2,1994.4,red,0.67,8.5,39,18,red
4521748513,5,6,5,0,0,0,0,15948,6.8,17169,222,54,-947,-1040,22.2,1594.8,6,5,10,2,1,1,0,16895,6.8,18209,248,51,947,1040,24.8,1689.5,red,1.67,3.2,20,26,blue
4516872097,3,6,6,0,0,0,0,14339,6,15064,197,32,-3074,-2611,19.7,1433.9,6,3,10,0,0,0,0,17413,6.8,17675,233,49,3074,2611,23.3,1741.3,blue,1.5,5.33,15,18,red
4458718389,16,10,12,1,1,0,0,20084,6.8,17621,175,46,2098,1150,17.5,2008.4,10,16,10,0,0,0,0,17986,6.8,16471,182,37,-2098,-1150,18.2,1798.6,blue,2.8,1.25,20,18,blue
4481753075,4,5,5,0,0,0,0,15375,6.8,17114,200,56,-1270,-2363,20,1537.5,5,4,1,1,1,0,0,16645,7.2,19477,273,60,1270,2363,27.3,1664.5,blue,1.8,1.5,19,17,red
4523278950,3,5,5,0,0,0,0,14313,6.2,15407,194,52,-2089,-2275,19.4,1431.3,5,3,7,1,1,0,0,16402,6.8,17682,243,48,2089,2275,24.3,1640.2,blue,1.6,4,18,24,red
4522325538,9,1,8,0,0,0,0,17786,7,19149,233,52,3404,2513,23.3,1778.6,1,9,1,0,0,0,0,14382,6.6,16636,206,51,-3404,-2513,20.6,1438.2,blue,17,0.22,18,18,blue
4457626899,4,8,4,1,0,1,0,16657,7,18154,210,58,-206,-1476,21,1665.7,8,4,0,1,1,0,0,16863,7.2,19630,248,52,206,1476,24.8,1686.3,blue,1,2,21,23,blue
4507806528,6,4,5,2,1,1,0,15994,6.8,18356,235,43,1396,2369,23.5,1599.4,4,6,4,0,0,0,0,14598,6.6,15987,166,56,-1396,-2369,16.6,1459.8,blue,2.75,1.33,15,12,blue
4495708633,5,7,5,0,0,0,0,14352,6.4,15070,153,44,-2475,-3608,15.3,1435.2,7,5,8,1,1,0,0,16827,7,18678,227,52,2475,3608,22.7,1682.7,red,1.43,3,17,120,blue
4509662137,5,8,6,0,0,0,0,15589,7,17960,203,43,-2111,-1385,20.3,1558.9,8,5,5,1,1,0,0,17700,7.2,19345,262,68,2111,1385,26.2,1770,blue,1.38,2.6,14,18,red
4485856450,8,8,10,0,0,0,0,17544,7.2,18246,213,53,-375,-547,21.3,1754.4,8,8,9,1,1,0,0,17919,7,18793,230,62,375,547,23,1791.9,red,2.25,2.12,24,25,red
4499846213,6,9,9,1,1,0,0,16447,6.6,16299,208,48,-1942,-2662,20.8,1644.7,9,6,14,0,0,0,0,18389,7,18961,239,52,1942,2662,23.9,1838.9,red,1.67,3.83,97,19,blue
4459583409,4,6,4,1,1,0,0,15883,6.8,17317,235,53,-426,-323,23.5,1588.3,6,4,6,0,0,0,0,16309,7,17640,238,42,426,323,23.8,1630.9,blue,1.33,3,32,21,red
4518900099,6,10,12,1,1,0,0,15693,6.6,16140,177,36,-2794,-2688,17.7,1569.3,10,6,17,0,0,0,0,18487,7.2,18828,237,57,2794,2688,23.7,1848.7,red,1.8,4.5,22,18,red
4524698581,3,13,1,0,0,0,0,13737,6.2,15314,174,36,-7218,-5853,17.4,1373.7,13,3,12,1,1,0,0,20955,7.6,21167,250,61,7218,5853,25,2095.5,red,0.31,8.33,11,14,blue
4515493524,7,3,5,0,0,0,0,17019,7.2,19372,236,46,1175,963,23.6,1701.9,3,7,3,2,1,1,0,15844,6.8,18409,231,69,-1175,-963,23.1,1584.4,red,4,0.86,17,22,blue
4518019650,3,5,3,0,0,0,0,15029,7,17571,230,40,-1420,-1415,23,1502.9,5,3,5,1,1,0,0,16449,7,18986,222,56,1420,1415,22.2,1644.9,red,1.2,3.33,15,104,blue
4458486067,6,7,6,0,0,0,0,16643,7,18042,232,47,-265,-872,23.2,1664.3,7,6,9,1,1,0,0,16908,7.2,18914,222,60,265,872,22.2,1690.8,red,1.71,2.67,17,16,blue
4470313749,4,9,4,0,0,0,0,15198,6.4,16245,226,37,-797,-532,22.6,1519.8,9,4,10,1,1,0,0,15995,6.6,16777,180,46,797,532,18,1599.5,blue,0.89,4.75,22,22,blue
4464987653,10,5,19,1,1,0,0,18625,7,18540,231,39,3201,2000,23.1,1862.5,5,10,5,1,0,1,0,15424,6.8,16540,191,60,-3201,-2000,19.1,1542.4,blue,5.8,1,72,17,red
4474742854,6,7,2,0,0,0,0,15030,6.4,16763,204,36,-632,675,20.4,1503,7,6,8,1,1,0,0,15662,6.4,16088,192,45,632,-675,19.2,1566.2,red,1.14,2.5,19,21,blue
4525016359,8,3,4,0,0,0,0,18347,7.4,19605,251,59,2493,1826,25.1,1834.7,3,8,2,1,1,0,0,15854,7,17779,233,44,-2493,-1826,23.3,1585.4,blue,4,0.62,23,19,blue
4454360834,9,4,4,1,0,1,0,18458,7.4,20320,270,51,3158,2594,27,1845.8,4,9,6,1,1,0,0,15300,6.8,17726,202,60,-3158,-2594,20.2,1530,blue,3.25,1.11,18,16,red
4508291469,7,8,8,0,0,0,0,16228,6.6,16832,191,44,-1127,-1496,19.1,1622.8,8,7,6,2,1,1,0,17355,7,18328,204,53,1127,1496,20.4,1735.5,red,1.88,2,17,36,red
4504019656,9,7,5,0,0,0,0,16880,7,17998,195,39,-296,872,19.5,1688,7,9,7,0,0,0,0,17176,6.8,17126,246,28,296,-872,24.6,1717.6,red,2,1.56,16,52,blue
4520878997,0,4,0,0,0,0,0,14144,6.6,16975,228,60,-1473,-29,22.8,1414.4,4,0,6,1,1,0,0,15617,6.6,17004,228,49,1473,29,22.8,1561.7,blue,0,12.65,42,21,red
4523302957,6,5,3,0,0,0,0,16056,7,17480,198,46,810,98,19.8,1605.6,5,6,3,1,1,0,0,15246,6.8,17382,192,58,-810,-98,19.2,1524.6,red,1.8,1.33,22,63,blue
4455324807,7,10,5,0,0,0,0,17444,7.2,18454,197,56,-180,-102,19.7,1744.4,10,7,12,2,1,1,0,17624,7,18556,204,52,180,102,20.4,1762.4,blue,1.2,3.14,43,18,red
4518444936,2,4,3,0,0,0,0,14716,6.8,17855,219,56,-839,63,21.9,1471.6,4,2,5,1,1,0,0,15555,7,17792,215,56,839,-63,21.5,1555.5,blue,1.25,4.5,18,19,red
4504045676,6,3,4,1,0,1,0,16443,7.4,19348,261,51,1030,914,26.1,1644.3,3,6,5,1,1,0,0,15413,7,18434,235,47,-1030,-914,23.5,1541.3,blue,3.33,1.33,24,47,red
4521355308,3,4,1,1,1,0,0,14507,6.6,17455,207,69,-885,180,20.7,1450.7,4,3,4,0,0,0,0,15392,6.8,17275,206,51,885,-180,20.6,1539.2,blue,1,2.67,21,21,red
4522798841,12,10,18,1,1,0,0,17974,6.2,15423,182,34,186,-741,18.2,1797.4,10,12,9,1,0,1,0,17788,6.4,16164,188,40,-186,741,18.8,1778.8,red,3,1.58,20,17,blue
4519568635,3,9,4,0,0,0,0,15279,6.8,17220,206,67,-3702,-1251,20.6,1527.9,9,3,14,2,1,1,1,18981,7,18471,237,52,3702,1251,23.7,1898.1,red,0.78,7.67,18,20,red
4467033955,8,4,7,1,0,1,0,18837,7.6,20066,246,48,3479,2657,24.6,1883.7,4,8,6,1,1,0,0,15358,6.8,17409,222,55,-3479,-2657,22.2,1535.8,blue,3.75,1.25,20,58,blue
4499944333,3,9,3,0,0,0,0,14291,6.4,15475,212,48,-4991,-3526,21.2,1429.1,9,3,13,2,1,1,1,19282,7.2,19001,216,53,4991,3526,21.6,1928.2,red,0.67,7.33,12,17,blue
4473436327,6,9,2,1,1,0,0,15290,6.8,16843,195,55,-2543,-538,19.5,1529,9,6,8,0,0,0,0,17833,6.6,17381,215,34,2543,538,21.5,1783.3,red,0.89,2.83,12,88,blue
4480001106,10,6,9,0,0,0,0,17687,7.2,19488,197,67,1729,2306,19.7,1768.7,6,10,5,0,0,0,0,15958,6.8,17182,194,48,-1729,-2306,19.4,1595.8,blue,3.17,1.1,37,18,blue
4479522740,5,7,6,0,0,0,0,15742,6.8,17327,228,36,-1964,-3104,22.8,1574.2,7,5,6,1,1,0,0,17706,7.6,20431,241,76,1964,3104,24.1,1770.6,red,1.57,2.6,18,21,blue
4519607930,1,3,1,1,1,0,0,13942,7,17704,219,52,-1231,-908,21.9,1394.2,3,1,1,0,0,0,0,15173,7,18612,248,56,1231,908,24.8,1517.3,red,0.67,4,14,17,red
4516676610,5,6,5,0,0,0,0,16452,7,17916,220,59,-445,141,22,1645.2,6,5,5,0,0,0,0,16897,7,17775,212,56,445,-141,21.2,1689.7,red,1.67,2.2,26,21,red
4499786377,5,4,3,1,1,0,0,16123,7,18987,235,52,857,961,23.5,1612.3,4,5,5,0,0,0,0,15266,7,18026,202,55,-857,-961,20.2,1526.6,red,2,1.8,35,15,red
4523463399,3,9,4,0,0,0,0,14725,6.6,16460,200,38,-2959,-2726,20,1472.5,9,3,9,0,0,0,0,17684,7,19186,213,48,2959,2726,21.3,1768.4,red,0.78,6,19,22,blue
4523432309,10,11,10,0,0,0,0,17151,6.8,17562,149,48,-1593,-1157,14.9,1715.1,11,10,9,0,0,0,0,18744,7.2,18719,212,37,1593,1157,21.2,1874.4,red,1.82,2,40,19,blue
4503435524,2,5,1,0,0,0,0,14616,7,18564,242,48,-1441,55,24.2,1461.6,5,2,7,1,1,0,0,16057,6.8,18509,207,67,1441,-55,20.7,1605.7,red,0.6,6,38,16,red
4478533693,5,4,5,1,1,0,0,15862,6.8,17599,220,56,-292,-440,22,1586.2,4,5,7,0,0,0,0,16154,7,18039,224,52,292,440,22.4,1615.4,blue,2.5,2.2,18,58,blue
4525170767,14,10,23,0,0,0,0,19139,6.8,17648,180,28,814,82,18,1913.9,10,14,14,0,0,0,0,18325,7,17566,203,46,-814,-82,20.3,1832.5,red,3.7,1.71,20,22,red
4520495410,6,6,9,1,1,0,1,18409,6.8,18255,212,60,225,-216,21.2,1840.9,6,6,4,1,0,1,2,18184,7,18471,242,60,-225,216,24.2,1818.4,blue,2.5,1.67,21,27,red
4462889102,9,7,9,0,0,0,0,18236,6.8,17468,207,63,2481,1470,20.7,1823.6,7,9,10,0,0,0,0,15755,6.6,15998,184,35,-2481,-1470,18.4,1575.5,blue,2.57,1.89,19,29,blue
4497643259,6,3,9,0,0,0,0,16991,6.8,18186,242,56,1116,1050,24.2,1699.1,3,6,5,0,0,0,0,15875,6.8,17136,248,45,-1116,-1050,24.8,1587.5,red,5,1.33,39,19,blue
4458668503,2,7,2,0,0,0,0,14270,6.4,15513,215,39,-3519,-4275,21.5,1427,7,2,8,1,1,0,0,17789,7.4,19788,241,56,3519,4275,24.1,1778.9,red,0.57,7.5,17,17,blue
4523946957,11,8,9,0,0,0,0,17802,7,17107,183,48,1124,1058,18.3,1780.2,8,11,10,1,1,0,0,16678,6.8,16049,190,46,-1124,-1058,19,1667.8,red,2.5,1.64,13,17,blue
4520778338,5,3,7,1,0,1,1,17340,7.2,18431,215,51,2486,2148,21.5,1734,3,5,3,0,0,0,0,14854,6.6,16283,223,40,-2486,-2148,22.3,1485.4,blue,4,1.2,17,104,blue
4524504649,10,4,15,2,1,1,0,18959,7.2,19473,244,60,3373,1784,24.4,1895.9,4,10,2,0,0,0,0,15586,6.8,17689,221,47,-3373,-1784,22.1,1558.6,red,6.25,0.6,18,15,blue
4497698751,3,8,3,0,0,0,0,14809,6.8,17625,232,44,-2595,-1917,23.2,1480.9,8,3,10,0,0,0,0,17404,7.2,19542,245,56,2595,1917,24.5,1740.4,red,0.75,6,43,21,red
4514381198,8,11,8,0,0,0,0,16900,6.8,17296,168,52,-590,527,16.8,1690,11,8,10,0,0,0,0,17490,6.4,16769,186,48,590,-527,18.6,1749,blue,1.45,2.62,185,10,red
4503150279,7,2,6,0,0,0,0,16647,7,18161,214,48,3257,2138,21.4,1664.7,2,7,1,0,0,0,0,13390,6.2,16023,197,44,-3257,-2138,19.7,1339,blue,6.5,0.43,19,29,blue
4521820831,6,3,2,1,0,1,0,17149,7,18751,257,57,2610,1716,25.7,1714.9,3,6,2,1,1,0,0,14539,6.6,17035,203,49,-2610,-1716,20.3,1453.9,blue,2.67,0.83,21,19,blue
4477133738,7,9,5,0,0,0,0,16855,7.2,18568,221,59,-1297,-856,22.1,1685.5,9,7,8,1,1,0,0,18152,7.2,19424,229,51,1297,856,22.9,1815.2,red,1.33,2.43,17,80,red
4434774244,10,10,7,0,0,0,0,17838,7,18262,230,39,-482,668,23,1783.8,10,10,16,1,0,1,0,18320,6.8,17594,202,40,482,-668,20.2,1832,blue,1.7,2.6,36,25,blue
4520597204,7,9,5,1,0,1,1,16730,6.8,17556,180,41,-1237,753,18,1673,9,7,10,1,1,0,0,17967,6.8,16803,196,57,1237,-753,19.6,1796.7,blue,1.33,2.71,15,15,blue
4513193579,8,14,7,1,0,1,0,16948,6.6,17462,181,44,-5335,-1002,18.1,1694.8,14,8,13,1,1,0,2,22283,7,18464,253,34,5335,1002,25.3,2228.3,red,1.07,3.38,23,21,red
4439857049,2,4,4,1,1,0,0,13946,6.6,16402,211,44,-1896,-2216,21.1,1394.6,4,2,5,0,0,0,0,15842,7,18618,232,55,1896,2216,23.2,1584.2,blue,1.5,4.5,15,17,blue
4507610115,6,0,7,0,0,0,0,16144,7,18236,199,49,1594,477,19.9,1614.4,0,6,0,1,1,0,0,14550,7,17759,257,60,-1594,-477,25.7,1455,blue,12.03,0,18,39,blue
4522867926,7,6,7,0,0,0,0,18248,7.2,19067,231,55,1989,1106,23.1,1824.8,6,7,3,1,1,0,0,16259,7,17961,215,55,-1989,-1106,21.5,1625.9,blue,2.33,1.29,25,39,blue
4511716965,9,4,12,1,0,1,0,18710,7.6,20305,210,80,3467,3958,21,1871,4,9,3,0,0,0,0,15243,6.4,16347,193,52,-3467,-3958,19.3,1524.3,blue,5.25,0.78,18,19,red
4513358950,2,7,1,1,0,1,0,14733,6.8,17627,224,52,-2267,-2546,22.4,1473.3,7,2,4,1,1,0,0,17000,7.6,20173,244,71,2267,2546,24.4,1700,red,0.43,5.5,19,18,blue
4509363217,5,7,4,0,0,0,0,15386,6.6,16591,188,44,-1739,-826,18.8,1538.6,7,5,9,1,0,1,0,17125,6.8,17417,222,48,1739,826,22.2,1712.5,red,1.29,3.2,35,28,blue
4521222405,5,7,7,0,0,0,0,15812,7,17291,227,40,-950,60,22.7,1581.2,7,5,7,1,1,0,0,16762,6.8,17231,233,51,950,-60,23.3,1676.2,red,1.71,2.8,27,25,red
4504197539,3,5,3,0,0,0,0,15553,7.2,18934,244,55,-1449,-349,24.4,1555.3,5,3,3,0,0,0,0,17002,7.2,19283,250,76,1449,349,25,1700.2,red,1.2,2.67,15,46,red
4472589919,7,5,6,0,0,0,0,16549,7.2,18284,205,59,611,1342,20.5,1654.9,5,7,9,1,1,0,0,15938,6.8,16942,203,44,-611,-1342,20.3,1593.8,red,2.6,2,24,21,red
4475225279,6,5,10,1,0,1,0,16348,7,17866,225,36,-720,-1208,22.5,1634.8,5,6,9,1,1,0,0,17068,7.2,19074,248,64,720,1208,24.8,1706.8,blue,3.2,2.33,17,16,blue
4518222649,5,5,5,1,0,1,0,16115,7.2,18971,237,48,516,2485,23.7,1611.5,5,5,8,0,0,0,0,15599,6.6,16486,213,42,-516,-2485,21.3,1559.9,red,2,2.6,18,21,red
4450233213,4,6,4,0,0,0,1,17814,7,18330,252,56,2154,25,25.2,1781.4,6,4,4,1,0,1,0,15660,7,18305,197,48,-2154,-25,19.7,1566,blue,1.33,2.5,18,15,blue
4511133368,7,9,5,0,0,0,0,16884,7.4,19682,220,67,-1474,-179,22,1688.4,9,7,8,1,1,0,0,18358,7.6,19861,228,60,1474,179,22.8,1835.8,red,1.33,2.43,13,14,blue
4516699298,6,12,8,0,0,0,0,16038,6.4,16019,209,36,-3674,-3098,20.9,1603.8,12,6,16,2,1,1,0,19712,7.6,19117,205,68,3674,3098,20.5,1971.2,red,1.17,4.67,48,13,red
4490758389,6,8,8,0,0,0,1,18198,7,17647,220,52,1549,-554,22,1819.8,8,6,8,0,0,0,0,16649,7,18201,220,40,-1549,554,22,1664.9,blue,1.75,2.67,23,23,red
4524397696,3,10,1,0,0,0,0,15827,7,17607,245,56,-2683,-2383,24.5,1582.7,10,3,12,1,1,0,0,18510,7.2,19990,234,59,2683,2383,23.4,1851,red,0.4,7.33,16,23,red
4520585674,6,4,7,0,0,0,0,16421,7,18708,224,44,267,-52,22.4,1642.1,4,6,7,1,1,0,0,16154,7.2,18760,241,55,-267,52,24.1,1615.4,blue,3.25,1.83,23,25,red
4511214856,9,7,13,0,0,0,0,18107,7,18643,210,70,1417,492,21,1810.7,7,9,8,0,0,0,0,16690,7,18151,199,45,-1417,-492,19.9,1669,blue,3.14,1.67,15,39,blue
4500339262,7,4,7,1,0,1,0,18821,7.2,19339,259,68,4074,2842,25.9,1882.1,4,7,6,0,0,0,0,14747,6.4,16497,189,36,-4074,-2842,18.9,1474.7,blue,3.5,1.43,14,14,blue
4514094698,7,7,6,1,1,0,0,16063,6.8,17688,192,60,-1571,-1130,19.2,1606.3,7,7,6,0,0,0,0,17634,7.2,18818,260,60,1571,1130,26,1763.4,red,1.86,1.86,51,53,red
4511489800,10,8,16,1,0,1,0,19376,7.2,19330,241,35,2068,1158,24.1,1937.6,8,10,7,0,0,0,0,17308,6.8,18172,204,49,-2068,-1158,20.4,1730.8,blue,3.25,1.5,39,11,blue
4516641337,11,8,14,0,0,0,0,18345,7.2,18508,218,52,1959,899,21.8,1834.5,8,11,10,2,1,1,0,16386,6.8,17609,198,44,-1959,-899,19.8,1638.6,red,3.12,1.64,21,17,blue
4524699601,8,5,7,0,0,0,0,16239,6.8,17856,200,48,36,1099,20,1623.9,5,8,6,0,0,0,0,16203,6.6,16757,215,44,-36,-1099,21.5,1620.3,blue,3,1.38,19,18,red
4469768643,10,4,8,0,0,0,0,17596,7.4,19125,211,55,2031,1116,21.1,1759.6,4,10,4,1,0,1,0,15565,7.2,18009,230,39,-2031,-1116,23,1556.5,blue,4.5,0.8,13,17,blue
4519221427,7,4,14,1,0,1,0,16655,6.8,17121,214,36,1054,-67,21.4,1665.5,4,7,5,1,1,0,0,15601,6.8,17188,214,56,-1054,67,21.4,1560.1,blue,5.25,1.29,20,20,blue
4458337524,7,7,5,0,0,0,0,17623,7.2,19660,233,68,724,1268,23.3,1762.3,7,7,7,1,1,0,0,16899,7.2,18392,223,56,-724,-1268,22.3,1689.9,blue,1.71,2,17,16,blue
4508680387,9,9,10,1,1,0,0,17326,6.8,17581,188,50,54,-321,18.8,1732.6,9,9,8,0,0,0,0,17272,6.8,17902,193,44,-54,321,19.3,1727.2,red,2.11,1.89,17,85,red
4524684326,6,3,6,1,1,0,0,16628,6.8,17323,230,56,2050,687,23,1662.8,3,6,2,0,0,0,0,14578,6.6,16636,195,43,-2050,-687,19.5,1457.8,blue,4,0.83,20,17,blue
4486065632,6,6,6,0,0,0,0,15863,6.8,17012,221,29,46,881,22.1,1586.3,6,6,9,0,0,0,0,15817,6.4,16131,191,46,-46,-881,19.1,1581.7,blue,2,2.5,41,46,red
4450357226,8,7,7,1,0,1,0,18698,7.4,20094,259,63,2078,2058,25.9,1869.8,7,8,7,1,1,0,0,16620,7,18036,207,52,-2078,-2058,20.7,1662,blue,2.14,1.75,21,18,blue
4521865491,14,6,15,0,0,0,0,21087,7.6,20108,215,36,5260,2633,21.5,2108.7,6,14,5,1,1,0,0,15827,7,17475,193,48,-5260,-2633,19.3,1582.7,blue,4.83,0.79,13,40,blue
4501754015,3,7,3,1,1,0,0,15689,6.8,17576,236,58,-2253,-1798,23.6,1568.9,7,3,8,0,0,0,0,17942,7.2,19374,238,58,2253,1798,23.8,1794.2,red,0.86,5,22,88,red
4524614022,2,2,4,0,0,0,0,14795,6.4,16396,208,47,204,-1452,20.8,1479.5,2,2,1,1,1,0,0,14591,6.8,17848,223,60,-204,1452,22.3,1459.1,blue,3,1.5,21,19,red
4491835607,16,6,20,2,1,1,1,21747,7.4,19828,244,49,5742,3475,24.4,2174.7,6,16,6,0,0,0,0,16005,6.6,16353,190,48,-5742,-3475,19,1600.5,blue,6,0.75,62,15,blue
4510513496,8,3,7,0,0,0,0,18103,7.4,19519,247,56,2683,1740,24.7,1810.3,3,8,3,1,1,0,0,15420,7,17779,241,52,-2683,-1740,24.1,1542,red,5,0.75,17,61,blue
4407377509,15,7,15,2,1,1,0,20822,6.8,18683,237,53,5040,2681,23.7,2082.2,7,15,8,0,0,0,0,15782,6.4,16002,187,26,-5040,-2681,18.7,1578.2,blue,4.29,1,40,24,blue
4491896790,5,4,7,0,0,0,0,15881,6.8,17469,239,44,76,98,23.9,1588.1,4,5,6,1,1,0,0,15805,6.8,17371,249,52,-76,-98,24.9,1580.5,red,3,2,22,20,red
4450546493,6,5,6,0,0,0,0,17342,7.2,19169,263,71,811,1501,26.3,1734.2,5,6,5,0,0,0,0,16531,6.6,17668,199,56,-811,-1501,19.9,1653.1,blue,2.4,1.67,18,13,red
4516319678,6,2,7,1,0,1,0,16583,7,18071,244,52,2191,1140,24.4,1658.3,2,6,1,1,1,0,0,14392,6.8,16931,218,52,-2191,-1140,21.8,1439.2,red,6.5,0.5,16,20,blue
4482120889,11,5,11,2,1,1,0,18544,7,18246,213,44,3046,1162,21.3,1854.4,5,11,5,0,0,0,0,15498,6.6,17084,198,48,-3046,-1162,19.8,1549.8,blue,4.4,0.91,20,14,blue
4520501061,6,6,6,0,0,0,0,17023,7.2,19264,255,66,671,804,25.5,1702.3,6,6,10,0,0,0,0,16352,6.8,18460,231,60,-671,-804,23.1,1635.2,blue,2,2.67,17,18,red
4468243911,6,7,2,0,0,0,0,16190,6.8,18041,234,54,-158,-67,23.4,1619,7,6,13,1,1,0,0,16348,7,18108,217,51,158,67,21.7,1634.8,red,1.14,3.33,13,16,blue
4506306158,9,5,15,0,0,0,0,17965,7,18483,210,63,2584,2273,21,1796.5,5,9,5,0,0,0,0,15381,6.4,16210,220,36,-2584,-2273,22,1538.1,blue,4.8,1.11,24,22,red
4500958321,5,5,10,0,0,0,0,16932,6.8,17955,239,56,1059,919,23.9,1693.2,5,5,4,1,0,1,0,15873,6.8,17036,192,56,-1059,-919,19.2,1587.3,blue,3,1.8,20,21,blue
4477371609,10,12,11,0,0,0,0,17793,7,18074,199,48,-1761,37,19.9,1779.3,12,10,14,2,1,1,1,19554,7,18037,206,40,1761,-37,20.6,1955.4,red,1.75,2.6,24,31,blue
4496877385,9,8,9,1,1,0,0,18096,6.8,17875,213,48,1827,972,21.3,1809.6,8,9,14,1,0,1,0,16269,6.8,16903,167,56,-1827,-972,16.7,1626.9,red,2.25,2.44,20,22,blue
4446010317,7,9,6,0,0,0,0,16317,6.6,16985,205,44,-2448,-1976,20.5,1631.7,9,7,7,1,1,0,1,18765,7.2,18961,238,42,2448,1976,23.8,1876.5,red,1.44,2.29,14,22,red
4496533687,4,8,3,1,1,0,0,15049,7,17666,218,52,-2088,-870,21.8,1504.9,8,4,7,0,0,0,0,17137,7.2,18536,240,47,2088,870,24,1713.7,blue,0.88,3.75,18,19,red
4475216536,11,7,21,1,1,0,0,18997,7.2,17998,237,45,1373,57,23.7,1899.7,7,11,7,0,0,0,0,17624,6.8,17941,227,48,-1373,-57,22.7,1762.4,red,4.57,1.27,19,22,blue
4438038380,7,5,10,0,0,0,0,17098,7.2,18682,229,58,1733,862,22.9,1709.8,5,7,4,1,1,0,0,15365,6.8,17820,206,63,-1733,-862,20.6,1536.5,red,3.4,1.29,19,57,blue
4518495220,8,8,4,2,1,1,0,16459,6.8,17550,190,48,-335,-213,19,1645.9,8,8,7,0,0,0,0,16794,7,17763,209,57,335,213,20.9,1679.4,blue,1.5,1.88,14,16,blue
4518191905,10,4,9,0,0,0,0,18129,7.4,20257,250,56,2915,3259,25,1812.9,4,10,4,1,1,0,0,15214,6.8,16998,193,48,-2915,-3259,19.3,1521.4,blue,4.75,0.8,17,15,red
4471147482,3,7,4,0,0,0,0,14459,6.6,16596,202,44,-2499,-1870,20.2,1445.9,7,3,13,1,1,0,0,16958,7,18466,238,40,2499,1870,23.8,1695.8,red,1,6.67,21,20,red
4521231615,5,10,6,0,0,0,0,16373,6.8,16941,237,51,-1343,-1261,23.7,1637.3,10,5,17,1,1,0,0,17716,6.8,18202,195,57,1343,1261,19.5,1771.6,blue,1.1,5.4,17,17,red
4464937851,7,7,7,1,1,0,0,16645,6.8,18070,231,44,-742,-750,23.1,1664.5,7,7,5,0,0,0,0,17387,7,18820,223,72,742,750,22.3,1738.7,red,2,1.71,18,13,red
4524343815,2,7,4,1,0,1,0,14010,6.4,16322,187,38,-3047,-612,18.7,1401,7,2,9,1,1,0,0,17057,6.6,16934,215,38,3047,612,21.5,1705.7,blue,0.86,8,19,16,red
4514102884,2,5,2,0,0,0,0,14780,7,17765,249,51,-1828,-1146,24.9,1478,5,2,6,1,1,0,0,16608,7.2,18911,230,84,1828,1146,23,1660.8,red,0.8,5.5,19,21,red
4450865114,7,8,10,1,0,1,0,16740,6.8,18257,234,40,-1784,-889,23.4,1674,8,7,8,1,1,0,0,18524,7,19146,251,64,1784,889,25.1,1852.4,red,2.12,2.29,19,19,blue
4500429958,7,7,8,1,1,0,0,16812,6.8,17939,226,52,-260,-369,22.6,1681.2,7,7,7,0,0,0,0,17072,7.2,18308,233,53,260,369,23.3,1707.2,red,2.14,2,16,53,blue
4518125489,7,4,9,0,0,0,0,16667,7,18043,223,43,1465,201,22.3,1666.7,4,7,6,1,1,0,0,15202,7,17842,218,52,-1465,-201,21.8,1520.2,red,4,1.43,21,20,blue
4504929560,10,5,7,0,0,0,0,17954,7.2,19474,201,62,2427,2365,20.1,1795.4,5,10,6,0,0,0,0,15527,6.8,17109,224,37,-2427,-2365,22.4,1552.7,blue,3.4,1.1,19,20,red
4469763796,11,3,14,1,1,0,1,19278,7.4,19529,226,42,4230,3209,22.6,1927.8,3,11,3,0,0,0,0,15048,6.4,16320,186,66,-4230,-3209,18.6,1504.8,blue,8.33,0.55,15,16,blue
4523335344,5,11,6,0,0,0,0,14784,6.4,15775,173,40,-3584,-3674,17.3,1478.4,11,5,8,0,0,0,0,18368,7.2,19449,211,60,3584,3674,21.1,1836.8,red,1,3.8,11,21,red
4524483591,3,8,1,0,0,0,0,14290,6.8,17459,204,52,-3260,-1060,20.4,1429,8,3,8,1,1,0,0,17550,7.2,18519,221,61,3260,1060,22.1,1755,red,0.5,5.33,15,21,red
4450495621,9,5,12,0,0,0,0,16759,7,17756,183,48,988,581,18.3,1675.9,5,9,9,2,1,1,0,15771,6.6,17175,198,59,-988,-581,19.8,1577.1,blue,4.2,1.56,17,18,blue
4475840580,5,2,3,0,0,0,0,16929,7.2,19477,232,76,1398,1802,23.2,1692.9,2,5,3,0,0,0,0,15531,7,17675,239,60,-1398,-1802,23.9,1553.1,blue,4,1,18,18,red
4458734669,3,4,3,1,0,1,0,14839,6.8,17590,205,53,-986,-1894,20.5,1483.9,4,3,3,1,1,0,0,15825,7.4,19484,250,48,986,1894,25,1582.5,red,1.5,2.33,26,104,blue
4524802127,8,6,6,0,0,0,0,16820,6.8,17719,223,39,439,-524,22.3,1682,6,8,4,1,1,0,0,16381,7,18243,214,64,-439,524,21.4,1638.1,blue,2.33,1.25,25,15,blue
4475829266,8,6,9,2,1,1,0,18010,7.2,20078,224,66,2120,2095,22.4,1801,6,8,5,0,0,0,0,15890,7,17983,229,36,-2120,-2095,22.9,1589,red,2.83,1.38,22,20,blue
4459200574,6,3,11,1,1,0,0,16409,6.6,16448,228,52,1642,-1085,22.8,1640.9,3,6,3,1,0,1,0,14767,6.8,17533,204,60,-1642,1085,20.4,1476.7,red,5.67,1,27,20,blue
4523613345,7,5,9,1,1,0,0,17456,7,17732,261,47,1480,721,26.1,1745.6,5,7,7,0,0,0,0,15976,6.6,17011,209,52,-1480,-721,20.9,1597.6,red,3.2,1.71,43,20,blue
4484419381,7,5,7,0,0,0,0,17235,7.4,19413,251,48,750,867,25.1,1723.5,5,7,8,0,0,0,0,16485,7.2,18546,230,60,-750,-867,23,1648.5,red,2.8,1.86,14,12,red
4464122036,7,3,7,1,0,1,0,16934,7,19205,228,44,1714,1369,22.8,1693.4,3,7,4,1,1,0,0,15220,6.8,17836,229,51,-1714,-1369,22.9,1522,blue,4.67,1,22,46,blue
4524415638,5,6,4,0,0,0,0,15109,7,18112,213,43,-1493,-382,21.3,1510.9,6,5,2,1,1,0,0,16602,7,18494,230,52,1493,382,23,1660.2,red,1.5,1.6,17,101,blue
4524256472,7,6,5,1,1,0,0,16898,7,17534,226,53,599,267,22.6,1689.8,6,7,7,1,0,1,0,16299,6.8,17267,203,50,-599,-267,20.3,1629.9,blue,2,1.86,29,35,blue
4509657547,12,11,12,0,0,0,0,19237,7.2,18874,209,72,981,369,20.9,1923.7,11,12,11,0,0,0,0,18256,7,18505,233,32,-981,-369,23.3,1825.6,blue,2.18,1.83,23,17,blue
4489404475,7,5,8,0,0,0,0,16525,6.8,17494,191,51,67,-303,19.1,1652.5,5,7,5,0,0,0,0,16458,7,17797,228,46,-67,303,22.8,1645.8,blue,3,1.43,21,15,red
4498058442,3,5,2,0,0,0,0,14452,6.4,15418,186,49,-1404,-2296,18.6,1445.2,5,3,3,1,1,0,0,15856,6.8,17714,228,56,1404,2296,22.8,1585.6,red,1,2.67,40,20,blue
4523343583,8,4,8,1,1,0,0,17463,7,18601,229,50,2337,2150,22.9,1746.3,4,8,3,0,0,0,0,15126,6.8,16451,204,39,-2337,-2150,20.4,1512.6,blue,4,0.88,24,23,red
4465280441,10,9,13,0,0,0,0,18695,7.2,18459,225,48,601,152,22.5,1869.5,9,10,9,0,0,0,0,18094,7,18307,199,52,-601,-152,19.9,1809.4,red,2.56,1.8,78,49,red
4523021223,4,6,2,1,0,1,0,15360,6.6,16644,220,44,-829,-1232,22,1536,6,4,4,1,1,0,0,16189,6.8,17876,232,43,829,1232,23.2,1618.9,red,1,2.5,21,21,red
4524774054,9,5,13,0,0,0,0,17626,7.2,18770,219,44,2511,3602,21.9,1762.6,5,9,13,2,1,1,0,15115,6,15168,162,47,-2511,-3602,16.2,1511.5,blue,4.4,2,21,42,red
4497972211,4,3,5,0,0,0,0,15429,7,18085,238,41,39,-301,23.8,1542.9,3,4,2,1,1,0,0,15390,7,18386,238,60,-39,301,23.8,1539,blue,3,1.25,20,18,red
4510968439,3,3,3,1,1,0,0,15271,7,18226,236,55,-455,-767,23.6,1527.1,3,3,3,0,0,0,0,15726,7.2,18993,258,59,455,767,25.8,1572.6,blue,2,2,13,13,blue
4516538758,2,5,3,2,1,1,0,14961,6.6,17746,210,56,-2377,-2713,21,1496.1,5,2,4,0,0,0,0,17338,7.6,20459,269,64,2377,2713,26.9,1733.8,blue,1,4.5,21,40,red
4517860890,14,3,14,0,0,0,4,23424,7.4,18730,220,41,11467,8265,22,2342.4,3,14,2,0,0,0,0,11957,5,10465,117,32,-11467,-8265,11.7,1195.7,blue,9.33,0.36,18,9,blue
4518359137,8,8,6,0,0,0,0,16983,7.2,18675,198,52,-125,-479,19.8,1698.3,8,8,7,1,1,0,0,17108,7.4,19154,208,51,125,479,20.8,1710.8,red,1.75,1.88,13,19,blue
4489197870,7,2,8,0,0,0,0,17490,7.6,19737,259,66,2880,3031,25.9,1749,2,7,2,0,0,0,0,14610,6.6,16706,215,50,-2880,-3031,21.5,1461,red,7.5,0.57,14,16,blue
4426693677,15,6,12,0,0,0,0,18863,7.2,18943,195,52,2789,585,19.5,1886.3,6,15,4,0,0,0,0,16074,7,18358,192,52,-2789,-585,19.2,1607.4,red,4.5,0.67,24,42,blue
4523841785,12,6,9,1,1,0,0,18259,7.2,19685,218,48,2254,1555,21.8,1825.9,6,12,3,0,0,0,0,16005,7,18130,215,42,-2254,-1555,21.5,1600.5,blue,3.5,0.75,24,21,blue
4471429482,9,3,13,1,1,0,0,17939,7.2,18687,220,48,3246,409,22,1793.9,3,9,0,0,0,0,0,14693,7,18278,235,52,-3246,-409,23.5,1469.3,blue,7.33,0.33,16,15,blue
4522484081,4,5,5,1,1,0,0,14695,7.2,18082,200,45,-1766,-639,20,1469.5,5,4,3,0,0,0,0,16461,7,18721,259,56,1766,639,25.9,1646.1,red,1.8,2,36,15,red
4523655915,3,12,2,1,1,0,0,14299,6.4,15937,207,38,-4376,-3665,20.7,1429.9,12,3,14,1,0,1,0,18675,7.4,19602,206,55,4376,3665,20.6,1867.5,red,0.42,8.67,120,49,blue
4516700251,8,3,9,1,1,0,0,17328,7.2,19304,228,69,2357,2202,22.8,1732.8,3,8,2,0,0,0,0,14971,6.8,17102,222,44,-2357,-2202,22.2,1497.1,blue,5.67,0.62,43,20,red
4513284283,9,5,11,1,1,0,0,17299,7,18277,213,44,2079,1371,21.3,1729.9,5,9,4,0,0,0,0,15220,6.6,16906,193,51,-2079,-1371,19.3,1522,blue,4,1,17,23,red
4487406430,10,4,14,1,1,0,0,18541,7,18196,210,48,4362,2989,21,1854.1,4,10,2,0,0,0,0,14179,6.4,15207,176,30,-4362,-2989,17.6,1417.9,blue,6,0.6,23,46,red
4475003668,2,7,3,0,0,0,0,14854,6.8,17513,250,55,-3330,-2255,25,1485.4,7,2,10,1,1,0,0,18184,7.4,19768,248,64,3330,2255,24.8,1818.4,red,0.71,8.5,23,22,red
4517491140,11,6,15,2,1,1,0,17816,7.4,18626,209,40,1488,1092,20.9,1781.6,6,11,9,0,0,0,0,16328,7,17534,225,48,-1488,-1092,22.5,1632.8,red,4.33,1.36,20,59,blue
4524829735,7,9,9,0,0,0,0,17482,7.2,18618,233,42,-561,-489,23.3,1748.2,9,7,9,0,0,0,0,18043,7.2,19107,224,41,561,489,22.4,1804.3,red,1.78,2.57,38,19,red
4462050605,11,9,9,1,0,1,1,19754,7,18453,227,48,1379,246,22.7,1975.4,9,11,15,1,1,0,0,18375,7.2,18207,215,60,-1379,-246,21.5,1837.5,blue,2.22,2.18,17,16,red
4473131351,8,8,6,1,1,0,0,17928,6.8,17767,217,45,1250,297,21.7,1792.8,8,8,13,0,0,0,0,16678,6.8,17470,192,38,-1250,-297,19.2,1667.8,blue,1.75,2.62,19,23,blue
4467354917,6,5,6,1,1,0,0,16273,7.2,19013,237,44,464,1383,23.7,1627.3,5,6,2,1,0,1,0,15809,7,17630,235,43,-464,-1383,23.5,1580.9,blue,2.4,1.17,22,19,red
4523089972,6,7,6,0,0,0,0,16473,7,17992,204,64,-628,-582,20.4,1647.3,7,6,4,1,1,0,0,17101,7.2,18574,218,64,628,582,21.8,1710.1,blue,1.71,1.83,20,21,red
4524915225,5,12,4,0,0,0,0,16033,7,17043,207,40,-2746,-827,20.7,1603.3,12,5,17,0,0,0,0,18779,6.8,17870,202,48,2746,827,20.2,1877.9,blue,0.75,5.8,20,23,red
4518298214,12,13,14,0,0,0,0,18002,6.8,17743,178,43,-2340,-2351,17.8,1800.2,13,12,16,1,1,0,0,20342,7.6,20094,220,65,2340,2351,22,2034.2,red,2,2.42,18,18,blue
4523504461,13,7,12,1,1,0,0,19360,7.2,19057,238,52,3034,1636,23.8,1936,7,13,7,0,0,0,0,16326,6.6,17421,183,56,-3034,-1636,18.3,1632.6,blue,3.57,1.08,16,16,blue
4467077556,1,5,1,0,0,0,0,14777,6.8,17674,231,59,-1664,-990,23.1,1477.7,5,1,7,1,0,1,0,16441,7.2,18664,236,46,1664,990,23.6,1644.1,red,0.4,12,20,50,red
4435875824,8,10,9,0,0,0,0,16738,6.8,17657,199,48,-1428,-671,19.9,1673.8,10,8,16,1,1,0,0,18166,7,18328,201,52,1428,671,20.1,1816.6,red,1.7,3.25,19,20,red
4511873331,7,4,7,1,1,0,0,17070,7.2,18583,223,47,1451,1441,22.3,1707,4,7,4,0,0,0,0,15619,6.8,17142,199,56,-1451,-1441,19.9,1561.9,blue,3.5,1.14,42,13,blue
4523290421,7,10,7,0,0,0,0,16995,6.8,17908,217,44,-1666,-759,21.7,1699.5,10,7,15,1,1,0,0,18661,7,18667,243,60,1666,759,24.3,1866.1,red,1.4,3.57,20,22,blue
4489154940,9,7,12,1,1,0,0,17896,6.8,18474,215,58,1076,1288,21.5,1789.6,7,9,10,0,0,0,0,16820,6.8,17186,222,40,-1076,-1288,22.2,1682,blue,3,1.89,26,90,red
4521090757,2,3,5,0,0,0,0,15186,7.2,18537,236,67,-35,1112,23.6,1518.6,3,2,4,0,0,0,0,15221,6.8,17425,236,48,35,-1112,23.6,1522.1,blue,2.33,3.5,113,22,red
4516555764,7,2,4,0,0,0,0,17294,7.4,19906,246,64,2480,3168,24.6,1729.4,2,7,2,0,0,0,0,14814,6.6,16738,218,48,-2480,-3168,21.8,1481.4,red,5.5,0.57,37,12,blue
4447227454,5,2,7,1,1,0,0,16443,7,18538,238,48,1717,508,23.8,1644.3,2,5,4,0,0,0,0,14726,7,18030,197,60,-1717,-508,19.7,1472.6,blue,6,1.2,15,12,blue
4523478431,5,7,5,0,0,0,0,15420,6.6,16502,210,44,-692,-604,21,1542,7,5,7,2,1,1,0,16112,6.8,17106,193,48,692,604,19.3,1611.2,red,1.43,2.8,21,19,red
4519775314,3,3,4,0,0,0,0,14979,7,17553,237,48,-1171,-496,23.7,1497.9,3,3,3,0,0,0,0,16150,7,18049,251,52,1171,496,25.1,1615,blue,2.33,2,26,15,red
4477340237,8,6,8,1,1,0,0,16984,6.8,17114,205,48,469,-755,20.5,1698.4,6,8,5,1,0,1,0,16515,7,17869,233,47,-469,755,23.3,1651.5,blue,2.67,1.38,23,45,blue
4523056452,7,5,6,1,1,0,0,16580,7,17570,207,36,-334,-1403,20.7,1658,5,7,5,0,0,0,0,16914,7,18973,228,56,334,1403,22.8,1691.4,blue,2.6,1.43,18,19,red
4470414312,1,1,1,1,1,0,0,14529,7,17655,241,58,924,1282,24.1,1452.9,1,1,0,1,0,1,0,13605,6.4,16373,215,42,-924,-1282,21.5,1360.5,blue,2,1,22,21,blue
4476935585,5,8,5,0,0,0,0,16616,6.6,17294,218,40,-827,-981,21.8,1661.6,8,5,11,0,0,0,0,17443,6.8,18275,243,40,827,981,24.3,1744.3,blue,1.25,3.8,20,18,blue
4512472589,3,7,3,1,1,0,0,15199,6.8,17382,235,45,-1631,-1338,23.5,1519.9,7,3,7,1,0,1,0,16830,7,18720,206,49,1631,1338,20.6,1683,blue,0.86,4.67,17,16,blue
4520844282,6,9,9,0,0,0,0,16240,7.2,18554,205,68,-2184,-1298,20.5,1624,9,6,9,1,1,0,0,18424,7.2,19852,250,56,2184,1298,25,1842.4,red,1.67,3,14,86,red
4524808186,7,8,10,1,1,0,0,15719,6.4,16209,172,25,-833,-1553,17.2,1571.9,8,7,7,0,0,0,0,16552,6.8,17762,201,47,833,1553,20.1,1655.2,red,2.12,2.14,21,19,blue
4454438289,8,10,15,1,1,0,0,17231,7,17898,193,59,-1471,-1810,19.3,1723.1,10,8,11,0,0,0,0,18702,7.2,19708,213,52,1471,1810,21.3,1870.2,blue,2.3,2.62,16,21,blue
4470384241,10,4,12,1,1,0,0,18945,7,18620,234,44,2542,525,23.4,1894.5,4,10,4,0,0,0,0,16403,6.8,18095,231,76,-2542,-525,23.1,1640.3,blue,5.5,0.8,19,15,blue
4517599722,8,5,9,1,1,0,0,16779,7,18171,224,43,1468,195,22.4,1677.9,5,8,4,1,0,1,0,15311,7,17976,212,44,-1468,-195,21.2,1531.1,blue,3.4,1.12,17,28,blue
4477434539,7,3,4,1,0,1,0,17993,7.8,20973,253,69,2782,4425,25.3,1799.3,3,7,4,1,1,0,0,15211,6.4,16548,221,57,-2782,-4425,22.1,1521.1,blue,3.67,1,36,21,red
4524368575,8,9,5,1,0,1,0,15782,6.8,16191,182,36,-2323,-2444,18.2,1578.2,9,8,8,1,1,0,0,18105,7,18635,185,58,2323,2444,18.5,1810.5,red,1.44,2.12,16,18,red
4494697495,10,5,8,1,1,0,0,17910,7.2,20300,211,60,2786,3197,21.1,1791,5,10,4,0,0,0,0,15124,6.8,17103,175,48,-2786,-3197,17.5,1512.4,blue,3.6,0.9,16,11,red
4520554250,7,7,4,0,0,0,0,17319,7,18310,253,36,2209,1640,25.3,1731.9,7,7,6,2,1,1,0,15110,6.8,16670,159,49,-2209,-1640,15.9,1511,red,1.57,1.86,26,20,red
4470048867,7,0,4,2,1,1,0,17788,7.2,19185,256,67,4961,3591,25.6,1778.8,0,7,0,0,0,0,0,12827,6.2,15594,202,40,-4961,-3591,20.2,1282.7,blue,12.03,0,17,19,blue
4427804202,7,6,14,1,1,0,0,16304,6.2,15338,182,45,-61,-1738,18.2,1630.4,6,7,8,0,0,0,0,16365,6.4,17076,219,44,61,1738,21.9,1636.5,blue,3.5,2,17,19,red
4522498843,3,4,1,1,0,1,0,15438,7.2,19325,213,62,-38,2015,21.3,1543.8,4,3,3,1,1,0,0,15476,6.8,17310,218,59,38,-2015,21.8,1547.6,red,1,2.33,16,12,red
4502099918,12,7,9,0,0,0,0,18879,7.4,19472,219,40,1912,1686,21.9,1887.9,7,12,8,1,1,0,0,16967,7,17786,197,50,-1912,-1686,19.7,1696.7,blue,3,1.25,18,125,red
4523945577,7,5,10,0,0,0,0,16987,6.8,18078,235,40,2407,543,23.5,1698.7,5,7,2,2,1,1,0,14580,6.8,17535,168,60,-2407,-543,16.8,1458,blue,3.4,1,19,15,blue
4468252863,6,5,2,0,0,0,0,15740,7,18504,201,46,1078,2430,20.1,1574,5,6,5,1,1,0,0,14662,6.6,16074,158,53,-1078,-2430,15.8,1466.2,blue,1.6,1.67,21,15,blue
4498654804,4,8,5,1,1,0,0,15375,7,18057,220,60,-1489,-2144,22,1537.5,8,4,3,0,0,0,0,16864,7.6,20201,230,52,1489,2144,23,1686.4,red,1.12,2.75,16,18,red
4506261342,7,13,8,0,0,0,0,16658,6.6,17588,192,50,-2184,-2333,19.2,1665.8,13,7,8,1,1,0,0,18842,7.4,19921,202,52,2184,2333,20.2,1884.2,red,1.15,3,14,73,red
4524963317,10,3,8,0,0,0,0,18130,7,18640,216,41,3905,1506,21.6,1813,3,10,3,1,1,0,0,14225,6.8,17134,173,56,-3905,-1506,17.3,1422.5,blue,6,0.6,73,24,blue
4519466762,1,2,1,1,1,0,0,13486,6.6,16382,200,47,-1433,-394,20,1348.6,2,1,2,0,0,0,0,14919,6.6,16776,241,40,1433,394,24.1,1491.9,red,1,4,22,18,red
4524520097,0,6,0,0,0,0,0,13421,6.6,17265,221,52,-3543,-1737,22.1,1342.1,6,0,7,1,1,0,0,16964,7.2,19002,242,48,3543,1737,24.2,1696.4,red,0,12.65,15,15,red
4524133023,5,11,7,1,1,0,0,14587,6.2,14862,171,42,-3541,-4118,17.1,1458.7,11,5,12,0,0,0,0,18128,7.2,18980,218,40,3541,4118,21.8,1812.8,red,1.09,4.6,18,13,blue
4524503051,4,4,5,0,0,0,0,15741,7,18215,224,63,-425,-284,22.4,1574.1,4,4,5,1,1,0,0,16166,7,18499,228,56,425,284,22.8,1616.6,red,2.25,2.25,19,17,red
4524019203,8,5,9,0,0,0,0,18098,7.2,19504,212,76,2730,3068,21.2,1809.8,5,8,2,1,1,0,0,15368,6.4,16436,215,40,-2730,-3068,21.5,1536.8,red,3.4,0.88,23,21,red
4427502264,9,3,9,1,1,0,1,18695,7.2,19263,245,56,4298,2299,24.5,1869.5,3,9,2,1,0,1,0,14397,6.8,16964,190,56,-4298,-2299,19,1439.7,blue,6,0.56,18,15,red
4517168876,4,8,6,0,0,0,0,15549,6.8,18169,228,65,-1841,-357,22.8,1554.9,8,4,11,0,0,0,0,17390,7,18526,223,49,1841,357,22.3,1739,red,1.25,4.75,17,29,blue
4384417283,10,3,13,1,1,0,0,17951,7.2,18502,226,44,3022,2631,22.6,1795.1,3,10,5,0,0,0,0,14929,6.6,15871,209,44,-3022,-2631,20.9,1492.9,blue,7.67,0.8,21,17,red
4452471591,12,3,11,1,1,0,0,18428,7,18214,218,47,3117,1745,21.8,1842.8,3,12,4,0,0,0,0,15311,6.6,16469,254,28,-3117,-1745,25.4,1531.1,red,7.67,0.58,25,45,blue
4515772836,8,2,4,1,1,0,0,16466,6.8,18740,205,51,2489,2364,20.5,1646.6,2,8,2,0,0,0,0,13977,6.8,16376,194,50,-2489,-2364,19.4,1397.7,blue,6,0.5,18,16,blue
4509689834,7,1,8,1,1,0,0,17056,7,18608,232,51,3515,2156,23.2,1705.6,1,7,1,1,0,1,0,13541,6.6,16452,208,49,-3515,-2156,20.8,1354.1,blue,15,0.29,14,14,red
4523311875,9,6,7,1,1,0,0,18017,7.2,19071,210,80,1937,766,21,1801.7,6,9,6,0,0,0,0,16080,7.2,18305,209,68,-1937,-766,20.9,1608,blue,2.67,1.33,17,14,blue
4524763167,17,10,21,0,0,0,1,22745,6.8,17394,205,23,4999,1094,20.5,2274.5,10,17,11,1,1,0,0,17746,6.4,16300,175,58,-4999,-1094,17.5,1774.6,blue,3.8,1.24,21,17,red
4469886384,1,7,2,0,0,0,0,13998,6.6,17086,207,55,-5086,-3284,20.7,1399.8,7,1,8,1,1,0,0,19084,7.6,20370,258,66,5086,3284,25.8,1908.4,red,0.43,15,41,16,red
4452601584,9,7,7,0,0,0,0,18012,7,19569,239,41,1194,2051,23.9,1801.2,7,9,6,1,1,0,0,16818,6.6,17518,221,42,-1194,-2051,22.1,1681.8,red,2.29,1.44,40,49,red
4523444869,5,3,6,0,0,0,0,15840,6.8,17440,211,52,923,828,21.1,1584,3,5,4,1,1,0,0,14917,6.4,16612,235,46,-923,-828,23.5,1491.7,red,3.67,1.4,16,20,blue
4517863926,6,4,12,2,1,1,0,17784,7,17328,223,48,1500,-1268,22.3,1778.4,4,6,6,0,0,0,0,16284,7.2,18596,233,72,-1500,1268,23.3,1628.4,blue,4.5,1.67,17,16,blue
4513809360,8,4,12,2,1,1,0,18167,7,18502,222,68,2691,2585,22.2,1816.7,4,8,4,0,0,0,0,15476,6.2,15917,234,41,-2691,-2585,23.4,1547.6,blue,5,1,27,18,red
4491456543,10,1,15,1,1,0,0,18795,7.4,20241,260,43,4498,3370,26,1879.5,1,10,2,0,0,0,0,14297,6.4,16871,226,48,-4498,-3370,22.6,1429.7,blue,25,0.3,25,25,blue
4452529666,8,5,15,2,1,1,0,17999,7.2,19381,214,82,2711,2160,21.4,1799.9,5,8,3,0,0,0,0,15288,7,17221,213,50,-2711,-2160,21.3,1528.8,blue,4.6,1,14,16,red
4522671632,7,5,5,1,1,0,0,17381,7.2,19539,234,59,1300,1783,23.4,1738.1,5,7,6,0,0,0,0,16081,6.8,17756,227,52,-1300,-1783,22.7,1608.1,blue,2.4,1.57,25,24,red
4456677220,2,10,2,0,0,0,0,14194,6.2,14858,195,48,-5553,-4226,19.5,1419.4,10,2,12,1,0,1,1,19747,7.2,19084,233,49,5553,4226,23.3,1974.7,red,0.4,11,16,13,red
4465078328,5,4,6,0,0,0,0,15732,6.6,16582,218,44,17,-1014,21.8,1573.2,4,5,4,0,0,0,0,15715,7,17596,248,44,-17,1014,24.8,1571.5,red,2.75,1.6,29,18,red
4474570659,11,6,10,0,0,0,0,18335,6.8,17921,238,36,2498,732,23.8,1833.5,6,11,7,0,0,0,0,15837,6.8,17189,194,52,-2498,-732,19.4,1583.7,blue,3.5,1.18,16,16,blue
4478150249,9,8,12,1,0,1,0,17785,7,17509,202,49,1323,183,20.2,1778.5,8,9,6,1,1,0,0,16462,6.8,17326,181,60,-1323,-183,18.1,1646.2,blue,2.62,1.56,17,33,blue
4505177490,8,4,11,1,1,0,0,16911,7.2,19106,217,53,2265,2392,21.7,1691.1,4,8,4,0,0,0,0,14646,6.8,16714,178,55,-2265,-2392,17.8,1464.6,blue,4.75,1,65,33,red
4521738539,16,6,16,0,0,0,0,21442,7.6,20440,232,48,5956,4568,23.2,2144.2,6,16,5,0,0,0,0,15486,6.4,15872,185,40,-5956,-4568,18.5,1548.6,blue,5.33,0.69,19,18,blue
4497526633,3,4,2,0,0,0,0,14652,7,18395,235,42,-1075,11,23.5,1465.2,4,3,2,1,1,0,0,15727,7.2,18384,233,58,1075,-11,23.3,1572.7,red,1.25,2,16,20,red
4521775433,5,8,6,0,0,0,0,16936,6.8,17513,215,63,-301,71,21.5,1693.6,8,5,10,1,1,0,0,17237,7,17442,187,60,301,-71,18.7,1723.7,blue,1.38,3.6,47,51,red
4521049898,6,9,6,0,0,0,0,15821,6.8,17419,208,43,-3364,-1990,20.8,1582.1,9,6,7,1,0,1,1,19185,7.2,19409,230,49,3364,1990,23,1918.5,red,1.33,2.67,14,141,blue
4460661408,7,4,8,1,1,0,0,17863,7.4,19967,257,39,3109,3007,25.7,1786.3,4,7,5,0,0,0,0,14754,6.4,16960,204,44,-3109,-3007,20.4,1475.4,blue,3.75,1.29,22,15,red
4514331863,16,7,16,1,1,0,1,20300,7.4,19812,192,44,3309,2603,19.2,2030,7,16,6,1,0,1,0,16991,6.8,17209,194,48,-3309,-2603,19.4,1699.1,blue,4.57,0.81,20,218,red
4493828380,5,6,3,0,0,0,0,15964,7.2,19695,206,59,-226,972,20.6,1596.4,6,5,7,1,1,0,0,16190,7.2,18723,208,40,226,-972,20.8,1619,red,1.33,2.6,16,25,blue
4519552784,11,9,10,1,1,0,0,18172,6.8,17184,191,36,1390,437,19.1,1817.2,9,11,7,0,0,0,0,16782,6.6,16747,181,30,-1390,-437,18.1,1678.2,red,2.33,1.45,25,16,blue
4507707770,6,13,5,0,0,0,0,15662,6.4,16109,191,36,-3983,-1784,19.1,1566.2,13,6,13,1,1,0,0,19645,7.2,17893,218,32,3983,1784,21.8,1964.5,red,0.85,4.33,16,19,red
4498286628,0,10,0,0,0,0,0,12863,6.6,16182,177,56,-5961,-4133,17.7,1286.3,10,0,9,1,1,0,0,18824,7.6,20315,244,48,5961,4133,24.4,1882.4,red,0,12.65,12,38,red
4457117855,11,9,13,1,1,0,0,19236,7.4,20585,231,48,2249,2480,23.1,1923.6,9,11,8,0,0,0,0,16987,7,18105,219,40,-2249,-2480,21.9,1698.7,blue,2.67,1.55,25,18,blue
4520613547,4,9,5,0,0,0,0,16500,7,18352,249,50,-981,-1105,24.9,1650,9,4,10,2,1,1,0,17481,7.2,19457,193,61,981,1105,19.3,1748.1,red,1,4.75,19,13,blue
4466299891,2,5,2,0,0,0,0,15292,6.8,17578,252,52,-1774,-2576,25.2,1529.2,5,2,4,1,1,0,0,17066,7.6,20154,267,72,1774,2576,26.7,1706.6,blue,0.8,4.5,22,43,red
4522859590,11,4,10,0,0,0,1,19677,6.8,17356,217,45,6581,3949,21.7,1967.7,4,11,5,0,0,0,0,13096,5.8,13407,132,39,-6581,-3949,13.2,1309.6,blue,5.25,0.82,16,15,blue
4518065335,5,10,4,0,0,0,0,15660,7,18016,201,50,-2602,-550,20.1,1566,10,5,14,1,1,0,0,18262,7.2,18566,197,42,2602,550,19.7,1826.2,red,0.9,4.8,14,173,red
4486171002,4,12,3,0,0,0,0,15639,6.4,17326,227,55,-2608,-1326,22.7,1563.9,12,4,13,0,0,0,0,18247,7,18652,198,52,2608,1326,19.8,1824.7,blue,0.58,6.25,16,21,red
4517966226,5,5,6,2,1,1,0,16746,7.2,18699,247,56,1066,-560,24.7,1674.6,5,5,4,0,0,0,0,15680,7.4,19259,239,47,-1066,560,23.9,1568,blue,2.2,1.8,25,45,blue
4474190443,5,10,1,0,0,0,0,15042,6.8,16868,189,56,-3052,-775,18.9,1504.2,10,5,13,1,1,0,0,18094,7,17643,201,56,3052,775,20.1,1809.4,blue,0.6,4.6,27,24,red
4510356766,1,3,2,0,0,0,0,13496,6.6,16421,186,50,-2452,-2422,18.6,1349.6,3,1,3,1,1,0,0,15948,7.2,18843,255,64,2452,2422,25.5,1594.8,red,1,6,19,21,red
4450209621,8,9,9,2,1,1,0,17421,6.8,17858,217,44,-1330,378,21.7,1742.1,9,8,10,0,0,0,1,18751,7,17480,217,37,1330,-378,21.7,1875.1,red,1.89,2.38,24,28,red
4486168054,5,11,6,0,0,0,0,15696,6.6,16453,195,42,-2942,-1785,19.5,1569.6,11,5,14,0,0,0,0,18638,7,18238,212,47,2942,1785,21.2,1863.8,red,1,5,24,24,blue
4516176117,3,5,1,1,1,0,0,15577,6.8,17552,220,48,-546,-1470,22,1557.7,5,3,7,0,0,0,0,16123,7.2,19022,229,52,546,1470,22.9,1612.3,red,0.8,4,18,22,red
4449958772,8,9,10,1,0,1,0,17563,7,18068,190,55,268,789,19,1756.3,9,8,13,0,0,0,0,17295,6.6,17279,234,34,-268,-789,23.4,1729.5,blue,2,2.75,13,21,blue
4521375330,5,4,4,0,0,0,0,15387,6.6,16280,196,41,-501,-934,19.6,1538.7,4,5,3,0,0,0,0,15888,6.6,17214,210,46,501,934,21,1588.8,red,2.25,1.4,16,23,red
4523588763,2,7,2,0,0,0,0,14612,6.6,16340,242,43,-2541,-3552,24.2,1461.2,7,2,8,1,1,0,0,17153,7.4,19892,220,68,2541,3552,22,1715.3,red,0.57,7.5,17,42,blue
4464945993,8,7,8,2,1,1,0,17898,7.4,19411,232,58,942,1300,23.2,1789.8,7,8,6,0,0,0,0,16956,7,18111,245,43,-942,-1300,24.5,1695.6,red,2.29,1.62,16,18,blue
4522081916,9,9,11,1,1,0,0,18376,7.2,18388,238,46,653,462,23.8,1837.6,9,9,18,0,0,0,0,17723,7,17926,204,44,-653,-462,20.4,1772.3,blue,2.22,3,23,20,red
4441440280,8,4,6,0,0,0,0,17235,7,18992,214,52,2203,2404,21.4,1723.5,4,8,5,1,1,0,0,15032,6.6,16588,205,44,-2203,-2404,20.5,1503.2,red,3.5,1.12,37,14,red
4522688117,2,6,1,0,0,0,0,13736,6.2,16381,188,52,-3593,-2516,18.8,1373.6,6,2,7,2,1,1,0,17329,7,18897,227,68,3593,2516,22.7,1732.9,red,0.5,6.5,12,19,red
4523544390,10,7,10,0,0,0,0,16818,6.8,16676,183,42,283,165,18.3,1681.8,7,10,9,1,1,0,0,16535,6.6,16511,219,38,-283,-165,21.9,1653.5,red,2.86,1.6,76,14,blue
4454366358,14,8,15,0,0,0,1,19950,7,18520,212,26,3657,3286,21.2,1995,8,14,12,1,1,0,0,16293,6.2,15234,156,49,-3657,-3286,15.6,1629.3,blue,3.62,1.43,25,17,red
4483489256,8,4,5,0,0,0,0,16840,7,18528,209,51,793,461,20.9,1684,4,8,5,1,1,0,0,16047,7,18067,232,48,-793,-461,23.2,1604.7,red,3.25,1.12,18,21,red
4415032113,3,12,6,0,0,0,0,13961,6.2,14440,168,25,-4731,-2817,16.8,1396.1,12,3,21,0,0,0,0,18692,6.8,17257,206,42,4731,2817,20.6,1869.2,red,0.75,11,21,27,red
4520742612,4,8,6,2,1,1,0,15404,6.6,16706,203,49,-1332,-1998,20.3,1540.4,8,4,4,0,0,0,0,16736,7.2,18704,204,45,1332,1998,20.4,1673.6,red,1.25,3,43,23,blue
4523054835,5,4,4,1,1,0,0,15481,6.8,17409,191,65,-253,111,19.1,1548.1,4,5,2,0,0,0,0,15734,6.6,17298,234,55,253,-111,23.4,1573.4,blue,2.25,1.2,22,20,blue
4487385988,6,2,9,1,1,0,0,16751,7,18674,239,42,832,551,23.9,1675.1,2,6,2,0,0,0,0,15919,6.8,18123,225,69,-832,-551,22.5,1591.9,blue,7.5,0.67,58,19,red
4523430704,9,6,10,1,1,0,0,18447,7.4,20232,243,69,1745,1766,24.3,1844.7,6,9,7,0,0,0,0,16702,7.2,18466,240,47,-1745,-1766,24,1670.2,blue,3.17,1.44,17,16,blue
4489459707,7,7,8,0,0,0,0,16983,6.8,17858,227,51,-355,-560,22.7,1698.3,7,7,10,1,1,0,0,17338,7,18418,218,71,355,560,21.8,1733.8,blue,2.14,2.43,19,23,red
4511713193,2,6,2,1,1,0,0,14596,6.8,17298,204,81,-1883,-1131,20.4,1459.6,6,2,2,0,0,0,0,16479,6.8,18429,254,43,1883,1131,25.4,1647.9,red,0.67,4,17,18,red
4525047411,5,2,6,0,0,0,0,16622,7.2,19176,235,61,2061,1314,23.5,1662.2,2,5,0,0,0,0,0,14561,7,17862,219,67,-2061,-1314,21.9,1456.1,blue,5.5,0.4,20,22,blue
4489800281,6,8,7,0,0,0,0,16730,7,17780,208,49,-828,-1255,20.8,1673,8,6,7,0,0,0,0,17558,7.2,19035,233,60,828,1255,23.3,1755.8,blue,1.62,2.5,11,15,red
4459617456,8,4,9,0,0,0,0,18073,7.6,21032,239,44,2364,2384,23.9,1807.3,4,8,2,0,0,0,0,15709,7,18648,233,62,-2364,-2384,23.3,1570.9,red,4.25,0.75,46,16,blue
4455082508,9,4,9,1,0,1,0,18622,7,18509,230,44,2962,1156,23,1862.2,4,9,6,1,1,0,0,15660,6.8,17353,181,79,-2962,-1156,18.1,1566,blue,4.5,1.11,19,15,red
4481697328,9,4,2,2,1,1,0,16730,7,19072,198,68,178,424,19.8,1673,4,9,3,0,0,0,0,16552,7.2,18648,245,56,-178,-424,24.5,1655.2,red,2.75,0.78,25,31,blue
4524733068,7,10,8,0,0,0,0,15724,6.4,15533,163,40,-3798,-2337,16.3,1572.4,10,7,10,1,0,1,2,19522,7,17870,222,44,3798,2337,22.2,1952.2,blue,1.5,2.86,18,21,red
4467510471,5,10,7,0,0,0,0,16161,6.8,16954,213,53,-3761,-2475,21.3,1616.1,10,5,13,2,1,1,1,19922,7.2,19429,241,52,3761,2475,24.1,1992.2,red,1.2,4.6,15,19,red
4461499793,4,4,3,0,0,0,0,16175,6.8,17305,253,48,684,-474,25.3,1617.5,4,4,4,0,0,0,0,15491,7,17779,232,46,-684,474,23.2,1549.1,red,1.75,2,19,13,blue
4517495714,3,7,3,0,0,0,0,15355,6.6,17119,204,43,-2215,-2114,20.4,1535.5,7,3,8,2,1,1,0,17570,7.2,19233,240,65,2215,2114,24,1757,red,0.86,5,21,18,red
4513692486,10,4,13,0,0,0,0,18504,7,19016,206,55,3446,1559,20.6,1850.4,4,10,2,1,1,0,0,15058,6.8,17457,221,50,-3446,-1559,22.1,1505.8,blue,5.75,0.6,18,22,blue
4518395320,8,9,11,1,0,1,0,17147,6.8,17510,194,48,-1546,-1047,19.4,1714.7,9,8,12,1,1,0,0,18693,6.8,18557,244,55,1546,1047,24.4,1869.3,red,2.11,2.62,24,24,red
4507369591,1,2,1,2,1,1,1,16616,7,19052,253,68,1384,201,25.3,1661.6,2,1,4,0,0,0,0,15232,7.2,18851,241,61,-1384,-201,24.1,1523.2,blue,1,6,13,35,red
4523635289,7,2,6,1,1,0,0,15471,7.4,19583,206,56,708,1840,20.6,1547.1,2,7,2,0,0,0,0,14763,7,17743,228,67,-708,-1840,22.8,1476.3,blue,6.5,0.57,10,15,blue
4515501077,7,9,6,0,0,0,0,17075,7.2,18691,230,52,-1075,-1160,23,1707.5,9,7,10,1,1,0,0,18150,7.2,19851,232,74,1075,1160,23.2,1815,red,1.44,2.71,16,13,blue
4467214068,2,10,2,1,0,1,0,14519,6.8,17122,223,40,-3798,-2950,22.3,1451.9,10,2,13,1,1,0,0,18317,7.4,20072,226,64,3798,2950,22.6,1831.7,red,0.4,11.5,98,50,red
4509867417,8,4,14,1,1,0,0,18664,7.4,20054,233,63,3326,3001,23.3,1866.4,4,8,2,0,0,0,0,15338,6.6,17053,215,56,-3326,-3001,21.5,1533.8,blue,5.5,0.75,40,18,blue
4452432602,5,6,4,0,0,0,0,14768,6.6,17244,157,64,-2337,-1158,15.7,1476.8,6,5,6,1,1,0,0,17105,7.2,18402,217,56,2337,1158,21.7,1710.5,red,1.5,2.4,20,20,red
4455468976,4,7,3,1,1,0,0,15859,7,18955,250,62,-898,-655,25,1585.9,7,4,9,0,0,0,0,16757,7,19610,193,59,898,655,19.3,1675.7,blue,1,4,20,22,blue
4464899636,12,8,10,0,0,0,0,19432,7.4,19488,232,38,2939,1636,23.2,1943.2,8,12,8,0,0,0,0,16493,6.8,17852,203,36,-2939,-1636,20.3,1649.3,red,2.75,1.33,23,18,red
4498068359,3,7,2,0,0,0,0,15412,6.8,17502,211,45,-3768,-2111,21.1,1541.2,7,3,9,2,1,1,1,19180,7.4,19613,246,64,3768,2111,24.6,1918,blue,0.71,5.33,15,19,red
4445596529,4,6,3,0,0,0,0,15306,6.8,17560,220,52,-1171,-11,22,1530.6,6,4,5,0,0,0,0,16477,6.8,17571,211,43,1171,11,21.1,1647.7,red,1.17,2.75,38,20,red
4522667273,5,10,4,0,0,0,0,16377,7,17958,228,45,-2167,-1447,22.8,1637.7,10,5,12,1,0,1,0,18544,7.2,19405,216,65,2167,1447,21.6,1854.4,red,0.9,4.4,16,15,red
4494477882,8,6,8,1,1,0,0,16563,7.2,18469,199,46,498,244,19.9,1656.3,6,8,2,0,0,0,0,16065,7,18225,209,41,-498,-244,20.9,1606.5,blue,2.67,1,20,16,blue
4518601095,10,4,11,1,0,1,0,18879,7.2,19552,222,68,4513,3883,22.2,1887.9,4,10,3,0,0,0,0,14366,6.4,15669,195,39,-4513,-3883,19.5,1436.6,blue,5.25,0.7,25,18,blue
4522111374,5,12,6,0,0,0,0,14656,6.4,15475,186,36,-4201,-4782,18.6,1465.6,12,5,11,1,1,0,0,18857,7.4,20257,216,44,4201,4782,21.6,1885.7,red,0.92,4.6,22,25,blue
4513214644,1,8,1,0,0,0,0,13129,6.6,16126,184,43,-4800,-1308,18.4,1312.9,8,1,10,0,0,0,0,17929,7,17434,218,48,4800,1308,21.8,1792.9,red,0.25,18,17,21,red
4494829301,5,2,10,2,1,1,0,16256,7,17985,218,61,2050,1834,21.8,1625.6,2,5,3,0,0,0,0,14206,6.4,16151,217,45,-2050,-1834,21.7,1420.6,blue,7.5,1,22,26,red
4525014650,3,4,4,0,0,0,0,15179,6.8,17410,237,53,-657,-81,23.7,1517.9,4,3,4,2,1,1,0,15836,7,17491,237,52,657,81,23.7,1583.6,red,1.75,2.67,20,66,red
4474762590,6,3,5,0,0,0,0,17384,7,18045,241,45,2245,304,24.1,1738.4,3,6,3,1,1,0,0,15139,6.8,17741,223,57,-2245,-304,22.3,1513.9,blue,3.67,1,20,19,blue
4524613194,12,3,16,1,1,0,0,18280,7.4,19206,209,43,4254,3059,20.9,1828,3,12,4,0,0,0,0,14026,6.6,16147,204,44,-4254,-3059,20.4,1402.6,blue,9.33,0.58,14,18,blue
4524942450,9,7,8,1,0,1,1,18253,7.2,19481,203,45,1156,1711,20.3,1825.3,7,9,7,0,0,0,0,17097,7,17770,221,38,-1156,-1711,22.1,1709.7,red,2.43,1.56,16,16,blue
4524496142,1,2,1,1,1,0,0,14722,7.2,18209,254,64,-455,-1,25.4,1472.2,2,1,0,1,0,1,0,15177,7.2,18210,263,46,455,1,26.3,1517.7,red,1,2,16,14,red
4511256473,8,7,9,0,0,0,0,18593,7.4,20037,252,66,2277,1630,25.2,1859.3,7,8,9,1,1,0,0,16316,7.2,18407,203,56,-2277,-1630,20.3,1631.6,blue,2.43,2,17,14,red
4520896282,8,7,9,1,1,0,0,17345,7,18944,236,52,928,-128,23.6,1734.5,7,8,7,0,0,0,0,16417,7.2,19072,198,64,-928,128,19.8,1641.7,blue,2.43,1.75,36,19,blue
4507095951,9,2,11,1,1,0,0,18804,7.2,19826,272,51,4607,2975,27.2,1880.4,2,9,2,0,0,0,0,14197,6.6,16851,197,52,-4607,-2975,19.7,1419.7,red,10,0.44,14,13,blue
4523319289,3,5,5,1,1,0,0,15597,7.2,18348,249,55,200,532,24.9,1559.7,5,3,2,0,0,0,0,15397,7,17816,203,60,-200,-532,20.3,1539.7,blue,1.6,2.33,15,11,red
4523556963,7,5,10,1,1,0,0,16460,7,17623,220,52,1068,-736,22,1646,5,7,5,0,0,0,0,15392,6.8,18359,209,57,-1068,736,20.9,1539.2,blue,3.4,1.43,24,18,blue
4477722097,3,1,4,1,0,1,0,16156,7,18605,233,61,1639,1308,23.3,1615.6,1,3,3,1,1,0,0,14517,7,17297,241,40,-1639,-1308,24.1,1451.7,red,7,1.33,15,18,blue
4451375141,7,3,8,1,0,1,0,16463,6.8,17675,223,44,1305,1032,22.3,1646.3,3,7,3,0,0,0,0,15158,6.6,16643,244,48,-1305,-1032,24.4,1515.8,blue,5,0.86,47,20,red
4441428673,7,5,5,1,1,0,0,17541,7.2,19979,232,57,1764,2586,23.2,1754.1,5,7,7,0,0,0,0,15777,6.8,17393,208,49,-1764,-2586,20.8,1577.7,blue,2.4,1.71,17,18,blue
4518734421,5,10,6,1,0,1,0,15020,6.6,16196,182,52,-2620,-1037,18.2,1502,10,5,11,1,1,0,0,17640,6.8,17233,197,51,2620,1037,19.7,1764,red,1.1,4.2,23,49,red
4524583586,4,6,2,0,0,0,0,14687,6.6,16647,216,32,-2142,-1742,21.6,1468.7,6,4,5,1,1,0,0,16829,6.8,18389,223,75,2142,1742,22.3,1682.9,blue,1,2.75,14,18,red
4475129478,4,6,6,0,0,0,0,15502,6.8,16609,227,42,-938,-729,22.7,1550.2,6,4,5,1,1,0,0,16440,6.8,17338,239,47,938,729,23.9,1644,red,1.67,2.75,21,19,red
4470213868,6,2,1,0,0,0,0,17413,7.2,19603,257,66,2646,2305,25.7,1741.3,2,6,2,1,1,0,0,14767,6.6,17298,210,58,-2646,-2305,21,1476.7,blue,3.5,0.67,21,74,blue
4495019552,3,4,5,1,1,0,0,16001,7.2,18372,265,56,-54,616,26.5,1600.1,4,3,6,0,0,0,0,16055,6.6,17756,223,54,54,-616,22.3,1605.5,red,2,3.33,21,23,red
4516351338,4,7,2,1,0,1,1,17040,7.2,18774,228,76,293,718,22.8,1704,7,4,7,1,1,0,0,16747,6.8,18056,204,56,-293,-718,20.4,1674.7,red,0.86,3.5,30,16,red
4523865628,4,7,5,1,1,0,0,15920,6.6,17523,234,57,-1138,-1025,23.4,1592,7,4,8,0,0,0,0,17058,7,18548,237,41,1138,1025,23.7,1705.8,red,1.29,3.75,47,56,blue
4521894738,9,8,11,2,1,1,0,17408,7,17809,207,48,360,97,20.7,1740.8,8,9,12,0,0,0,0,17048,7,17712,191,47,-360,-97,19.1,1704.8,blue,2.5,2.22,24,46,red
4515724067,5,7,5,0,0,0,0,16394,7,18234,251,42,-127,515,25.1,1639.4,7,5,12,1,1,0,0,16521,7,17719,194,60,127,-515,19.4,1652.1,red,1.43,3.8,17,33,red
4518804913,2,5,0,0,0,0,0,13408,6.4,16175,192,31,-3160,-3099,19.2,1340.8,5,2,6,1,1,0,0,16568,7.2,19274,224,76,3160,3099,22.4,1656.8,red,0.4,5.5,15,17,blue
4517985377,8,9,7,0,0,0,0,17697,6.8,16356,208,41,118,-2044,20.8,1769.7,9,8,5,1,1,0,0,17579,7.2,18400,200,59,-118,2044,20,1757.9,blue,1.67,1.75,16,16,blue
4516590665,5,12,4,1,1,0,0,15708,7,17799,219,59,-3205,-2487,21.9,1570.8,12,5,8,1,0,1,1,18913,7.4,20286,231,47,3205,2487,23.1,1891.3,blue,0.75,4,10,18,red
4459022414,11,11,12,0,0,0,0,18409,7,17925,219,36,-206,290,21.9,1840.9,11,11,12,0,0,0,0,18615,7,17635,174,55,206,-290,17.4,1861.5,blue,2.09,2.09,15,18,red
4499681914,1,13,1,0,0,0,0,12622,5.8,13759,185,32,-6954,-5631,18.5,1262.2,13,1,16,2,1,1,0,19576,7.4,19390,228,44,6954,5631,22.8,1957.6,red,0.15,29,16,21,blue
4523717374,9,3,9,0,0,0,0,17503,7.2,18043,204,59,2471,827,20.4,1750.3,3,9,4,1,1,0,0,15032,6.8,17216,212,51,-2471,-827,21.2,1503.2,blue,6,0.78,19,42,blue
4503795353,7,8,7,1,0,1,0,16936,7,18077,236,43,-96,827,23.6,1693.6,8,7,8,1,1,0,0,17032,6.8,17250,211,52,96,-827,21.1,1703.2,blue,1.75,2.29,22,25,red
4479934294,3,5,3,0,0,0,0,14622,7.2,18174,206,62,-1567,-713,20.6,1462.2,5,3,3,1,1,0,0,16189,7.2,18887,237,52,1567,713,23.7,1618.9,red,1.2,2.67,14,18,red
4518016212,6,6,3,0,0,0,0,16266,7,17825,213,51,920,1098,21.3,1626.6,6,6,4,0,0,0,0,15346,6.6,16727,210,40,-920,-1098,21,1534.6,blue,1.5,1.67,19,19,red
4521431219,3,4,9,1,1,0,0,15240,6.8,17456,243,45,-1279,-1122,24.3,1524,4,3,6,0,0,0,0,16519,7.2,18578,244,64,1279,1122,24.4,1651.9,red,3,3.33,23,19,red
4518409381,5,7,3,1,0,1,0,16911,7.2,18891,247,52,681,2047,24.7,1691.1,7,5,10,1,1,0,0,16230,6.8,16844,196,38,-681,-2047,19.6,1623,blue,1.14,3.4,19,16,red
4521225915,1,9,1,1,0,1,0,14055,6.8,17109,204,48,-3872,-3173,20.4,1405.5,9,1,9,0,0,0,0,17927,7.6,20282,214,48,3872,3173,21.4,1792.7,red,0.22,18,16,22,red
4446116098,7,5,5,2,1,1,0,17227,7.6,20568,218,56,1329,1625,21.8,1722.7,5,7,3,0,0,0,0,15898,7,18943,207,73,-1329,-1625,20.7,1589.8,blue,2.4,1.14,18,17,blue
4518127728,4,8,3,0,0,0,0,15525,6.6,16079,198,60,-1784,-2938,19.8,1552.5,8,4,7,0,0,0,0,17309,7,19017,227,48,1784,2938,22.7,1730.9,red,0.88,3.75,16,37,blue
4495179602,2,12,4,0,0,0,0,14199,6.4,16214,167,55,-7911,-3435,16.7,1419.9,12,2,17,1,1,0,2,22110,7.2,19649,223,48,7911,3435,22.3,2211,red,0.5,14.5,14,16,red
4520400316,5,4,6,1,1,0,0,16610,7,17963,263,40,828,-804,26.3,1661,4,5,3,0,0,0,0,15782,7.2,18767,243,64,-828,804,24.3,1578.2,blue,2.75,1.4,20,105,red
4524014762,1,6,2,0,0,0,0,14307,6.4,16295,211,44,-3418,-3733,21.1,1430.7,6,1,5,2,1,1,0,17725,7.4,20028,234,72,3418,3733,23.4,1772.5,red,0.5,11,23,20,red
4482132906,9,3,7,0,0,0,0,16646,7,18209,236,32,2522,2156,23.6,1664.6,3,9,3,1,1,0,0,14124,6.6,16053,210,43,-2522,-2156,21,1412.4,blue,5.33,0.67,22,26,blue
4520518114,4,10,8,1,0,1,0,15316,6.4,17001,215,52,-2882,-1423,21.5,1531.6,10,4,14,1,1,0,0,18198,6.8,18424,218,44,2882,1423,21.8,1819.8,red,1.2,6,18,20,red
4511949314,4,8,5,0,0,0,0,14834,6.6,16539,191,52,-2714,-427,19.1,1483.4,8,4,11,1,0,1,0,17548,6.8,16966,198,51,2714,427,19.8,1754.8,blue,1.12,4.75,6,18,red
4508820253,6,4,2,1,1,0,0,16027,7,18775,231,52,276,-106,23.1,1602.7,4,6,4,0,0,0,0,15751,7.2,18881,239,56,-276,106,23.9,1575.1,blue,2,1.33,19,13,blue
4456615224,3,5,2,0,0,0,0,15631,7.2,18436,252,53,-704,-1028,25.2,1563.1,5,3,4,1,1,0,0,16335,7.4,19464,229,72,704,1028,22.9,1633.5,red,1,3,19,17,red
4422263673,4,9,4,1,1,0,0,15114,6.8,16890,193,56,-1210,-2064,19.3,1511.4,9,4,4,0,0,0,0,16324,7.2,18954,213,52,1210,2064,21.3,1632.4,red,0.89,3.25,14,20,blue
4520495529,6,3,5,2,1,1,0,16929,7.4,19425,263,54,1101,1147,26.3,1692.9,3,6,3,0,0,0,0,15828,7.2,18278,242,49,-1101,-1147,24.2,1582.8,blue,3.67,1,20,84,blue
4517796937,10,9,12,1,1,0,0,17828,7,18635,184,59,371,514,18.4,1782.8,9,10,9,1,0,1,0,17457,7,18121,219,35,-371,-514,21.9,1745.7,blue,2.44,1.8,20,18,blue
4521686224,2,6,1,0,0,0,0,14062,6.8,17156,219,44,-2226,-2642,21.9,1406.2,6,2,2,2,1,1,0,16288,7.4,19798,238,59,2226,2642,23.8,1628.8,red,0.5,4,147,19,red
4520004131,5,5,4,1,1,0,0,15885,6.6,16411,213,54,-508,-1263,21.3,1588.5,5,5,5,0,0,0,0,16393,7,17674,235,46,508,1263,23.5,1639.3,blue,1.8,2,18,36,blue
4523884002,1,7,2,0,0,0,0,13976,6.6,16595,211,48,-2971,-1923,21.1,1397.6,7,1,7,1,1,0,0,16947,7.2,18518,231,59,2971,1923,23.1,1694.7,red,0.43,14,17,139,red
4524469798,8,6,14,0,0,0,0,16898,7.2,18746,213,48,734,1966,21.3,1689.8,6,8,9,0,0,0,0,16164,6.4,16780,209,44,-734,-1966,20.9,1616.4,blue,3.67,1.88,49,14,red
4522236632,5,7,3,1,1,0,0,16535,7.2,19103,206,80,956,2176,20.6,1653.5,7,5,5,0,0,0,0,15579,6.6,16927,197,48,-956,-2176,19.7,1557.9,blue,1.14,2.4,21,22,red
4523047693,7,3,9,0,0,0,0,16847,7,17476,223,48,1840,-279,22.3,1684.7,3,7,1,1,1,0,0,15007,6.8,17755,224,51,-1840,279,22.4,1500.7,red,5.33,0.57,22,41,blue
4511021907,4,8,4,0,0,0,0,15937,7.2,18739,219,50,-2138,-990,21.9,1593.7,8,4,13,1,1,0,0,18075,7.2,19729,254,52,2138,990,25.4,1807.5,red,1,5.25,43,19,red
4451654412,1,12,1,0,0,0,0,13453,6.4,15565,215,40,-5403,-4604,21.5,1345.3,12,1,17,1,1,0,0,18856,7.4,20169,232,50,5403,4604,23.2,1885.6,red,0.17,29,18,25,red
4511234219,4,9,8,0,0,0,0,17071,6.8,17610,205,48,-1763,-2184,20.5,1707.1,9,4,10,1,1,0,0,18834,7.4,19794,236,56,1763,2184,23.6,1883.4,red,1.33,4.75,14,15,red
4523608047,4,7,2,0,0,0,0,16224,7,18247,212,64,-294,321,21.2,1622.4,7,4,5,0,0,0,0,16518,7,17926,205,40,294,-321,20.5,1651.8,red,0.86,3,17,17,red
4520980725,16,7,26,1,1,0,0,19776,7,17806,191,46,2806,-579,19.1,1977.6,7,16,11,0,0,0,0,16970,7.2,18385,197,58,-2806,579,19.7,1697,blue,6,1.12,16,14,blue
4525247260,9,1,13,1,1,0,0,17461,7.2,18412,235,48,3119,896,23.5,1746.1,1,9,1,1,0,1,0,14342,7,17516,228,56,-3119,-896,22.8,1434.2,blue,22,0.22,27,46,blue
4493967269,8,7,9,0,0,0,0,16355,7,17876,193,44,-495,934,19.3,1635.5,7,8,7,1,1,0,0,16850,6.6,16942,191,60,495,-934,19.1,1685,red,2.43,1.75,58,18,red
4523611140,7,2,7,2,1,1,0,17325,7.6,20228,238,71,2905,2774,23.8,1732.5,2,7,3,0,0,0,0,14420,6.6,17454,222,52,-2905,-2774,22.2,1442,blue,7,0.71,16,15,blue
4498878998,5,8,9,0,0,0,0,16391,6.8,17744,228,68,-842,-711,22.8,1639.1,8,5,9,1,1,0,0,17233,7,18455,239,44,842,711,23.9,1723.3,blue,1.75,3.4,18,23,blue
4524164148,4,4,5,1,0,1,1,16938,7,18241,213,52,1881,635,21.3,1693.8,4,4,5,0,0,0,0,15057,6.8,17606,224,47,-1881,-635,22.4,1505.7,blue,2.25,2.25,18,61,blue
4524951656,4,15,5,0,0,0,0,15316,6.6,15976,184,44,-2883,-3312,18.4,1531.6,15,4,15,1,1,0,0,18199,7.2,19288,194,48,2883,3312,19.4,1819.9,red,0.6,7.5,16,21,red
4519000412,1,7,0,0,0,0,0,12300,6,14201,171,30,-5394,-5037,17.1,1230,7,1,8,2,1,1,0,17694,7.2,19238,246,54,5394,5037,24.6,1769.4,red,0.14,15,42,34,red
4519887278,4,11,5,1,0,1,0,15373,6.6,16348,217,47,-4432,-3639,21.7,1537.3,11,4,16,1,1,0,0,19805,7.4,19987,226,80,4432,3639,22.6,1980.5,red,0.82,6.75,77,16,red
4516971846,1,3,2,0,0,0,0,15196,6.8,17168,262,40,52,-934,26.2,1519.6,3,1,2,1,0,1,0,15144,7,18102,246,47,-52,934,24.6,1514.4,red,1,5,19,18,red
4423842693,7,6,7,1,0,1,0,17184,6.6,16943,206,43,1835,393,20.6,1718.4,6,7,5,1,1,0,0,15349,6.6,16550,217,47,-1835,-393,21.7,1534.9,blue,2.33,1.57,24,18,red
4494910229,4,6,8,0,0,0,0,16135,6.6,16458,213,52,173,461,21.3,1613.5,6,4,11,1,1,0,0,15962,6.4,15997,196,52,-173,-461,19.6,1596.2,blue,2,4.25,15,18,blue
4494910651,2,5,1,0,0,0,0,14658,6.6,16832,210,47,-1957,422,21,1465.8,5,2,7,1,1,0,1,16615,6.6,16410,209,39,1957,-422,20.9,1661.5,red,0.6,6,19,25,red
4436906182,4,6,5,0,0,0,0,15420,6.8,16822,235,41,-1633,-2918,23.5,1542,6,4,5,1,0,1,0,17053,7.4,19740,253,52,1633,2918,25.3,1705.3,blue,1.5,2.75,14,19,blue
4523647103,9,6,8,0,0,0,0,18130,7.2,19442,220,53,2635,2531,22,1813,6,9,4,0,0,0,0,15495,6.6,16911,195,32,-2635,-2531,19.5,1549.5,blue,2.83,1.11,17,12,blue
4492589905,1,3,1,1,1,0,0,15119,6.8,18281,249,64,-326,-294,24.9,1511.9,3,1,3,1,0,1,0,15445,7.4,18575,228,53,326,294,22.8,1544.5,blue,0.67,6,50,13,red
4524762045,9,1,10,1,1,0,0,17101,7,18332,207,42,3157,1899,20.7,1710.1,1,9,0,0,0,0,0,13944,6.4,16433,239,35,-3157,-1899,23.9,1394.4,blue,19,0.11,33,21,blue
4500567604,5,4,4,0,0,0,0,15832,7,17807,225,40,-386,-775,22.5,1583.2,4,5,4,0,0,0,0,16218,7,18582,244,66,386,775,24.4,1621.8,blue,2.25,1.6,21,19,blue
4495292630,3,7,4,1,0,1,0,15088,6.6,16413,209,44,-1685,-2902,20.9,1508.8,7,3,6,0,0,0,0,16773,7.4,19315,235,55,1685,2902,23.5,1677.3,blue,1,4.33,17,23,blue
4502360734,3,3,3,0,0,0,0,16213,7.2,18235,247,60,1962,730,24.7,1621.3,3,3,6,1,0,1,0,14251,6.8,17505,212,39,-1962,-730,21.2,1425.1,blue,2,3,16,18,blue
4511778720,8,2,10,1,0,1,0,17300,7,19249,223,44,2298,1572,22.3,1730,2,8,0,1,1,0,0,15002,7,17677,248,64,-2298,-1572,24.8,1500.2,blue,9,0.25,17,14,blue
4521806282,8,6,4,0,0,0,0,16818,7,18842,213,52,588,1104,21.3,1681.8,6,8,7,1,1,0,0,16230,7,17738,232,45,-588,-1104,23.2,1623,blue,2,1.62,16,12,blue
4423897951,9,13,13,0,0,0,0,17163,6.6,17099,190,31,-2880,-2174,19,1716.3,13,9,11,0,0,0,0,20043,7,19273,213,48,2880,2174,21.3,2004.3,red,1.69,2.67,24,19,blue
4485735117,4,5,4,1,0,1,0,15522,7,18317,214,63,-1071,-120,21.4,1552.2,5,4,7,1,1,0,0,16593,7.2,18437,246,64,1071,120,24.6,1659.3,blue,1.6,3,25,40,red
4518381780,8,10,10,1,1,0,0,16991,7,17910,205,44,-1001,-825,20.5,1699.1,10,8,6,0,0,0,0,17992,7.2,18735,225,52,1001,825,22.5,1799.2,red,1.8,2,15,18,red
4467510669,9,7,10,0,0,0,0,17556,7,18073,220,41,1253,-235,22,1755.6,7,9,4,0,0,0,0,16303,7,18308,191,68,-1253,235,19.1,1630.3,blue,2.71,1.22,23,23,blue
4519411417,9,6,12,0,0,0,0,17359,7.2,18731,225,34,887,346,22.5,1735.9,6,9,2,0,0,0,0,16472,6.8,18385,237,54,-887,-346,23.7,1647.2,blue,3.5,0.89,15,15,red
4480113908,12,11,10,0,0,0,0,18849,7.2,18593,216,42,702,4,21.6,1884.9,11,12,12,1,1,0,0,18147,7,18589,182,54,-702,-4,18.2,1814.7,red,2,1.92,20,22,blue
4500843362,4,6,6,0,0,0,0,15260,6.8,17024,201,32,-1443,-1629,20.1,1526,6,4,9,1,1,0,0,16703,7.4,18653,212,74,1443,1629,21.2,1670.3,blue,1.67,3.75,17,18,blue
4473499451,9,4,10,0,0,0,0,18307,7.2,19026,244,49,3113,2284,24.4,1830.7,4,9,3,1,1,0,0,15194,6.4,16742,213,48,-3113,-2284,21.3,1519.4,blue,4.75,0.78,23,22,blue
4521425528,7,11,9,1,1,0,0,15363,6.2,15411,171,52,-2151,-852,17.1,1536.3,11,7,9,0,0,0,0,17514,6.4,16263,199,43,2151,852,19.9,1751.4,red,1.45,2.86,18,17,blue
4496874595,7,9,8,0,0,0,0,17543,7.2,19187,236,47,204,-344,23.6,1754.3,9,7,7,1,1,0,0,17339,7.2,19531,237,43,-204,344,23.7,1733.9,red,1.67,2.29,16,17,blue
4513961751,10,9,14,1,1,0,0,18513,7,17991,213,60,710,288,21.3,1851.3,9,10,13,0,0,0,0,17803,6.8,17703,191,56,-710,-288,19.1,1780.3,blue,2.67,2.2,18,18,blue
4522165708,6,8,5,0,0,0,0,15913,6.8,16789,197,45,-483,320,19.7,1591.3,8,6,7,1,0,1,0,16396,6.6,16469,187,44,483,-320,18.7,1639.6,blue,1.38,2.5,16,18,blue
4491875550,7,5,4,1,1,0,0,16605,7,18407,199,61,-643,508,19.9,1660.5,5,7,5,1,0,1,1,17248,6.8,17899,241,46,643,-508,24.1,1724.8,blue,2.2,1.43,39,20,blue
4484202085,9,9,13,1,1,0,0,17641,6.8,16803,199,38,436,338,19.9,1764.1,9,9,11,0,0,0,0,17205,6.4,16465,207,33,-436,-338,20.7,1720.5,red,2.44,2.22,44,23,blue
4477061244,9,5,8,0,0,0,0,18564,7.2,19783,212,60,2005,2005,21.2,1856.4,5,9,7,0,0,0,0,16559,7.2,17778,236,44,-2005,-2005,23.6,1655.9,blue,3.4,1.33,15,13,blue
4509467207,4,4,3,0,0,0,0,15588,6.8,17603,225,51,192,88,22.5,1558.8,4,4,7,2,1,1,0,15396,6.6,17515,241,46,-192,-88,24.1,1539.6,blue,1.75,2.75,21,49,red
4463147006,4,5,3,1,1,0,0,14722,6.4,16664,187,40,-675,-2016,18.7,1472.2,5,4,5,0,0,0,0,15397,7.2,18680,185,52,675,2016,18.5,1539.7,blue,1.4,2.5,19,78,red
4448381986,7,7,10,0,0,0,0,16531,6.6,16364,202,44,-869,327,20.2,1653.1,7,7,9,1,1,0,1,17400,6.6,16037,219,48,869,-327,21.9,1740,red,2.43,2.29,21,31,red
4520650822,3,3,3,1,1,0,0,15471,7,17472,233,56,-390,-502,23.3,1547.1,3,3,5,1,0,1,0,15861,6.8,17974,240,47,390,502,24,1586.1,red,2,2.67,19,23,blue
4512033848,7,5,7,1,0,1,0,17271,7,18144,246,51,2369,2245,24.6,1727.1,5,7,4,1,1,0,0,14902,6.4,15899,190,56,-2369,-2245,19,1490.2,blue,2.8,1.29,20,24,blue
4523404428,8,2,8,1,1,0,0,17351,7.2,19306,235,55,3251,2936,23.5,1735.1,2,8,1,1,0,1,0,14100,6.6,16370,213,44,-3251,-2936,21.3,1410,blue,8,0.38,20,17,red
4468160343,2,6,2,1,0,1,0,14869,6.8,17895,238,41,-1642,-703,23.8,1486.9,6,2,8,1,1,0,0,16511,7.2,18598,224,59,1642,703,22.4,1651.1,red,0.67,7,23,18,red
4517237029,6,9,5,0,0,0,0,16534,7,17934,231,52,-1256,-844,23.1,1653.4,9,6,9,1,0,1,0,17790,7.2,18778,235,32,1256,844,23.5,1779,red,1.22,3,24,20,blue
4423066417,6,10,4,1,0,1,0,16226,7.2,18754,221,46,-1613,474,22.1,1622.6,10,6,11,1,1,0,0,17839,7,18280,215,46,1613,-474,21.5,1783.9,blue,1,3.5,12,16,red
4458628043,6,3,6,1,1,0,0,16847,7.4,19065,220,67,2341,2303,22,1684.7,3,6,3,0,0,0,0,14506,6.6,16762,214,38,-2341,-2303,21.4,1450.6,blue,4,1,18,18,blue
4492021851,8,11,9,0,0,0,0,16583,6.4,17229,198,44,-1635,-2200,19.8,1658.3,11,8,7,1,1,0,0,18218,7.2,19429,211,60,1635,2200,21.1,1821.8,blue,1.55,2.25,15,14,red
4467412400,1,3,1,0,0,0,0,15573,7,18440,246,70,66,319,24.6,1557.3,3,1,6,2,1,1,0,15507,7,18121,233,57,-66,-319,23.3,1550.7,red,0.67,9,18,134,blue
4519181878,10,9,6,0,0,0,0,17770,7.4,19036,239,47,995,2657,23.9,1777,9,10,8,0,0,0,0,16775,6.6,16379,155,52,-995,-2657,15.5,1677.5,blue,1.78,1.7,19,19,blue
4525006118,4,3,4,0,0,0,0,15850,7.2,18831,233,51,1207,1885,23.3,1585,3,4,4,1,1,0,0,14643,6.6,16946,229,48,-1207,-1885,22.9,1464.3,red,2.67,1.75,22,19,red
4464700538,1,4,1,0,0,0,0,13756,6.6,16900,238,36,-3750,-3108,23.8,1375.6,4,1,3,2,1,1,1,17506,7.2,20008,244,64,3750,3108,24.4,1750.6,blue,0.5,7,17,43,red
4442297652,5,9,5,0,0,0,0,15192,6.6,16557,198,44,-3240,-2369,19.8,1519.2,9,5,18,0,0,0,0,18432,7.2,18926,252,52,3240,2369,25.2,1843.2,red,1.11,5.4,15,24,red
4449732140,9,4,11,1,0,1,0,17611,7.2,18414,223,58,1706,1239,22.3,1761.1,4,9,6,1,1,0,0,15905,6.8,17175,233,41,-1706,-1239,23.3,1590.5,blue,5,1.11,18,16,blue
4523370740,4,6,3,0,0,0,0,14796,6.6,17144,209,50,-2183,-1025,20.9,1479.6,6,4,5,1,1,0,0,16979,6.8,18169,236,56,2183,1025,23.6,1697.9,blue,1.17,2.75,15,19,red
4523422751,8,0,8,2,1,1,0,18519,7.2,20004,235,52,5222,3469,23.5,1851.9,0,8,0,0,0,0,0,13297,6.6,16535,187,68,-5222,-3469,18.7,1329.7,blue,12.03,0,17,10,blue
4512135752,4,2,3,0,0,0,0,15750,7,18310,233,52,755,-289,23.3,1575,2,4,2,1,1,0,0,14995,7,18599,248,57,-755,289,24.8,1499.5,blue,3.5,1,17,18,red
4524590914,7,11,4,0,0,0,0,15967,6.8,17259,205,47,-2068,36,20.5,1596.7,11,7,12,0,0,0,0,18035,6.8,17223,210,28,2068,-36,21,1803.5,red,1,3.29,18,27,red
4492859847,6,7,6,0,0,0,0,16777,7,18587,212,55,295,857,21.2,1677.7,7,6,7,1,1,0,0,16482,7,17730,218,40,-295,-857,21.8,1648.2,red,1.71,2.33,17,28,blue
4432528181,8,5,11,0,0,0,0,17145,7,17795,204,70,2563,1726,20.4,1714.5,5,8,5,1,1,0,0,14582,6.6,16069,181,36,-2563,-1726,18.1,1458.2,blue,3.8,1.25,16,16,blue
4511606609,7,7,4,0,0,0,0,17309,7.2,19092,253,48,763,1025,25.3,1730.9,7,7,9,1,1,0,0,16546,7,18067,217,48,-763,-1025,21.7,1654.6,blue,1.57,2.29,33,18,blue
4517186404,10,9,9,1,1,0,0,19219,7,18673,229,50,2346,1776,22.9,1921.9,9,10,10,0,0,0,0,16873,6.8,16897,177,35,-2346,-1776,17.7,1687.3,blue,2.11,1.9,18,9,blue
4523069290,6,5,3,0,0,0,0,16164,7,18306,226,63,113,-518,22.6,1616.4,5,6,9,1,1,0,0,16051,7.4,18824,223,52,-113,518,22.3,1605.1,blue,1.8,2.33,26,18,blue
4437610399,7,7,9,1,1,0,0,17220,7.2,18678,202,64,135,794,20.2,1722,7,7,6,0,0,0,0,17085,6.8,17884,228,52,-135,-794,22.8,1708.5,red,2.29,1.86,54,17,red
4443355005,5,5,4,2,1,1,0,14527,6.8,17128,195,45,-1063,63,19.5,1452.7,5,5,4,0,0,0,0,15590,6.8,17065,217,48,1063,-63,21.7,1559,blue,1.8,1.8,42,18,blue
4491275026,2,3,2,1,0,1,0,14355,6.8,17580,217,51,59,1149,21.7,1435.5,3,2,6,1,1,0,0,14296,6.6,16431,205,39,-59,-1149,20.5,1429.6,red,1.33,4.5,19,20,red
4525087986,10,3,11,1,0,1,0,18672,7.2,19616,243,44,3579,2473,24.3,1867.2,3,10,2,1,1,0,0,15093,6.8,17143,212,72,-3579,-2473,21.2,1509.3,blue,7,0.5,26,20,blue
4524444788,5,6,4,0,0,0,0,16481,7.2,18268,221,53,563,-1127,22.1,1648.1,6,5,4,1,1,0,0,15918,7.2,19395,217,52,-563,1127,21.7,1591.8,blue,1.5,2,15,16,blue
4483466671,7,6,10,0,0,0,1,18376,7,17877,225,48,2595,776,22.5,1837.6,6,7,4,2,1,1,0,15781,6.6,17101,201,59,-2595,-776,20.1,1578.1,red,2.83,1.43,24,37,red
4497898410,2,12,3,0,0,0,0,13899,6.4,15844,195,38,-6134,-6414,19.5,1389.9,12,2,9,1,1,0,0,20033,8.2,22258,236,83,6134,6414,23.6,2003.3,red,0.42,10.5,47,30,red
4519814636,5,5,7,1,1,0,0,16345,7,17851,230,46,1284,-1614,23,1634.5,5,5,3,1,0,1,0,15061,7.2,19465,200,43,-1284,1614,20,1506.1,blue,2.4,1.6,22,19,blue
4446530367,7,5,14,1,1,0,0,17964,7.2,18073,216,55,4042,4968,21.6,1796.4,5,7,4,0,0,0,0,13922,5.4,13105,172,4,-4042,-4968,17.2,1392.2,blue,4.2,1.29,96,13,blue
4522433326,1,1,0,0,0,0,0,14591,6.8,17823,230,66,-817,-1289,23,1459.1,1,1,0,1,1,0,0,15408,7,19112,253,76,817,1289,25.3,1540.8,red,1,1,10,14,red
4460577454,4,4,5,2,1,1,0,16486,7.2,18617,256,60,1118,871,25.6,1648.6,4,4,6,0,0,0,0,15368,6.8,17746,224,43,-1118,-871,22.4,1536.8,blue,2.25,2.5,24,24,red
4467040856,6,2,4,0,0,0,0,16636,7.2,18741,225,40,1833,899,22.5,1663.6,2,6,3,1,1,0,0,14803,6.8,17842,201,63,-1833,-899,20.1,1480.3,blue,5,0.83,18,16,blue
4474081068,4,3,4,0,0,0,0,17585,7.2,19376,270,55,3052,3581,27,1758.5,3,4,8,0,0,0,0,14533,6.6,15795,200,44,-3052,-3581,20,1453.3,blue,2.67,2.75,90,44,red
4524916446,3,9,5,1,1,0,0,16233,6.4,17101,216,52,-3559,-3823,21.6,1623.3,9,3,6,1,0,1,1,19792,7.6,20924,236,56,3559,3823,23.6,1979.2,red,0.89,5,20,16,red
4475799088,8,12,9,0,0,0,0,16830,7,17100,206,59,-1619,265,20.6,1683,12,8,19,1,0,1,0,18449,7,16835,158,45,1619,-265,15.8,1844.9,red,1.42,3.88,20,25,red
4469524745,9,6,8,1,0,1,1,19257,7,18701,224,68,3766,3001,22.4,1925.7,6,9,9,0,0,0,0,15491,6.4,15700,186,44,-3766,-3001,18.6,1549.1,blue,2.83,1.67,92,51,blue
4522819345,5,2,5,0,0,0,0,16977,7,18682,231,60,1807,1076,23.1,1697.7,2,5,1,1,0,1,0,15170,7,17606,237,51,-1807,-1076,23.7,1517,blue,5,0.6,20,45,blue
4464132605,4,3,2,2,1,1,0,15517,6.8,17441,215,52,697,951,21.5,1551.7,3,4,3,0,0,0,0,14820,6.8,16490,211,48,-697,-951,21.1,1482,blue,2,1.5,17,15,red
4524919895,12,7,13,2,1,1,0,17810,6.6,16753,150,50,532,-883,15,1781,7,12,8,0,0,0,0,17278,6.8,17636,255,28,-532,883,25.5,1727.8,red,3.57,1.25,23,20,blue
4487949921,5,5,9,0,0,0,0,15454,6.8,16466,210,40,-824,-976,21,1545.4,5,5,8,0,0,0,0,16278,6.8,17442,240,56,824,976,24,1627.8,red,2.8,2.6,20,56,red
4460536979,12,1,10,1,1,0,0,18048,7,19291,185,55,4294,2844,18.5,1804.8,1,12,0,0,0,0,0,13754,6.4,16447,176,68,-4294,-2844,17.6,1375.4,blue,22,0.08,14,15,blue
4525009804,7,6,7,1,1,0,0,16938,7.2,18493,223,60,206,-453,22.3,1693.8,6,7,3,1,0,1,0,16732,7.4,18946,234,56,-206,453,23.4,1673.2,red,2.33,1.29,15,17,blue
4494315859,9,4,14,0,0,0,0,18587,7.4,19265,223,52,2851,1140,22.3,1858.7,4,9,3,1,1,0,0,15736,6.8,18125,226,68,-2851,-1140,22.6,1573.6,blue,5.75,0.78,14,19,red
4515468378,2,10,1,0,0,0,0,13711,6.2,15114,180,48,-4331,-3757,18,1371.1,10,2,12,2,1,1,0,18042,7.2,18871,216,71,4331,3757,21.6,1804.2,blue,0.3,11,16,23,red
4457802737,6,1,9,0,0,0,0,17687,7,18128,232,60,4039,1819,23.2,1768.7,1,6,1,0,0,0,0,13648,6.6,16309,217,52,-4039,-1819,21.7,1364.8,blue,15,0.33,21,18,blue
4475997366,6,3,6,1,0,1,0,17170,6.8,18330,238,56,2241,639,23.8,1717,3,6,3,0,0,0,0,14929,6.6,17691,214,60,-2241,-639,21.4,1492.9,red,4,1,20,17,blue
4498029734,7,6,7,0,0,0,0,17055,7.2,19405,230,55,567,1254,23,1705.5,6,7,7,1,1,0,0,16488,7,18151,201,60,-567,-1254,20.1,1648.8,red,2.33,1.86,18,21,red
4516562563,9,6,10,0,0,0,0,16760,6.8,16804,193,42,226,-957,19.3,1676,6,9,2,0,0,0,0,16534,6.8,17761,213,55,-226,957,21.3,1653.4,red,3.17,0.89,15,15,red
4513270155,5,13,4,1,1,0,0,15680,6.8,18107,197,64,-3865,-1779,19.7,1568,13,5,15,0,0,0,0,19545,7.2,19886,223,43,3865,1779,22.3,1954.5,red,0.69,5.6,69,20,red
4524115285,4,9,3,0,0,0,0,13670,6.2,15417,166,30,-6282,-4301,16.6,1367,9,4,8,1,1,0,1,19952,7.2,19718,233,65,6282,4301,23.3,1995.2,red,0.78,4.25,37,16,red
4470543217,14,8,17,1,1,0,0,20305,7.4,19846,239,55,3072,3561,23.9,2030.5,8,14,9,0,0,0,0,17233,6.8,16285,189,40,-3072,-3561,18.9,1723.3,blue,3.88,1.21,43,21,red
4466899490,5,6,7,1,1,0,0,16209,7,18162,231,52,55,-1918,23.1,1620.9,6,5,3,0,0,0,0,16154,7.2,20080,228,64,-55,1918,22.8,1615.4,blue,2,1.8,15,20,blue
4421794878,13,8,17,2,1,1,1,20860,7.2,19749,239,67,4299,3637,23.9,2086,8,13,10,0,0,0,0,16561,6.4,16112,192,33,-4299,-3637,19.2,1656.1,blue,3.75,1.38,27,24,red
4439533081,4,4,6,1,0,1,0,16180,6.8,17769,217,56,1338,1039,21.7,1618,4,4,3,0,0,0,0,14842,6.6,16730,216,47,-1338,-1039,21.6,1484.2,red,2.5,1.75,15,18,red
4424234082,8,3,8,0,0,0,0,17608,7.2,18800,210,43,2185,955,21,1760.8,3,8,4,0,0,0,0,15423,6.8,17845,231,53,-2185,-955,23.1,1542.3,blue,5.33,0.88,20,20,blue
4482198928,9,11,8,1,1,0,0,17248,6.6,16433,185,40,-109,158,18.5,1724.8,11,9,6,0,0,0,0,17357,6.4,16275,195,33,109,-158,19.5,1735.7,red,1.55,1.89,51,16,red
4515946724,6,4,6,0,0,0,0,17025,7,18219,211,59,1196,-85,21.1,1702.5,4,6,2,1,1,0,0,15829,7,18304,228,64,-1196,85,22.8,1582.9,blue,3,1,17,18,red
4523056736,3,8,8,0,0,0,0,14451,6.8,16229,225,37,-3028,-3555,22.5,1445.1,8,3,8,1,0,1,0,17479,7.4,19784,223,60,3028,3555,22.3,1747.9,red,1.38,5.33,21,38,blue
4450343886,8,7,9,0,0,0,0,17169,7,17752,210,51,734,-965,21,1716.9,7,8,5,0,0,0,0,16435,7,18717,207,58,-734,965,20.7,1643.5,red,2.43,1.5,17,63,blue
4521921939,6,6,7,2,1,1,0,15908,7.2,18702,208,63,-1035,-442,20.8,1590.8,6,6,2,0,0,0,0,16943,7.2,19144,229,64,1035,442,22.9,1694.3,red,2.17,1.33,18,27,red
4521986656,2,8,3,0,0,0,0,14948,6.8,17592,226,48,-3669,-2489,22.6,1494.8,8,2,14,1,1,0,0,18617,7.6,20081,255,76,3669,2489,25.5,1861.7,blue,0.62,11,33,21,red
4523281045,8,12,14,0,0,0,0,16941,7,17520,203,41,-1833,-393,20.3,1694.1,12,8,17,2,1,1,0,18774,7,17913,210,52,1833,393,21,1877.4,red,1.83,3.62,22,21,red
4474915935,9,10,7,1,1,0,0,18410,7.2,18561,253,51,714,-176,25.3,1841,10,9,10,0,0,0,0,17696,7,18737,232,40,-714,176,23.2,1769.6,blue,1.6,2.22,34,20,blue
4429865093,5,6,3,1,1,0,0,15288,6.8,18328,218,52,-1652,466,21.8,1528.8,6,5,9,0,0,0,0,16940,6.8,17862,224,47,1652,-466,22.4,1694,red,1.33,3,18,16,red
4475519320,1,6,0,0,0,0,0,13446,6.4,15362,204,45,-4840,-4530,20.4,1344.6,6,1,6,2,1,1,1,18286,7.2,19892,258,66,4840,4530,25.8,1828.6,red,0.17,12,26,24,blue
4472501015,8,5,11,1,0,1,1,18802,6.8,17609,236,42,3247,576,23.6,1880.2,5,8,4,0,0,0,0,15555,6.8,17033,207,51,-3247,-576,20.7,1555.5,blue,3.8,1.12,20,17,blue
4522527253,5,2,6,0,0,0,0,16398,7,17792,234,39,1343,519,23.4,1639.8,2,5,1,1,1,0,0,15055,6.8,17273,225,63,-1343,-519,22.5,1505.5,blue,5.5,0.6,17,13,blue
4476639744,4,4,4,0,0,0,0,15778,7.2,18381,219,40,36,-325,21.9,1577.8,4,4,1,0,0,0,0,15742,7.2,18706,220,64,-36,325,22,1574.2,red,2,1.25,17,15,red
4526971501,3,3,1,0,0,0,0,14634,7,18284,213,48,-879,254,21.3,1463.4,3,3,3,1,1,0,0,15513,7,18030,248,48,879,-254,24.8,1551.3,red,1.33,2,15,18,red
4503041917,2,9,3,0,0,0,0,14269,6.4,15867,203,41,-3941,-3623,20.3,1426.9,9,2,9,1,1,0,0,18210,7.2,19490,239,46,3941,3623,23.9,1821,blue,0.56,9,17,16,red
4519327401,6,8,11,1,1,0,0,16031,6.6,17016,215,57,-987,-1705,21.5,1603.1,8,6,8,0,0,0,0,17018,6.8,18721,223,55,987,1705,22.3,1701.8,red,2.12,2.67,21,19,blue
4467537493,3,8,3,0,0,0,0,13817,6.4,14829,167,44,-3294,-2723,16.7,1381.7,8,3,5,1,1,0,0,17111,6.6,17552,206,48,3294,2723,20.6,1711.1,red,0.75,4.33,19,16,red
4512808961,5,11,5,1,1,0,0,16280,6.6,17350,199,48,-2198,-1633,19.9,1628,11,5,15,0,0,0,0,18478,7.2,18983,188,46,2198,1633,18.8,1847.8,red,0.91,5.2,21,18,red
4472483704,3,8,5,0,0,0,0,14823,6.8,17193,193,56,-3916,-1400,19.3,1482.3,8,3,7,2,1,1,1,18739,7,18593,245,53,3916,1400,24.5,1873.9,blue,1,5,67,28,red
4514660539,9,9,7,0,0,0,0,17174,7,18159,189,49,-1342,-1278,18.9,1717.4,9,9,10,1,1,0,0,18516,7.2,19437,238,50,1342,1278,23.8,1851.6,blue,1.78,2.11,22,176,blue
4470658458,8,4,8,1,0,1,0,17349,7.6,19375,197,55,1942,1658,19.7,1734.9,4,8,2,1,1,0,0,15407,6.8,17717,228,52,-1942,-1658,22.8,1540.7,blue,4,0.75,18,22,red
4506057736,1,5,2,1,0,1,0,13235,6.4,15728,187,40,-2466,-1449,18.7,1323.5,5,1,6,1,1,0,0,15701,6.6,17177,221,31,2466,1449,22.1,1570.1,red,0.6,11,18,25,red
4472131838,6,10,8,0,0,0,0,16231,6.6,16805,179,50,-1535,-838,17.9,1623.1,10,6,11,1,1,0,0,17766,6.8,17643,192,59,1535,838,19.2,1776.6,red,1.4,3.5,17,19,red
4464848388,4,5,3,2,1,1,0,15255,7.2,18352,228,47,-965,658,22.8,1525.5,5,4,5,0,0,0,0,16220,7,17694,223,44,965,-658,22.3,1622,blue,1.4,2.5,14,15,red
4493734272,2,5,1,0,0,0,0,15337,7.2,18920,235,72,-1676,-532,23.5,1533.7,5,2,8,0,0,0,0,17013,7.4,19452,228,63,1676,532,22.8,1701.3,blue,0.6,6.5,22,23,red
4527017223,9,6,9,0,0,0,0,18050,6.6,17022,220,28,2847,1559,22,1805,6,9,6,1,1,0,0,15203,6.2,15463,176,52,-2847,-1559,17.6,1520.3,blue,3,1.33,21,21,blue
4478592146,4,2,4,1,1,0,0,15730,6.8,18012,240,55,1383,660,24,1573,2,4,1,0,0,0,0,14347,6.6,17352,221,56,-1383,-660,22.1,1434.7,blue,4,0.75,52,16,blue
4447547106,2,3,3,0,0,0,0,14752,6.8,17798,230,53,-439,-983,23,1475.2,3,2,3,2,1,1,0,15191,7.2,18781,222,65,439,983,22.2,1519.1,red,1.67,3,16,36,red
4508188493,9,5,10,0,0,0,0,17578,7.2,19495,213,52,1989,2500,21.3,1757.8,5,9,5,1,1,0,0,15589,6.8,16995,218,44,-1989,-2500,21.8,1558.9,blue,3.8,1.11,75,16,red
4484146794,5,6,3,1,1,0,0,15397,6.6,17110,222,55,-775,-393,22.2,1539.7,6,5,5,0,0,0,0,16172,6.8,17503,191,52,775,393,19.1,1617.2,blue,1.33,2.2,19,19,red
4523808167,8,6,10,1,0,1,0,17012,7,17507,225,38,872,-215,22.5,1701.2,6,8,6,1,1,0,0,16140,6.8,17722,214,48,-872,215,21.4,1614,red,3,1.5,16,75,blue
4500724232,2,2,1,1,0,1,0,14886,6.8,18605,234,55,762,1570,23.4,1488.6,2,2,1,1,1,0,0,14124,6.8,17035,209,44,-762,-1570,20.9,1412.4,blue,1.5,1.5,40,54,blue
4474893713,12,7,14,2,1,1,0,19592,7.2,19231,235,53,3214,2261,23.5,1959.2,7,12,5,0,0,0,0,16378,7,16970,184,49,-3214,-2261,18.4,1637.8,blue,3.71,1,17,55,blue
4505729756,7,9,6,0,0,0,0,17550,7.2,18791,237,52,175,989,23.7,1755,9,7,9,1,1,0,0,17375,6.8,17802,221,48,-175,-989,22.1,1737.5,red,1.44,2.57,16,15,red
4518473968,7,6,6,0,0,0,0,17106,6.8,17550,226,47,1138,558,22.6,1710.6,6,7,5,1,0,1,0,15968,6.8,16992,202,39,-1138,-558,20.2,1596.8,blue,2.17,1.57,16,17,blue
4475507866,8,7,9,1,0,1,0,17977,7.2,18586,255,49,1062,445,25.5,1797.7,7,8,8,1,1,0,0,16915,7.2,18141,203,62,-1062,-445,20.3,1691.5,red,2.43,1.88,24,20,blue
4505127174,6,2,5,1,1,0,0,16953,7.2,19642,248,52,2348,2678,24.8,1695.3,2,6,3,0,0,0,0,14605,6.6,16964,225,56,-2348,-2678,22.5,1460.5,blue,5.5,0.83,20,22,blue
4514341381,2,10,2,0,0,0,0,13550,6.4,15932,183,30,-4770,-3411,18.3,1355,10,2,7,1,1,0,0,18320,7.4,19343,236,56,4770,3411,23.6,1832,red,0.4,8.5,15,42,red
4505220147,4,11,7,0,0,0,0,15224,6.8,16862,189,43,-3595,-1973,18.9,1522.4,11,4,11,1,1,0,0,18819,7,18835,221,68,3595,1973,22.1,1881.9,red,1,5.5,20,23,red
4508120759,9,3,9,1,1,0,0,18582,7.6,19702,243,51,3881,3409,24.3,1858.2,3,9,4,0,0,0,0,14701,6.6,16293,217,40,-3881,-3409,21.7,1470.1,blue,6,0.78,20,15,blue
4473949665,15,3,12,1,0,1,0,21202,7.8,21701,238,59,6577,4426,23.8,2120.2,3,15,3,0,0,0,0,14625,7,17275,188,57,-6577,-4426,18.8,1462.5,blue,9,0.4,30,17,blue
4459896509,7,5,3,2,1,1,0,16066,6.8,17944,224,50,-1247,400,22.4,1606.6,5,7,3,0,0,0,1,17313,6.8,17544,225,55,1247,-400,22.5,1731.3,red,2,1.14,46,18,blue
4496832374,9,6,11,1,1,0,0,18077,6.8,17869,235,40,1669,113,23.5,1807.7,6,9,4,0,0,0,0,16408,7,17756,218,48,-1669,-113,21.8,1640.8,blue,3.33,1.11,20,19,red
4496136877,3,3,6,1,1,0,0,16042,7.2,19220,255,72,580,709,25.5,1604.2,3,3,2,1,0,1,0,15462,7,18511,231,51,-580,-709,23.1,1546.2,red,3,1.67,18,22,red
4525596664,4,4,7,0,0,0,0,14781,6.6,16316,209,32,165,267,20.9,1478.1,4,4,8,1,1,0,0,14616,6.4,16049,185,48,-165,-267,18.5,1461.6,blue,2.75,3,18,16,blue
4522256108,7,11,4,1,0,1,0,15904,6.4,15750,198,36,-1597,-1321,19.8,1590.4,11,7,15,1,1,0,0,17501,6.8,17071,170,63,1597,1321,17,1750.1,red,1,3.71,82,19,blue
4521874252,4,5,5,0,0,0,0,15281,6.6,16663,211,62,-736,-1526,21.1,1528.1,5,4,4,1,1,0,0,16017,7,18189,229,53,736,1526,22.9,1601.7,blue,1.8,2.25,19,19,red
4465964389,4,8,7,0,0,0,0,14795,6.6,16491,190,36,-3431,-1020,19,1479.5,8,4,11,1,1,0,0,18226,6.8,17511,221,47,3431,1020,22.1,1822.6,red,1.38,4.75,42,28,red
4518589161,3,7,3,0,0,0,0,15065,6.8,17306,239,31,-2560,-2062,23.9,1506.5,7,3,6,2,1,1,0,17625,7.2,19368,242,63,2560,2062,24.2,1762.5,blue,0.86,4.33,80,19,red
4521148922,9,5,18,2,1,1,1,19011,7,17878,201,57,3451,202,20.1,1901.1,5,9,4,0,0,0,0,15560,7,17676,224,44,-3451,-202,22.4,1556,blue,5.4,1,19,47,blue
4527257242,6,4,3,0,0,0,0,16366,7,18102,237,61,1980,1777,23.7,1636.6,4,6,4,1,1,0,0,14386,6.4,16325,203,40,-1980,-1777,20.3,1438.6,red,2.25,1.33,17,18,blue
4478190403,7,9,5,0,0,0,0,16709,7.2,19029,227,48,-629,180,22.7,1670.9,9,7,9,0,0,0,0,17338,7.2,18849,223,56,629,-180,22.3,1733.8,blue,1.33,2.57,22,21,red
4470068491,5,4,2,1,0,1,0,15798,7,18818,231,52,-361,671,23.1,1579.8,4,5,3,1,1,0,0,16159,7,18147,248,48,361,-671,24.8,1615.9,blue,1.75,1.4,13,19,red
4527293021,5,3,5,1,1,0,0,15239,7.2,18919,218,45,742,2904,21.8,1523.9,3,5,4,0,0,0,0,14497,6.6,16015,182,58,-742,-2904,18.2,1449.7,blue,3.33,1.4,17,24,blue
4510120989,8,6,11,1,1,0,0,17287,7,18312,224,45,886,684,22.4,1728.7,6,8,8,0,0,0,0,16401,6.8,17628,228,32,-886,-684,22.8,1640.1,blue,3.17,1.75,23,48,blue
4526615576,3,5,5,0,0,0,0,14788,6.6,16201,223,44,-166,-1446,22.3,1478.8,5,3,3,0,0,0,0,14954,7,17647,188,52,166,1446,18.8,1495.4,blue,1.6,2.67,18,19,blue
4525354292,7,5,7,1,1,0,0,16736,7,18814,217,56,433,-323,21.7,1673.6,5,7,6,0,0,0,0,16303,7.2,19137,262,52,-433,323,26.2,1630.3,blue,2.8,1.57,19,25,blue
4447620478,7,9,8,1,1,0,0,16876,7,17943,223,38,31,-472,22.3,1687.6,9,7,12,0,0,0,0,16845,7.2,18415,207,27,-31,472,20.7,1684.5,red,1.67,3,18,41,blue
4510923222,4,8,6,1,1,0,0,14563,6.6,15835,196,39,-3004,-3860,19.6,1456.3,8,4,10,0,0,0,0,17567,7.2,19695,229,64,3004,3860,22.9,1756.7,red,1.25,4.5,16,21,blue
4527100931,3,5,5,0,0,0,0,15912,6.4,16609,236,40,1034,-973,23.6,1591.2,5,3,2,1,1,0,0,14878,6.8,17582,169,67,-1034,973,16.9,1487.8,red,1.6,2.33,18,17,red
4500484679,5,5,9,1,0,1,0,16624,6.8,18064,208,62,1060,2796,20.8,1662.4,5,5,7,1,1,0,0,15564,6.6,15268,190,44,-1060,-2796,19,1556.4,red,2.8,2.4,17,18,red
4387767645,10,7,9,1,1,0,1,19018,7.2,19294,209,63,3126,3795,20.9,1901.8,7,10,11,0,0,0,0,15892,6.4,15499,162,51,-3126,-3795,16.2,1589.2,blue,2.71,1.8,17,13,blue
4463387399,6,7,6,0,0,0,0,16682,7.2,19047,209,68,-257,1379,20.9,1668.2,7,6,8,1,1,0,0,16939,6.8,17668,209,55,257,-1379,20.9,1693.9,blue,1.71,2.5,20,23,red
4484373881,6,4,8,2,1,1,0,17249,7,18964,239,56,1095,768,23.9,1724.9,4,6,6,0,0,0,0,16154,7,18196,247,56,-1095,-768,24.7,1615.4,red,3.5,1.67,18,16,blue
4494726186,4,6,3,0,0,0,0,15727,7.2,18903,247,44,-84,221,24.7,1572.7,6,4,4,0,0,0,0,15811,7.2,18682,216,52,84,-221,21.6,1581.1,blue,1.17,2.5,15,15,red
4472805332,4,6,3,0,0,0,0,14962,7,18176,201,48,-1672,-2213,20.1,1496.2,6,4,3,0,0,0,0,16634,7.4,20389,237,68,1672,2213,23.7,1663.4,red,1.17,2.25,17,18,red
4501013939,6,2,7,1,1,0,0,17390,7.4,19841,239,68,1644,987,23.9,1739,2,6,4,1,0,1,0,15746,7,18854,250,60,-1644,-987,25,1574.6,red,6.5,1,18,16,blue
4478907514,7,10,8,1,1,0,0,16632,6.8,17520,191,53,-1069,-587,19.1,1663.2,10,7,11,0,0,0,0,17701,6.8,18107,202,45,1069,587,20.2,1770.1,blue,1.5,3,23,19,blue
4496688229,5,3,5,1,1,0,0,16706,7,17948,231,48,1352,-81,23.1,1670.6,3,5,2,0,0,0,0,15354,7,18029,230,55,-1352,81,23,1535.4,blue,3.33,1,17,21,blue
4522642789,2,1,3,0,0,0,0,14969,6.8,16983,246,51,816,-457,24.6,1496.9,1,2,2,2,1,1,0,14153,6.8,17440,213,52,-816,457,21.3,1415.3,red,5,1.5,19,42,blue
4485749610,4,5,5,2,1,1,0,16630,7.2,19373,251,70,-159,-206,25.1,1663,5,4,6,0,0,0,0,16789,7.2,19579,244,65,159,206,24.4,1678.9,blue,1.8,2.75,18,24,red
4494913568,7,11,11,0,0,0,0,17037,7,18710,243,47,-1896,-1756,24.3,1703.7,11,7,13,1,1,0,0,18933,7.4,20466,243,50,1896,1756,24.3,1893.3,red,1.64,3.43,19,17,blue
4492541051,7,2,3,0,0,0,0,16729,7.2,19694,231,56,2248,3163,23.1,1672.9,2,7,1,0,0,0,0,14481,6.4,16531,206,53,-2248,-3163,20.6,1448.1,red,5,0.43,25,16,blue
4489966675,5,5,6,0,0,0,0,16281,6.8,17527,233,48,128,-368,23.3,1628.1,5,5,10,1,1,0,0,16153,7.2,17895,223,51,-128,368,22.3,1615.3,blue,2.2,3,29,21,blue
4462339976,6,4,11,0,0,0,0,16375,7.2,18060,226,44,1389,1615,22.6,1637.5,4,6,3,2,1,1,0,14986,6.6,16445,198,50,-1389,-1615,19.8,1498.6,blue,4.25,1.17,67,14,blue
4483417316,7,4,4,1,1,0,0,16849,7.6,20518,234,68,1116,2834,23.4,1684.9,4,7,6,0,0,0,0,15733,6.8,17684,237,48,-1116,-2834,23.7,1573.3,blue,2.75,1.43,39,14,blue
4525386289,10,2,16,1,0,1,0,18195,7.2,19078,220,48,4358,4325,22,1819.5,2,10,3,0,0,0,0,13837,6,14753,207,44,-4358,-4325,20.7,1383.7,blue,13,0.5,16,17,blue
4491961923,4,7,2,0,0,0,0,15825,7,18247,235,54,-306,-953,23.5,1582.5,7,4,7,1,1,0,0,16131,7.4,19200,227,45,306,953,22.7,1613.1,blue,0.86,3.5,16,40,red
4476239097,11,7,8,0,0,0,0,18483,7.4,19419,199,47,2915,2523,19.9,1848.3,7,11,6,0,0,0,0,15568,6.6,16896,209,41,-2915,-2523,20.9,1556.8,blue,2.71,1.18,14,19,blue
4505326762,10,6,14,0,0,0,0,18270,7,18940,234,50,1927,495,23.4,1827,6,10,7,2,1,1,0,16343,7,18445,224,49,-1927,-495,22.4,1634.3,red,4,1.3,22,17,red
4503121126,9,6,11,0,0,0,0,17372,6.8,17545,202,42,1491,1101,20.2,1737.2,6,9,6,2,1,1,0,15881,6.4,16444,206,48,-1491,-1101,20.6,1588.1,red,3.33,1.33,20,21,blue
4505476136,11,4,13,0,0,0,0,19582,7.4,19381,228,44,4267,2764,22.8,1958.2,4,11,2,0,0,0,0,15315,6.6,16617,200,50,-4267,-2764,20,1531.5,blue,6,0.55,18,18,red
4437519921,5,4,3,0,0,0,0,16823,7.2,19226,226,68,1409,2767,22.6,1682.3,4,5,7,0,0,0,0,15414,6.6,16459,188,52,-1409,-2767,18.8,1541.4,blue,2,2.2,10,15,red
4502105412,9,4,9,2,1,1,0,18264,7.4,20134,234,75,2188,2716,23.4,1826.4,4,9,5,0,0,0,0,16076,6.8,17418,227,60,-2188,-2716,22.7,1607.6,blue,4.5,1,24,11,red
4527083339,3,10,2,0,0,0,0,15142,6.8,16713,211,52,-3107,-1687,21.1,1514.2,10,3,21,1,1,0,0,18249,6.8,18400,222,53,3107,1687,22.2,1824.9,red,0.5,10.33,21,24,red
4492536033,5,8,4,1,1,0,0,16396,7.2,18166,211,60,-1640,-907,21.1,1639.6,8,5,9,0,0,0,0,18036,7.2,19073,250,48,1640,907,25,1803.6,red,1.12,3.4,41,18,blue
4503471693,4,7,3,0,0,0,0,15434,7,18097,235,49,-1806,-226,23.5,1543.4,7,4,12,1,1,0,0,17240,7.2,18323,224,58,1806,226,22.4,1724,blue,1,4.75,26,24,red
4446019299,6,3,7,1,1,0,1,18564,7,18738,239,44,4518,1715,23.9,1856.4,3,6,2,0,0,0,0,14046,6.8,17023,169,55,-4518,-1715,16.9,1404.6,blue,4.33,0.83,18,14,blue
4514189275,8,6,9,0,0,0,0,17304,7.2,19455,233,52,1127,1908,23.3,1730.4,6,8,5,1,1,0,0,16177,6.8,17547,211,52,-1127,-1908,21.1,1617.7,red,2.83,1.38,13,8,red
4472984936,8,5,5,0,0,0,0,17785,7.2,19422,238,55,2597,2731,23.8,1778.5,5,8,4,1,1,0,0,15188,6.6,16691,199,47,-2597,-2731,19.9,1518.8,red,2.6,1.12,25,39,blue
4524360641,8,4,11,0,0,0,0,17299,6.8,17445,233,32,2406,1503,23.3,1729.9,4,8,2,0,0,0,0,14893,6.2,15942,194,49,-2406,-1503,19.4,1489.3,blue,4.75,0.75,16,16,blue
4486292796,7,11,4,0,0,0,0,15528,6.6,17206,235,6,-3546,-1919,23.5,1552.8,11,7,12,0,0,0,0,19074,7.2,19125,238,65,3546,1919,23.8,1907.4,red,1,3.29,14,14,red
4526660217,6,5,10,0,0,0,0,16532,6.6,16932,213,58,1920,1140,21.3,1653.2,5,6,9,1,1,0,0,14612,6.4,15792,155,52,-1920,-1140,15.5,1461.2,red,3.2,2.33,16,18,blue
4464579175,6,4,7,1,1,0,0,16279,7,18119,227,44,1079,784,22.7,1627.9,4,6,4,0,0,0,0,15200,6.6,17335,223,55,-1079,-784,22.3,1520,red,3.25,1.33,18,18,blue
4513797565,11,5,10,1,1,0,0,19245,7.6,20286,245,60,3108,2974,24.5,1924.5,5,11,6,0,0,0,0,16137,6.8,17312,194,64,-3108,-2974,19.4,1613.7,blue,4.2,1,17,60,blue
4525790279,1,5,1,0,0,0,0,14998,7,17794,246,48,-1431,269,24.6,1499.8,5,1,8,0,0,0,0,16429,6.8,17525,230,52,1431,-269,23,1642.9,blue,0.4,13,22,22,red
4525378713,6,7,5,1,1,0,0,15391,6.6,16901,182,56,-1595,-907,18.2,1539.1,7,6,5,0,0,0,0,16986,6.8,17808,201,64,1595,907,20.1,1698.6,blue,1.57,2,18,16,red
4526119590,11,8,10,0,0,0,0,18459,7,17481,224,39,1536,624,22.4,1845.9,8,11,12,1,1,0,0,16923,6.6,16857,197,55,-1536,-624,19.7,1692.3,red,2.62,1.82,20,16,blue
4486673822,4,7,5,0,0,0,0,15535,6.8,18068,214,56,-1608,-572,21.4,1553.5,7,4,9,2,1,1,0,17143,7,18640,220,59,1608,572,22,1714.3,red,1.29,4,18,17,red
4527311362,6,1,9,0,0,0,0,17226,7.4,19043,269,52,2955,2093,26.9,1722.6,1,6,1,1,0,1,0,14271,6.8,16950,224,56,-2955,-2093,22.4,1427.1,blue,15,0.33,16,83,blue
4526731314,5,6,6,1,0,1,0,15743,6.6,16662,212,48,-720,-1533,21.2,1574.3,6,5,11,1,1,0,0,16463,7,18195,229,48,720,1533,22.9,1646.3,blue,1.83,3.4,21,26,blue
4527438398,2,5,0,0,0,0,0,14659,6.6,16878,233,46,-492,89,23.3,1465.9,5,2,3,0,0,0,0,15151,6.8,16789,175,48,492,-89,17.5,1515.1,red,0.4,4,21,18,red
4509798845,7,10,14,1,0,1,0,15674,6.4,16123,176,53,-3579,-3233,17.6,1567.4,10,7,18,1,1,0,0,19253,7.2,19356,203,65,3579,3233,20.3,1925.3,red,2.1,4,14,17,blue
4494519313,13,1,14,0,0,0,1,20699,7.4,19768,249,44,7721,5190,24.9,2069.9,1,13,0,0,0,0,0,12978,6,14578,200,40,-7721,-5190,20,1297.8,blue,27,0.08,13,14,blue
4525841873,10,3,9,1,1,0,0,17631,6.8,18612,201,44,3436,1760,20.1,1763.1,3,10,1,1,0,1,0,14195,6.6,16852,206,48,-3436,-1760,20.6,1419.5,red,6.33,0.4,20,17,blue
4423286445,5,5,3,1,1,0,0,16282,7.2,19492,225,61,813,1913,22.5,1628.2,5,5,4,0,0,0,0,15469,7,17579,225,52,-813,-1913,22.5,1546.9,blue,1.6,1.8,39,13,blue
4520535249,3,7,3,2,1,1,0,14249,6.6,16596,220,38,-3144,-3235,22,1424.9,7,3,4,0,0,0,0,17393,7.2,19831,255,80,3144,3235,25.5,1739.3,red,0.86,3.67,18,26,red
4525957901,12,11,10,1,1,0,0,18159,7,18557,207,37,-48,482,20.7,1815.9,11,12,16,0,0,0,0,18207,7.2,18075,159,46,48,-482,15.9,1820.7,red,2,2.25,43,27,blue
4527580524,6,8,9,1,1,0,0,15666,6.4,16073,208,39,-2468,-2552,20.8,1566.6,8,6,6,1,0,1,0,18134,7.2,18625,231,60,2468,2552,23.1,1813.4,red,1.88,2.33,18,15,red
4507977385,1,8,1,0,0,0,0,13305,6.2,15657,196,50,-4849,-4463,19.6,1330.5,8,1,9,2,1,1,0,18154,7.4,20120,276,65,4849,4463,27.6,1815.4,red,0.25,17,11,15,red
4527276580,6,3,5,1,1,0,0,16563,7,18392,215,52,1786,-5,21.5,1656.3,3,6,2,0,0,0,0,14777,7,18397,201,63,-1786,5,20.1,1477.7,blue,3.67,0.83,18,13,blue
4492402947,11,4,4,1,1,0,0,18339,7.2,18855,216,53,4128,2704,21.6,1833.9,4,11,4,0,0,0,0,14211,6.4,16151,158,47,-4128,-2704,15.8,1421.1,blue,3.75,0.73,51,15,blue
4465778231,11,8,11,0,0,0,0,17666,6.8,16963,193,48,-184,-835,19.3,1766.6,8,11,12,0,0,0,0,17850,7,17798,234,52,184,835,23.4,1785,blue,2.75,1.82,28,15,red
4525945440,4,9,7,1,1,0,0,15315,7,17674,188,62,-2881,-981,18.8,1531.5,9,4,11,1,0,1,0,18196,7,18655,230,39,2881,981,23,1819.6,red,1.22,5,19,22,red
4413135878,12,5,13,0,0,0,0,18628,7,18625,239,43,2863,2632,23.9,1862.8,5,12,7,0,0,0,0,15765,6.6,15993,207,45,-2863,-2632,20.7,1576.5,blue,5,1,21,23,red
4526385006,7,3,7,1,1,0,0,17342,7.2,18792,248,56,2783,1844,24.8,1734.2,3,7,3,0,0,0,0,14559,6.8,16948,197,52,-2783,-1844,19.7,1455.9,blue,4.67,0.86,15,12,red
4450382199,7,8,7,0,0,0,1,18000,6.8,17798,210,48,1157,-173,21,1800,8,7,10,0,0,0,0,16843,7,17971,190,53,-1157,173,19,1684.3,red,1.75,2.57,20,61,blue
4493638317,3,4,2,1,0,1,0,15318,6.8,17968,235,49,-942,120,23.5,1531.8,4,3,5,1,1,0,0,16260,6.8,17848,263,44,942,-120,26.3,1626,blue,1.25,3,19,18,red
4495435379,9,5,9,1,0,1,0,17795,7.4,19812,237,71,1367,1620,23.7,1779.5,5,9,4,1,1,0,0,16428,7,18192,217,60,-1367,-1620,21.7,1642.8,blue,3.6,1,107,31,blue
4525318046,6,8,5,0,0,0,0,16351,7,18380,234,52,-2929,-154,23.4,1635.1,8,6,10,1,1,0,1,19280,7.2,18534,233,48,2929,154,23.3,1928,red,1.38,3,44,43,blue
4508240261,4,5,2,1,1,0,0,14842,6.8,17067,184,46,-1992,-1722,18.4,1484.2,5,4,5,1,0,1,1,16834,7.2,18789,209,55,1992,1722,20.9,1683.4,red,1.2,2.5,125,13,blue
4500702023,2,3,6,0,0,0,0,15439,7,18214,250,55,567,1168,25,1543.9,3,2,6,1,0,1,0,14872,6.6,17046,225,40,-567,-1168,22.5,1487.2,blue,2.67,4.5,33,52,blue
4526265096,9,6,5,1,0,1,0,16994,7.6,19700,225,40,446,2153,22.5,1699.4,6,9,5,1,1,0,0,16548,6.8,17547,234,42,-446,-2153,23.4,1654.8,blue,2.33,1.22,17,16,blue
4502952363,7,7,15,0,0,0,0,16250,6.8,17026,157,54,-1661,-1369,15.7,1625,7,7,9,0,0,0,0,17911,7.2,18395,243,51,1661,1369,24.3,1791.1,red,3.14,2.29,81,24,blue
4502881141,2,12,2,0,0,0,0,14789,6.6,16856,221,54,-5163,-3425,22.1,1478.9,12,2,13,1,1,0,1,19952,7.4,20281,237,41,5163,3425,23.7,1995.2,red,0.33,12.5,44,27,red
4525913834,3,4,2,0,0,0,0,14830,6.8,16901,184,60,-572,-636,18.4,1483,4,3,3,1,1,0,0,15402,7,17537,194,56,572,636,19.4,1540.2,blue,1.25,2.33,20,20,red
4509818939,1,7,1,0,0,0,0,14252,6.6,16567,229,47,-4219,-3256,22.9,1425.2,7,1,9,2,1,1,0,18471,7.2,19823,268,59,4219,3256,26.8,1847.1,red,0.29,16,70,80,red
4465705901,6,13,5,1,1,0,0,17300,7.2,18747,229,68,-2604,-2089,22.9,1730,13,6,12,0,0,0,0,19904,7.6,20836,214,52,2604,2089,21.4,1990.4,red,0.85,4.17,20,16,red
4521267611,10,12,6,1,1,0,0,17391,6.8,18031,202,56,-3064,-537,20.2,1739.1,12,10,11,1,0,1,1,20455,7.2,18568,180,51,3064,537,18,2045.5,red,1.33,2.3,16,19,red
4462172750,5,10,5,0,0,0,0,15600,6.6,16412,169,50,-2689,-1566,16.9,1560,10,5,12,1,1,0,0,18289,7,17978,223,49,2689,1566,22.3,1828.9,red,1,4.4,19,28,red
4526606861,8,4,7,1,1,0,0,16134,6.6,16880,183,52,857,22,18.3,1613.4,4,8,1,0,0,0,0,15277,6.6,16858,210,52,-857,-22,21,1527.7,blue,3.75,0.62,17,14,blue
4518326207,11,4,11,0,0,0,0,18470,7.4,19952,231,59,3418,3608,23.1,1847,4,11,3,0,0,0,0,15052,6.4,16344,214,36,-3418,-3608,21.4,1505.2,blue,5.5,0.64,17,37,red
4500166392,3,6,1,1,1,0,0,15298,6.8,17728,233,64,-1317,-872,23.3,1529.8,6,3,11,0,0,0,0,16615,7,18600,204,60,1317,872,20.4,1661.5,red,0.67,5.67,15,20,blue
4457440450,5,3,7,1,1,0,0,15849,6.8,17178,220,43,1236,478,22,1584.9,3,5,6,0,0,0,0,14613,6.6,16700,202,55,-1236,-478,20.2,1461.3,blue,4,1.8,28,18,blue
4527168732,5,7,10,1,0,1,0,15793,6.4,16329,215,64,-1254,-293,21.5,1579.3,7,5,11,0,0,0,0,17047,6.8,16622,188,37,1254,293,18.8,1704.7,blue,2.14,3.6,22,20,red
4525121314,1,2,1,1,1,0,0,14392,6.6,17199,222,54,337,124,22.2,1439.2,2,1,2,0,0,0,0,14055,6.8,17075,197,52,-337,-124,19.7,1405.5,blue,1,4,16,15,blue
4486403546,6,4,6,0,0,0,0,15508,7,17029,193,42,-745,156,19.3,1550.8,4,6,3,1,1,0,0,16253,6.6,16873,250,40,745,-156,25,1625.3,red,3,1.17,17,19,red
4500454224,2,8,2,1,1,0,0,15467,7,18928,228,63,-2524,-376,22.8,1546.7,8,2,6,0,0,0,0,17991,7,19304,252,56,2524,376,25.2,1799.1,blue,0.5,7,16,16,red
4468830390,14,9,16,1,1,0,0,19904,7,18106,179,60,2685,1605,17.9,1990.4,9,14,7,0,0,0,0,17219,6.6,16501,205,44,-2685,-1605,20.5,1721.9,blue,3.33,1.14,27,21,red
4475483826,9,10,7,0,0,0,0,17206,6.8,16783,216,44,-621,-428,21.6,1720.6,10,9,10,0,0,0,0,17827,6.8,17211,211,42,621,428,21.1,1782.7,blue,1.6,2.22,17,17,red
4482162285,7,7,11,0,0,0,0,16600,7,18623,195,49,-335,262,19.5,1660,7,7,6,0,0,0,0,16935,7.2,18361,206,58,335,-262,20.6,1693.5,red,2.57,1.86,76,13,red
4526326403,5,6,5,1,1,0,0,16154,6.8,18329,235,42,-773,609,23.5,1615.4,6,5,8,1,0,1,0,16927,6.8,17720,201,48,773,-609,20.1,1692.7,blue,1.67,2.8,43,12,red
4505381555,5,7,12,1,1,0,0,15218,6.4,16410,198,44,-2060,-2850,19.8,1521.8,7,5,6,0,0,0,0,17278,7.2,19260,240,47,2060,2850,24,1727.8,red,2.43,2.6,16,19,red
4496853150,5,7,5,1,0,1,0,15135,6.6,17507,176,68,-2497,-1376,17.6,1513.5,7,5,9,1,1,0,0,17632,7.2,18883,231,68,2497,1376,23.1,1763.2,blue,1.43,3.2,14,15,blue
4472605223,3,6,1,0,0,0,0,14980,6.8,17697,210,59,-2958,-1627,21,1498,6,3,4,1,1,0,0,17938,7.2,19324,268,65,2958,1627,26.8,1793.8,red,0.67,3.33,15,47,red
4466967958,7,4,5,1,1,0,0,16283,7.2,19282,206,63,-30,1427,20.6,1628.3,4,7,5,0,0,0,0,16313,7,17855,217,48,30,-1427,21.7,1631.3,blue,3,1.29,19,16,red
4527110786,3,2,3,0,0,0,0,14706,6.6,15747,203,45,207,-1880,20.3,1470.6,2,3,1,0,0,0,0,14499,6.8,17627,242,54,-207,1880,24.2,1449.9,blue,3,1,48,20,red
4527059473,12,5,14,1,1,0,0,18508,7.4,18693,205,60,1442,322,20.5,1850.8,5,12,4,0,0,0,0,17066,7,18371,225,52,-1442,-322,22.5,1706.6,red,5.2,0.75,22,19,red
4477719459,5,6,7,1,0,1,1,18324,7.2,18932,227,68,2215,2315,22.7,1832.4,6,5,13,0,0,0,0,16109,6.6,16617,203,36,-2215,-2315,20.3,1610.9,red,2,3.8,21,20,blue
4486740435,4,13,2,0,0,0,0,14969,6.6,16183,208,43,-4486,-5334,20.8,1496.9,13,4,8,0,0,0,0,19455,7.6,21517,222,59,4486,5334,22.2,1945.5,red,0.46,5.25,15,25,red
4525969441,4,3,1,1,1,0,0,15116,7,18375,228,64,-434,673,22.8,1511.6,3,4,4,0,0,0,0,15550,7,17702,246,53,434,-673,24.6,1555,blue,1.67,1.75,21,25,red
4526523308,5,5,2,0,0,0,0,15752,7,18629,217,55,-717,8,21.7,1575.2,5,5,4,0,0,0,0,16469,7.2,18621,218,54,717,-8,21.8,1646.9,red,1.4,1.8,23,96,red
4473772500,10,3,14,1,0,1,0,19056,7.2,18501,233,43,4312,1000,23.3,1905.6,3,10,1,1,1,0,0,14744,6.8,17501,211,48,-4312,-1000,21.1,1474.4,red,8,0.4,109,19,blue
4489837555,5,4,7,1,1,0,0,16412,7.2,18935,223,44,980,1536,22.3,1641.2,4,5,5,0,0,0,0,15432,6.8,17399,232,38,-980,-1536,23.2,1543.2,red,3,1.8,43,17,red
4489653837,8,4,9,1,1,0,0,17773,7,19376,235,56,2898,1941,23.5,1777.3,4,8,4,0,0,0,0,14875,7,17435,181,57,-2898,-1941,18.1,1487.5,blue,4.25,1,18,37,blue
4476985915,3,5,4,0,0,0,0,14710,6.8,16797,227,34,-1799,-1942,22.7,1471,5,3,8,1,1,0,0,16509,7,18739,204,75,1799,1942,20.4,1650.9,red,1.4,4.33,45,23,red
4526251344,8,9,9,0,0,0,0,17543,7,18113,190,56,304,-302,19,1754.3,9,8,3,1,1,0,0,17239,7,18415,196,59,-304,302,19.6,1723.9,red,1.89,1.5,12,16,blue
4476720209,6,4,3,1,1,0,0,15981,7,18320,219,60,354,1465,21.9,1598.1,4,6,4,0,0,0,0,15627,6.6,16855,217,47,-354,-1465,21.7,1562.7,blue,2.25,1.33,18,23,red
4468743739,8,8,3,1,0,1,0,17570,7.2,19555,230,60,124,659,23,1757,8,8,10,1,1,0,0,17446,7,18896,215,59,-124,-659,21.5,1744.6,red,1.38,2.25,32,16,blue
4456176215,3,7,2,1,1,0,0,14505,6.8,17362,216,52,-4531,-2325,21.6,1450.5,7,3,8,1,0,1,1,19036,7.2,19687,252,58,4531,2325,25.2,1903.6,red,0.71,5,22,15,red
4446200696,5,7,5,1,0,1,1,17618,7.2,19203,225,63,1000,346,22.5,1761.8,7,5,7,1,1,0,0,16618,7,18857,199,52,-1000,-346,19.9,1661.8,red,1.43,2.8,16,14,red
4524793745,11,10,17,1,1,0,0,18858,7.4,19797,214,62,878,2182,21.4,1885.8,10,11,11,0,0,0,0,17980,6.8,17615,204,28,-878,-2182,20.4,1798,blue,2.8,1.91,18,17,red
4522643294,4,9,8,0,0,0,0,15400,6.6,16910,219,34,-2564,-1518,21.9,1540,9,4,10,0,0,0,0,17964,6.8,18428,229,56,2564,1518,22.9,1796.4,red,1.33,4.75,26,39,red
4456827660,8,5,13,1,1,0,0,17355,6.8,17548,204,39,1890,1473,20.4,1735.5,5,8,5,0,0,0,0,15465,6.4,16075,177,48,-1890,-1473,17.7,1546.5,blue,4.2,1.25,20,73,blue
4457100198,5,3,5,0,0,0,0,15999,7,18110,211,45,497,-743,21.1,1599.9,3,5,3,0,0,0,0,15502,7.2,18853,229,60,-497,743,22.9,1550.2,red,3.33,1.2,39,15,blue
4483595782,8,6,9,0,0,0,0,18262,7.2,19248,224,58,2537,2412,22.4,1826.2,6,8,6,1,1,0,0,15725,6.6,16836,208,41,-2537,-2412,20.8,1572.5,blue,2.83,1.5,23,20,blue
4523286020,6,7,4,1,1,0,0,15514,6.8,17211,185,52,-1640,-1839,18.5,1551.4,7,6,8,1,0,1,0,17154,7.2,19050,234,52,1640,1839,23.4,1715.4,red,1.43,2.5,24,14,blue
4525800444,9,3,11,0,0,0,0,16678,7,17929,201,42,1351,433,20.1,1667.8,3,9,6,1,1,0,0,15327,6.8,17496,228,62,-1351,-433,22.8,1532.7,blue,6.67,1,72,15,blue
4525204773,6,5,8,1,1,0,0,16660,6.8,17964,241,44,850,-98,24.1,1666,5,6,4,0,0,0,0,15810,7,18062,215,39,-850,98,21.5,1581,red,2.8,1.5,23,19,blue
4465375225,8,2,15,1,1,0,0,17392,7,18794,215,53,2865,2606,21.5,1739.2,2,8,3,0,0,0,0,14527,6.4,16188,225,52,-2865,-2606,22.5,1452.7,blue,11.5,0.62,14,17,red
4519991058,7,3,7,1,1,0,0,16674,7.2,18431,221,48,2176,1739,22.1,1667.4,3,7,3,0,0,0,0,14498,6.6,16692,212,35,-2176,-1739,21.2,1449.8,blue,4.67,0.86,39,15,blue
4468650585,5,9,4,1,1,0,0,15703,7,17235,210,44,-1678,-2431,21,1570.3,9,5,5,0,0,0,0,17381,7.4,19666,202,52,1678,2431,20.2,1738.1,red,1,2.8,210,15,blue
4495217197,5,0,4,1,1,0,0,16797,7.2,19788,268,55,2234,1897,26.8,1679.7,0,5,0,0,0,0,0,14563,6.8,17891,273,57,-2234,-1897,27.3,1456.3,blue,12.03,0,24,24,blue
4510761424,7,8,8,2,1,1,0,17606,6.8,17803,227,58,290,477,22.7,1760.6,8,7,13,0,0,0,0,17316,6.6,17326,232,37,-290,-477,23.2,1731.6,blue,1.88,3,22,23,blue
4477447417,6,9,7,0,0,0,0,15993,6.8,18112,226,48,-1607,-215,22.6,1599.3,9,6,13,1,1,0,0,17600,7,18327,217,56,1607,215,21.7,1760,blue,1.44,3.67,60,38,red
4525989643,7,5,7,0,0,0,0,16622,7.4,18996,206,60,753,2050,20.6,1662.2,5,7,6,1,1,0,0,15869,6.6,16946,213,49,-753,-2050,21.3,1586.9,blue,2.8,1.57,22,19,red
4497696872,6,4,6,0,0,0,0,15807,6.8,17244,221,33,239,1281,22.1,1580.7,4,6,3,1,1,0,0,15568,6.6,15963,213,44,-239,-1281,21.3,1556.8,red,3,1.17,18,18,red
4519502337,9,6,12,1,1,0,0,18555,7.2,19740,250,56,2976,1300,25,1855.5,6,9,6,0,0,0,0,15579,7,18440,207,48,-2976,-1300,20.7,1557.9,blue,3.5,1.33,21,19,red
4503465904,10,2,8,2,1,1,0,18826,7.2,19835,259,52,5616,3916,25.9,1882.6,2,10,2,0,0,0,0,13210,6.6,15919,184,36,-5616,-3916,18.4,1321,blue,9,0.4,22,19,blue
4515736487,4,8,3,0,0,0,0,14787,6.6,16543,185,60,-2404,-2013,18.5,1478.7,8,4,8,0,0,0,0,17191,7,18556,228,36,2404,2013,22.8,1719.1,red,0.88,4,24,20,red
4527053268,8,6,12,0,0,0,0,18675,7.6,20603,219,61,2125,2034,21.9,1867.5,6,8,5,1,1,0,0,16550,7,18569,222,64,-2125,-2034,22.2,1655,blue,3.33,1.38,46,17,blue
4506306912,7,5,7,1,1,0,0,17106,7.2,18424,231,48,450,-219,23.1,1710.6,5,7,5,1,0,1,0,16656,7,18643,241,62,-450,219,24.1,1665.6,blue,2.8,1.43,20,23,blue
4513247424,6,7,4,0,0,0,0,16956,7.2,19155,242,61,-172,594,24.2,1695.6,7,6,10,1,1,0,0,17128,7.2,18561,213,61,172,-594,21.3,1712.8,blue,1.43,2.83,25,20,blue
4523498928,2,9,1,0,0,0,0,13879,6.2,15363,185,48,-4267,-3389,18.5,1387.9,9,2,5,2,1,1,0,18146,7,18752,232,56,4267,3389,23.2,1814.6,red,0.33,7,9,17,red
4495323290,4,3,6,1,0,1,0,15164,7,17014,216,51,-185,-1101,21.6,1516.4,3,4,1,1,1,0,0,15349,7.2,18115,233,68,185,1101,23.3,1534.9,blue,3.33,1,17,15,red
4500110259,6,2,4,0,0,0,0,16849,7.4,19849,241,67,2094,2789,24.1,1684.9,2,6,3,0,0,0,0,14755,6.8,17060,208,56,-2094,-2789,20.8,1475.5,blue,5,0.83,21,18,blue
4506588820,6,8,6,1,0,1,1,16914,6.4,16785,184,42,302,-1958,18.4,1691.4,8,6,6,1,1,0,0,16612,7.2,18743,208,60,-302,1958,20.8,1661.2,blue,1.5,2.33,19,56,red
4500342902,7,7,10,1,1,0,0,16728,7,17494,231,36,102,65,23.1,1672.8,7,7,8,0,0,0,0,16626,6.6,17429,195,52,-102,-65,19.5,1662.6,red,2.43,2.14,19,29,red
4476043495,8,6,9,0,0,0,0,16694,6.8,17192,227,32,370,92,22.7,1669.4,6,8,6,1,1,0,0,16324,6.8,17100,213,48,-370,-92,21.3,1632.4,blue,2.83,1.5,16,36,red
4517507024,5,6,6,1,1,0,0,15826,6.8,17837,235,52,-1177,-1157,23.5,1582.6,6,5,4,0,0,0,0,17003,7.4,18994,242,49,1177,1157,24.2,1700.3,red,1.83,2,24,22,red
4437156744,5,13,6,1,1,0,0,15558,6.4,16462,203,47,-3180,-3271,20.3,1555.8,13,5,14,0,0,0,0,18738,7.4,19733,218,34,3180,3271,21.8,1873.8,red,0.85,5.4,27,40,red
4526838859,4,6,4,0,0,0,0,14053,6.6,16510,169,52,-3045,-810,16.9,1405.3,6,4,11,0,0,0,0,17098,6.8,17320,229,50,3045,810,22.9,1709.8,red,1.33,4.25,23,23,red
4514633280,14,11,14,0,0,0,0,20887,7,18795,215,32,2049,699,21.5,2088.7,11,14,11,2,1,1,0,18838,6.8,18096,191,58,-2049,-699,19.1,1883.8,red,2.55,1.57,50,173,red
4410019021,4,6,3,1,1,0,0,15373,6.4,16354,228,54,-1323,-1422,22.8,1537.3,6,4,5,0,0,0,0,16696,7,17776,216,59,1323,1422,21.6,1669.6,blue,1.17,2.75,24,22,blue
4467282089,8,4,6,1,0,1,0,17522,7.2,18612,257,42,2392,511,25.7,1752.2,4,8,1,0,0,0,0,15130,7,18101,222,69,-2392,-511,22.2,1513,blue,3.5,0.62,18,24,blue
4460835266,9,7,15,1,1,0,0,17088,7,17650,179,40,262,-229,17.9,1708.8,7,9,9,0,0,0,0,16826,7,17879,222,56,-262,229,22.2,1682.6,blue,3.43,1.78,18,19,red
4456181584,6,6,4,0,0,0,0,16968,7.2,18303,231,48,423,318,23.1,1696.8,6,6,8,2,1,1,0,16545,7,17985,219,48,-423,-318,21.9,1654.5,red,1.67,2.33,18,16,red
4502793197,10,5,10,0,0,0,0,17987,7.4,19698,232,52,1810,2115,23.2,1798.7,5,10,4,1,0,1,0,16177,6.8,17583,222,56,-1810,-2115,22.2,1617.7,blue,4,0.9,26,74,red
4526544646,6,7,8,1,1,0,0,16871,6.8,17798,263,40,-89,-144,26.3,1687.1,7,6,13,0,0,0,0,16960,7.2,17942,232,36,89,144,23.2,1696,blue,2,3.33,15,43,red
4473393506,11,4,13,1,1,0,0,19035,7.4,19600,207,52,4481,3872,20.7,1903.5,4,11,4,0,0,0,0,14554,6.4,15728,189,43,-4481,-3872,18.9,1455.4,blue,6,0.73,17,17,blue
4488853318,2,9,1,0,0,0,0,13380,6.2,14784,188,48,-4446,-3703,18.8,1338,9,2,10,1,1,0,0,17826,7.2,18487,233,44,4446,3703,23.3,1782.6,red,0.33,9.5,13,18,red
4468293476,3,3,4,0,0,0,0,15834,7,18253,248,52,324,-574,24.8,1583.4,3,3,3,2,1,1,0,15510,7.2,18827,220,68,-324,574,22,1551,blue,2.33,2,26,11,blue
4510832463,5,7,3,0,0,0,0,15209,6.8,16799,208,56,-1517,-1331,20.8,1520.9,7,5,8,0,0,0,0,16726,7,18130,229,52,1517,1331,22.9,1672.6,red,1.14,3,19,64,red
4469425272,3,2,6,1,1,0,0,16426,7,18180,236,64,2063,708,23.6,1642.6,2,3,6,0,0,0,0,14363,6.6,17472,210,40,-2063,-708,21,1436.3,blue,4.5,2.67,35,16,blue
4473941338,4,11,4,0,0,0,0,15358,6.8,17610,210,47,-3019,-848,21,1535.8,11,4,12,1,1,0,0,18377,7.2,18458,207,56,3019,848,20.7,1837.7,red,0.73,5.75,17,16,red
4497766397,6,7,2,0,0,0,0,15894,6.6,16813,205,48,-399,-868,20.5,1589.4,7,6,4,1,1,0,0,16293,7,17681,213,44,399,868,21.3,1629.3,red,1.14,1.83,20,23,blue
4511315940,2,2,1,1,1,0,0,14092,6.4,16918,201,49,-1999,-2041,20.1,1409.2,2,2,3,0,0,0,0,16091,7,18959,257,59,1999,2041,25.7,1609.1,blue,1.5,2.5,16,46,red
4524830174,10,2,18,1,1,0,0,17559,7,17788,217,24,3158,1518,21.7,1755.9,2,10,3,0,0,0,0,14401,6.4,16270,184,47,-3158,-1518,18.4,1440.1,blue,14,0.5,17,14,blue
4525115790,2,4,3,0,0,0,0,15847,7,17815,241,48,647,-710,24.1,1584.7,4,2,5,1,1,0,0,15200,7.2,18525,221,46,-647,710,22.1,1520,red,1.25,4.5,24,17,red
4486000436,3,9,4,1,1,0,0,15280,6.6,16614,220,50,-2034,-1071,22,1528,9,3,17,0,0,0,0,17314,6.8,17685,220,37,2034,1071,22,1731.4,red,0.78,8.67,20,24,red
4515427154,6,9,6,0,0,0,0,18187,7,18454,223,55,299,-1051,22.3,1818.7,9,6,7,1,0,1,0,17888,7.2,19505,215,60,-299,1051,21.5,1788.8,red,1.33,2.67,15,14,red
4500244269,5,5,4,1,0,1,0,15509,6.8,17265,220,40,-1335,-1142,22,1550.9,5,5,10,1,1,0,0,16844,7,18407,230,69,1335,1142,23,1684.4,red,1.8,3,40,16,blue
4474956980,6,3,7,1,1,0,0,16319,7.2,18982,207,59,1589,1075,20.7,1631.9,3,6,2,0,0,0,0,14730,6.6,17907,215,49,-1589,-1075,21.5,1473,blue,4.33,0.83,16,16,red
4515231062,4,9,4,1,1,0,0,14588,6.2,15647,207,45,-2627,-4080,20.7,1458.8,9,4,4,1,0,1,0,17215,7.4,19727,225,51,2627,4080,22.5,1721.5,red,0.89,3.25,19,38,red
4499863965,8,10,8,0,0,0,0,16748,6.8,16907,178,44,-1579,-1715,17.8,1674.8,10,8,8,1,1,0,0,18327,7.2,18622,215,66,1579,1715,21.5,1832.7,blue,1.6,2.25,13,20,red
4509741728,6,6,8,2,1,1,0,16516,7,17456,184,57,366,596,18.4,1651.6,6,6,7,0,0,0,0,16150,6.6,16860,221,48,-366,-596,22.1,1615,blue,2.33,2.17,18,22,red
4477615327,7,4,10,2,1,1,0,17256,7,18265,228,64,1177,226,22.8,1725.6,4,7,6,0,0,0,0,16079,6.8,18039,217,51,-1177,-226,21.7,1607.9,red,4.25,1.43,17,15,blue
4515404379,7,7,6,1,1,0,0,16396,7,18419,204,52,-2,866,20.4,1639.6,7,7,5,0,0,0,0,16398,6.8,17553,202,48,2,-866,20.2,1639.8,red,1.86,1.71,43,16,red
4526316157,4,13,3,0,0,0,0,14539,6.6,16271,165,53,-6139,-4548,16.5,1453.9,13,4,12,0,0,0,0,20678,7.6,20819,224,50,6139,4548,22.4,2067.8,red,0.54,6.25,13,61,red
4468400169,3,4,4,1,1,0,0,14657,6.6,17306,204,52,-987,-555,20.4,1465.7,4,3,4,0,0,0,0,15644,7,17861,246,51,987,555,24.6,1564.4,blue,1.75,2.67,18,25,red
4471975610,10,13,5,1,1,0,0,18656,7.2,19253,227,46,42,666,22.7,1865.6,13,10,14,0,0,0,0,18614,7,18587,211,36,-42,-666,21.1,1861.4,red,1.15,2.7,17,16,red
4524765561,5,7,6,1,1,0,1,16609,6.8,16960,216,33,-265,-2101,21.6,1660.9,7,5,3,0,0,0,0,16874,7.2,19061,225,70,265,2101,22.5,1687.4,red,1.57,2,18,17,blue
4526274055,4,8,7,1,1,0,0,15299,6.6,16493,196,48,-2489,-2828,19.6,1529.9,8,4,8,0,0,0,0,17788,7.4,19321,233,43,2489,2828,23.3,1778.8,red,1.38,4,17,40,red
4465134989,6,3,5,1,1,0,0,16942,7,18645,216,71,2032,2196,21.6,1694.2,3,6,3,0,0,0,0,14910,6.4,16449,210,48,-2032,-2196,21,1491,blue,3.67,1,29,89,blue
4471999593,6,3,3,0,0,0,0,15365,6.4,16848,186,44,-136,-385,18.6,1536.5,3,6,3,0,0,0,0,15501,6.6,17233,219,48,136,385,21.9,1550.1,red,3,1,19,22,red
4519724135,8,10,11,0,0,0,0,16052,6.4,15330,159,44,-1825,-1458,15.9,1605.2,10,8,14,1,1,0,0,17877,6.6,16788,213,41,1825,1458,21.3,1787.7,red,1.9,3,14,19,blue
4458421453,7,7,4,0,0,0,0,16875,7.2,18652,214,52,-191,533,21.4,1687.5,7,7,13,1,1,0,0,17066,7,18119,230,40,191,-533,23,1706.6,blue,1.57,2.86,28,18,red
4497697674,6,2,10,1,1,0,0,16623,7.2,18555,211,54,1792,-764,21.1,1662.3,2,6,2,1,0,1,0,14831,7,19319,223,72,-1792,764,22.3,1483.1,blue,8,0.67,21,16,blue
4506593398,8,6,11,2,1,1,0,16813,6.8,18065,200,52,70,508,20,1681.3,6,8,9,0,0,0,0,16743,6.8,17557,204,56,-70,-508,20.4,1674.3,blue,3.17,1.88,37,39,blue
4527001202,7,12,8,1,1,0,0,16763,7,17386,221,45,-1469,-2427,22.1,1676.3,12,7,10,0,0,0,0,18232,7.4,19813,214,44,1469,2427,21.4,1823.2,red,1.25,3.14,16,12,blue
4486327611,5,16,2,0,0,0,0,14603,6.4,15446,181,39,-6185,-2328,18.1,1460.3,16,5,20,1,1,0,1,20788,7,17774,195,29,6185,2328,19.5,2078.8,red,0.44,7.2,76,26,red
4475432693,10,4,11,1,1,0,0,18005,7,19501,210,60,2962,3043,21,1800.5,4,10,1,0,0,0,0,15043,6.6,16458,187,48,-2962,-3043,18.7,1504.3,blue,5.25,0.5,18,21,blue
4492524476,5,9,4,0,0,0,0,15274,6.6,17169,228,37,-2538,-1731,22.8,1527.4,9,5,8,1,1,0,0,17812,7.2,18900,219,59,2538,1731,21.9,1781.2,blue,1,3.4,21,25,red
4522440155,1,2,1,1,1,0,0,15216,7.2,18663,251,56,99,-174,25.1,1521.6,2,1,5,0,0,0,0,15117,7,18837,217,60,-99,174,21.7,1511.7,red,1,7,18,14,red
4518707192,8,3,10,1,1,0,0,17756,7.2,18394,231,43,2510,758,23.1,1775.6,3,8,3,0,0,0,0,15246,6.8,17636,218,68,-2510,-758,21.8,1524.6,blue,6,0.75,41,15,blue
4526832439,6,6,6,1,1,0,0,17476,7,18428,219,63,1408,957,21.9,1747.6,6,6,6,0,0,0,0,16068,6.8,17471,231,44,-1408,-957,23.1,1606.8,blue,2,2,18,19,red
4491140067,9,3,14,0,0,0,0,18017,7,18434,208,40,2917,930,20.8,1801.7,3,9,1,0,0,0,0,15100,6.8,17504,210,54,-2917,-930,21,1510,red,7.67,0.44,18,22,blue
4475394181,6,5,2,1,1,0,0,15531,7,17915,192,52,-537,176,19.2,1553.1,5,6,5,0,0,0,0,16068,6.8,17739,198,64,537,-176,19.8,1606.8,red,1.6,1.67,20,23,blue
4483792624,4,8,5,0,0,0,0,14799,6.8,16562,207,39,-3590,-3279,20.7,1479.9,8,4,9,1,1,0,0,18389,7.4,19841,259,56,3590,3279,25.9,1838.9,red,1.12,4.25,23,20,blue
4526372741,10,4,9,1,1,0,0,18009,7.4,19630,226,56,3026,1849,22.6,1800.9,4,10,1,0,0,0,0,14983,6.8,17781,205,51,-3026,-1849,20.5,1498.3,blue,4.75,0.5,13,39,blue
4484936763,5,8,7,0,0,0,0,16265,7,17407,217,56,-1195,-1492,21.7,1626.5,8,5,6,1,1,0,0,17460,7.2,18899,244,59,1195,1492,24.4,1746,red,1.5,2.8,16,20,red
4483500225,4,4,2,0,0,0,0,15023,6.8,17293,226,44,-814,-374,22.6,1502.3,4,4,4,1,0,1,0,15837,6.8,17667,232,47,814,374,23.2,1583.7,red,1.5,2,19,19,red
4454378934,9,8,12,0,0,0,0,17083,6.6,17538,183,33,67,-820,18.3,1708.3,8,9,5,1,1,0,0,17016,7,18358,225,44,-67,820,22.5,1701.6,red,2.62,1.44,22,18,blue
4527044797,5,10,5,0,0,0,0,15954,6.8,16521,192,56,-2527,-2193,19.2,1595.4,10,5,8,1,1,0,0,18481,7.4,18714,197,80,2527,2193,19.7,1848.1,red,1,3.6,15,17,red
4485840157,6,8,5,0,0,0,0,16892,7,18225,226,48,-44,277,22.6,1689.2,8,6,10,1,1,0,0,16936,7,17948,185,48,44,-277,18.5,1693.6,red,1.38,3,15,15,blue
4512836783,1,2,1,1,0,1,0,14583,6.6,17525,244,54,262,1643,24.4,1458.3,2,1,3,1,1,0,0,14321,6.4,15882,224,32,-262,-1643,22.4,1432.1,blue,1,5,25,20,red
4500382908,6,7,10,0,0,0,0,16802,6.8,17626,243,44,-1599,-1890,24.3,1680.2,7,6,12,0,0,0,0,18401,7.2,19516,237,58,1599,1890,23.7,1840.1,red,2.29,3.17,28,19,red
4479461412,8,9,8,0,0,0,0,16957,6.6,17005,220,28,-206,-1872,22,1695.7,9,8,5,0,0,0,0,17163,7.2,18877,204,48,206,1872,20.4,1716.3,red,1.78,1.75,15,15,blue
4472849009,5,6,5,2,1,1,0,15817,7,17992,218,43,-27,-371,21.8,1581.7,6,5,7,0,0,0,0,15844,7.2,18363,203,41,27,371,20.3,1584.4,red,1.67,2.6,23,21,blue
4527482253,5,11,5,0,0,0,0,17219,6.8,18160,241,59,-1213,-769,24.1,1721.9,11,5,14,0,0,0,0,18432,7.2,18929,183,56,1213,769,18.3,1843.2,red,0.91,5,12,55,blue
4525023714,4,7,5,1,1,0,0,15424,6.8,17357,211,44,-1933,-2906,21.1,1542.4,7,4,3,0,0,0,0,17357,7.6,20263,256,55,1933,2906,25.6,1735.7,red,1.29,2.5,60,15,blue
4508533364,8,8,9,1,0,1,0,16502,7,17726,198,45,342,-444,19.8,1650.2,8,8,8,1,1,0,0,16160,7,18170,195,48,-342,444,19.5,1616,blue,2.12,2,126,39,blue
4491827833,5,10,5,0,0,0,0,16324,6.8,17213,193,59,-943,-708,19.3,1632.4,10,5,13,1,1,0,0,17267,7,17921,174,60,943,708,17.4,1726.7,red,1,4.6,16,43,red
4497776955,2,4,0,0,0,0,0,14532,6.6,17477,217,52,-1021,-1439,21.7,1453.2,4,2,2,0,0,0,0,15553,7.2,18916,206,64,1021,1439,20.6,1555.3,red,0.5,3,89,13,red
4505239658,4,5,2,1,0,1,0,14644,6.8,17550,222,48,-1367,-412,22.2,1464.4,5,4,6,0,0,0,0,16011,7,17962,201,56,1367,412,20.1,1601.1,red,1.2,2.75,17,21,red
4460445038,5,7,3,1,0,1,0,16616,7,18633,211,67,-47,318,21.1,1661.6,7,5,10,1,1,0,0,16663,7,18315,219,56,47,-318,21.9,1666.3,red,1.14,3.4,34,15,red
4521826058,1,4,1,0,0,0,0,14754,6.6,16591,230,44,-1769,-845,23,1475.4,4,1,4,0,0,0,1,16523,7,17436,224,36,1769,845,22.4,1652.3,red,0.5,8,16,22,red
4514596262,2,7,2,0,0,0,0,14242,6.6,17184,212,50,-2954,-1250,21.2,1424.2,7,2,3,1,0,1,0,17196,7,18434,244,52,2954,1250,24.4,1719.6,red,0.57,5,51,20,red
4508289353,8,2,15,0,0,0,0,17083,7,18346,229,24,2877,1714,22.9,1708.3,2,8,1,1,1,0,0,14206,6.6,16632,212,45,-2877,-1714,21.2,1420.6,blue,11.5,0.38,18,16,red
4526805817,10,3,13,1,1,0,1,19716,7.6,20456,219,64,5656,3415,21.9,1971.6,3,10,1,0,0,0,0,14060,6.6,17041,222,50,-5656,-3415,22.2,1406,blue,7.67,0.4,15,14,blue
4520336674,10,4,13,1,1,0,0,18401,7.6,20273,236,60,3668,4509,23.6,1840.1,4,10,3,1,0,1,0,14733,6.6,15764,195,46,-3668,-4509,19.5,1473.3,blue,5.75,0.7,26,120,red
4447974687,7,9,6,2,1,1,0,17359,7.2,18754,221,69,1,-116,22.1,1735.9,9,7,6,0,0,0,0,17358,7,18870,221,42,-1,116,22.1,1735.8,red,1.44,2.14,21,22,blue
4467316184,7,6,4,1,1,0,1,17742,7,18795,203,64,2294,2616,20.3,1774.2,6,7,6,0,0,0,0,15448,6.6,16179,186,40,-2294,-2616,18.6,1544.8,blue,1.83,1.71,13,14,red
4502847039,2,4,1,1,1,0,0,14431,7,17984,194,70,-940,-43,19.4,1443.1,4,2,3,0,0,0,0,15371,6.8,18027,234,42,940,43,23.4,1537.1,blue,0.75,3.5,16,27,red
4410127520,9,3,9,0,0,0,0,18125,7.8,21102,236,48,2828,2738,23.6,1812.5,3,9,2,1,1,0,0,15297,7.2,18364,227,71,-2828,-2738,22.7,1529.7,blue,6,0.56,32,68,red
4477684980,6,8,6,0,0,0,0,17210,7,18131,220,72,1091,605,22,1721,8,6,10,0,0,0,0,16119,7,17526,178,32,-1091,-605,17.8,1611.9,blue,1.5,3,23,54,blue
4494648390,6,8,8,0,0,0,0,15697,6.8,16449,196,44,-1237,-285,19.6,1569.7,8,6,13,0,0,0,0,16934,6.4,16734,201,47,1237,285,20.1,1693.4,red,1.75,3.5,18,16,blue
4510873008,3,8,5,2,1,1,0,14591,6.2,15636,177,55,-2658,-3328,17.7,1459.1,8,3,9,0,0,0,0,17249,7,18964,209,52,2658,3328,20.9,1724.9,blue,1,5.67,13,43,red
4475515736,4,7,5,0,0,0,0,14488,6.4,16390,197,36,-3152,-2754,19.7,1448.8,7,4,7,1,1,0,0,17640,7.2,19144,196,84,3152,2754,19.6,1764,red,1.29,3.5,16,37,red
4490720316,9,6,12,0,0,0,0,18869,7,18526,206,74,4242,2348,20.6,1886.9,6,9,6,0,0,0,0,14627,6.6,16178,164,51,-4242,-2348,16.4,1462.7,blue,3.5,1.33,40,16,blue
4522686444,6,5,4,0,0,0,0,16682,7,18272,236,52,598,374,23.6,1668.2,5,6,5,1,1,0,0,16084,6.8,17898,235,60,-598,-374,23.5,1608.4,red,2,1.67,17,18,blue
4483425458,7,13,6,0,0,0,0,15898,5.8,14230,131,45,-2787,-4217,13.1,1589.8,13,7,10,2,1,1,0,18685,6.8,18447,224,50,2787,4217,22.4,1868.5,red,1,3.29,25,21,red
4496718092,6,10,2,0,0,0,0,15485,6.6,17335,191,55,-2650,-388,19.1,1548.5,10,6,10,1,1,0,0,18135,6.8,17723,201,40,2650,388,20.1,1813.5,red,0.8,3.33,15,15,red
4526112177,7,8,4,0,0,0,0,16667,7.4,18874,213,44,-692,-987,21.3,1666.7,8,7,6,1,1,0,0,17359,7.4,19861,245,56,692,987,24.5,1735.9,red,1.38,2,44,20,blue
4481856648,5,6,6,0,0,0,0,16182,7,17509,245,51,-667,-1046,24.5,1618.2,6,5,9,2,1,1,0,16849,7,18555,234,56,667,1046,23.4,1684.9,red,1.83,3,31,26,blue
4410060427,5,5,5,1,0,1,0,16574,7.2,19529,235,60,803,857,23.5,1657.4,5,5,6,1,1,0,0,15771,7.2,18672,204,64,-803,-857,20.4,1577.1,red,2,2.2,21,22,blue
4517859191,3,11,3,0,0,0,0,14595,6.4,15064,161,59,-3619,-4011,16.1,1459.5,11,3,9,1,1,0,0,18214,7.2,19075,222,54,3619,4011,22.2,1821.4,red,0.55,6.67,20,49,red
4444221942,9,4,13,0,0,0,0,18856,7.2,19293,236,45,3002,2378,23.6,1885.6,4,9,6,2,1,1,0,15854,6.8,16915,217,56,-3002,-2378,21.7,1585.4,red,5.5,1.11,19,14,red
4505284268,3,10,5,0,0,0,0,14826,6.6,16636,185,56,-3607,-2956,18.5,1482.6,10,3,12,1,1,0,0,18433,7.4,19592,257,41,3607,2956,25.7,1843.3,red,0.8,7.33,17,18,blue
4493848070,6,6,6,0,0,0,0,16237,7,18980,222,52,-958,-461,22.2,1623.7,6,6,6,2,1,1,0,17195,7.2,19441,232,65,958,461,23.2,1719.5,red,2,2,17,79,red
4522621799,8,5,6,2,1,1,1,18731,7,18165,225,48,2892,1413,22.5,1873.1,5,8,5,0,0,0,0,15839,6.4,16752,207,56,-2892,-1413,20.7,1583.9,blue,2.8,1.25,16,20,red
4462890794,5,5,2,2,1,1,0,15443,7,18156,220,47,-997,-226,22,1544.3,5,5,7,0,0,0,0,16440,7,18382,207,52,997,226,20.7,1644,blue,1.4,2.4,12,13,blue
4508148812,6,6,8,1,1,0,0,16820,6.8,17746,221,44,472,426,22.1,1682,6,6,7,0,0,0,0,16348,6.8,17320,185,55,-472,-426,18.5,1634.8,blue,2.33,2.17,17,16,red
4526758448,1,3,1,1,1,0,0,14997,7.2,17630,229,62,-465,-801,22.9,1499.7,3,1,3,0,0,0,0,15462,7,18431,219,58,465,801,21.9,1546.2,red,0.67,6,124,16,red
4496622570,7,8,3,1,0,1,0,16653,7,17618,227,40,23,306,22.7,1665.3,8,7,8,0,0,0,0,16630,7,17312,193,48,-23,-306,19.3,1663,blue,1.25,2.29,18,13,red
4458921343,9,2,9,1,0,1,0,17781,7.2,19251,228,60,3422,2271,22.8,1778.1,2,9,3,1,1,0,0,14359,6.6,16980,212,64,-3422,-2271,21.2,1435.9,red,9,0.56,15,14,red
4525953112,9,2,18,1,1,0,0,17936,7,18452,218,48,3350,1590,21.8,1793.6,2,9,2,0,0,0,0,14586,6.8,16862,213,58,-3350,-1590,21.3,1458.6,blue,13.5,0.44,23,18,blue
4520910762,3,3,3,1,1,0,0,16769,7.2,19760,257,76,1316,1233,25.7,1676.9,3,3,4,0,0,0,0,15453,7.2,18527,241,53,-1316,-1233,24.1,1545.3,blue,2,2.33,15,19,blue
4527318012,7,6,6,0,0,0,0,16714,7.4,19411,226,58,91,798,22.6,1671.4,6,7,5,0,0,0,0,16623,7.2,18613,252,46,-91,-798,25.2,1662.3,red,2.17,1.57,32,18,blue
4526279428,1,12,1,0,0,0,0,13517,6.4,15501,187,48,-5338,-5445,18.7,1351.7,12,1,13,1,0,1,0,18855,7.6,20946,243,43,5338,5445,24.3,1885.5,red,0.17,25,15,18,red
4524675236,5,5,1,0,0,0,0,15514,7,18750,217,58,-343,481,21.7,1551.4,5,5,5,1,1,0,0,15857,6.8,18269,204,46,343,-481,20.4,1585.7,blue,1.2,2,16,14,red
4484689883,5,5,5,1,1,0,0,16131,6.8,17436,223,48,874,818,22.3,1613.1,5,5,5,0,0,0,0,15257,6.6,16618,219,32,-874,-818,21.9,1525.7,red,2,2,17,17,red
4526519393,3,4,4,1,1,0,0,15613,7,17932,214,66,-468,-1321,21.4,1561.3,4,3,3,0,0,0,0,16081,7.2,19253,230,52,468,1321,23,1608.1,red,1.75,2.33,22,16,blue
4470019953,6,5,7,1,0,1,0,16678,7.2,19110,248,53,1401,1740,24.8,1667.8,5,6,6,1,1,0,0,15277,6.8,17370,233,34,-1401,-1740,23.3,1527.7,blue,2.6,1.83,20,22,blue
4525860458,6,2,7,0,0,0,0,17311,7,18763,257,52,2781,1229,25.7,1731.1,2,6,2,0,0,0,0,14530,6.8,17534,216,60,-2781,-1229,21.6,1453,blue,6.5,0.67,47,28,blue
4439121035,5,3,6,2,1,1,1,16703,6.8,17483,201,51,1051,612,20.1,1670.3,3,5,9,0,0,0,0,15652,6.8,16871,228,52,-1051,-612,22.8,1565.2,blue,3.67,2.4,37,49,blue
4514482057,2,19,0,0,0,0,0,12403,5.2,11921,152,28,-10329,-8531,15.2,1240.3,19,2,16,1,1,0,1,22732,7.6,20452,232,71,10329,8531,23.2,2273.2,red,0.11,17.5,12,14,red
4464561037,5,9,5,1,1,0,0,15585,6.6,16636,200,35,-2864,-3491,20,1558.5,9,5,8,0,0,0,0,18449,7.2,20127,224,71,2864,3491,22.4,1844.9,blue,1.11,3.4,22,21,blue
4464746011,8,4,6,1,1,0,0,16558,6.8,18174,238,36,241,-363,23.8,1655.8,4,8,6,0,0,0,0,16317,7,18537,222,66,-241,363,22.2,1631.7,blue,3.5,1.25,17,25,red
4491660542,8,6,7,1,0,1,1,18211,7.2,19027,204,52,1479,-198,20.4,1821.1,6,8,6,1,1,0,0,16732,7.4,19225,217,56,-1479,198,21.7,1673.2,red,2.5,1.5,17,12,blue
4525953219,7,7,6,1,1,0,0,15990,6.8,17803,190,50,-1425,-1068,19,1599,7,7,6,0,0,0,0,17415,7.2,18871,241,41,1425,1068,24.1,1741.5,red,1.86,1.86,20,11,blue
4489065955,4,12,8,0,0,0,0,15147,6.4,16605,188,50,-4559,-1851,18.8,1514.7,12,4,22,1,1,0,0,19706,7.2,18456,241,44,4559,1851,24.1,1970.6,blue,1,8.5,16,21,red
4495748526,8,5,12,2,1,1,0,17008,6.6,16893,203,44,1280,370,20.3,1700.8,5,8,5,0,0,0,0,15728,6.4,16523,245,42,-1280,-370,24.5,1572.8,red,4,1.25,55,20,red
4499426958,5,7,4,0,0,0,0,15538,6.8,16787,207,46,-707,-1088,20.7,1553.8,7,5,11,0,0,0,0,16245,6.8,17875,208,41,707,1088,20.8,1624.5,red,1.29,3.6,18,43,blue
4468449125,7,6,10,1,1,0,0,17097,7.2,18614,220,71,620,-328,22,1709.7,6,7,4,0,0,0,0,16477,7.2,18942,207,52,-620,328,20.7,1647.7,blue,2.83,1.43,20,16,blue
4495418857,6,7,7,0,0,0,0,17075,7,18491,234,44,1224,625,23.4,1707.5,7,6,4,2,1,1,0,15851,6.8,17866,221,48,-1224,-625,22.1,1585.1,blue,1.86,1.83,19,20,red
4521577993,7,9,6,0,0,0,0,16035,7,18455,180,55,-2691,-2196,18,1603.5,9,7,9,1,1,0,0,18726,7.6,20651,243,63,2691,2196,24.3,1872.6,red,1.44,2.57,18,18,red
4480393322,8,3,10,1,1,0,0,17967,7,18074,240,43,3039,712,24,1796.7,3,8,3,0,0,0,0,14928,6.8,17362,211,53,-3039,-712,21.1,1492.8,blue,6,0.75,19,19,blue
4489783029,8,9,9,0,0,0,0,17273,7,18297,208,56,381,1571,20.8,1727.3,9,8,9,0,0,0,0,16892,6.8,16726,181,40,-381,-1571,18.1,1689.2,blue,1.89,2.25,18,17,blue
4468657792,1,1,2,2,1,1,0,14546,7,17721,232,60,305,-443,23.2,1454.6,1,1,1,0,0,0,0,14241,7.2,18164,203,68,-305,443,20.3,1424.1,blue,3,2,17,20,blue
4515611996,2,2,4,1,1,0,0,14639,6.6,17316,237,44,-1767,-2080,23.7,1463.9,2,2,3,0,0,0,0,16406,7,19396,258,70,1767,2080,25.8,1640.6,blue,3,2.5,21,44,red
4520570110,9,8,3,0,0,0,0,16882,7.4,18988,191,57,-1261,1286,19.1,1688.2,8,9,9,0,0,0,0,18143,6.8,17702,238,40,1261,-1286,23.8,1814.3,red,1.5,1.89,17,19,red
4522596231,9,4,11,0,0,0,1,20170,7.2,19190,257,54,5619,3506,25.7,2017,4,9,5,1,1,0,0,14551,6.4,15684,198,44,-5619,-3506,19.8,1455.1,blue,5,1,20,20,blue
4460730840,13,4,16,1,1,0,0,20029,7.4,20123,213,54,6445,4988,21.3,2002.9,4,13,4,0,0,0,0,13584,6,15135,176,29,-6445,-4988,17.6,1358.4,blue,7.25,0.62,29,19,blue
4525587763,9,4,8,0,0,0,0,17260,7,19375,197,60,1463,1277,19.7,1726,4,9,4,0,0,0,0,15797,7,18098,203,52,-1463,-1277,20.3,1579.7,blue,4.25,0.89,14,16,blue
4458431377,11,3,4,0,0,0,0,18192,7.2,19823,221,50,2639,1711,22.1,1819.2,3,11,2,0,0,0,0,15553,7,18112,230,49,-2639,-1711,23,1555.3,blue,5,0.45,17,14,blue
4455400959,8,3,13,0,0,0,0,17325,7,18380,217,26,3454,2249,21.7,1732.5,3,8,3,1,1,0,0,13871,6.8,16131,193,48,-3454,-2249,19.3,1387.1,blue,7,0.75,38,14,blue
4516564229,5,9,3,0,0,0,0,16163,6.8,18244,218,60,-1828,-1410,21.8,1616.3,9,5,17,1,0,1,0,17991,7.2,19654,235,54,1828,1410,23.5,1799.1,red,0.89,5.2,13,15,red
4387776096,7,13,6,0,0,0,0,16039,6.8,16809,179,46,-2168,-2823,17.9,1603.9,13,7,9,1,1,0,0,18207,7.4,19632,185,46,2168,2823,18.5,1820.7,red,1,3.14,18,17,blue
4419869178,6,7,3,1,0,1,0,15907,7.2,17910,206,55,-112,727,20.6,1590.7,7,6,9,0,0,0,0,16019,6.8,17183,211,44,112,-727,21.1,1601.9,blue,1.29,2.67,18,20,blue
4508860669,7,2,10,1,0,1,0,17536,7.4,19146,211,63,4003,3255,21.1,1753.6,2,7,1,0,0,0,0,13533,6.4,15891,204,48,-4003,-3255,20.4,1353.3,red,8.5,0.43,45,17,blue
4498323673,11,11,16,0,0,0,0,18730,7,18011,208,38,175,-532,20.8,1873,11,11,14,1,1,0,0,18555,7,18543,219,81,-175,532,21.9,1855.5,red,2.45,2.27,22,22,blue
4471385992,6,2,5,1,1,0,0,16105,7.2,18285,223,56,2275,1667,22.3,1610.5,2,6,2,0,0,0,0,13830,6.8,16618,204,39,-2275,-1667,20.4,1383,blue,5.5,0.67,26,54,blue
4510612584,4,3,1,1,1,0,0,15843,6.8,17751,243,46,1301,1123,24.3,1584.3,3,4,6,0,0,0,0,14542,6.6,16628,205,40,-1301,-1123,20.5,1454.2,blue,1.67,2.25,15,15,blue
4526837498,10,0,14,1,1,0,0,20302,7,18149,212,52,7577,2363,21.2,2030.2,0,10,0,0,0,0,0,12725,6.6,15786,165,48,-7577,-2363,16.5,1272.5,blue,12.03,0,24,20,blue
4516544412,10,4,9,1,0,1,2,20236,7,18603,257,36,6161,5326,25.7,2023.6,4,10,6,1,1,0,0,14075,5.8,13277,146,40,-6161,-5326,14.6,1407.5,blue,4.75,1,20,13,red
4506260681,10,9,12,2,1,1,0,17869,6.8,17341,193,46,664,515,19.3,1786.9,9,10,9,0,0,0,0,17205,6.6,16826,202,37,-664,-515,20.2,1720.5,blue,2.44,1.8,25,25,blue
4483620406,3,6,1,1,0,1,0,14499,7,18406,201,68,-3079,-1816,20.1,1449.9,6,3,4,1,1,0,0,17578,7.2,20222,245,63,3079,1816,24.5,1757.8,red,0.67,3.33,21,17,red
4471057382,3,9,3,0,0,0,0,13705,6.4,16018,184,40,-4651,-3870,18.4,1370.5,9,3,8,1,1,0,0,18356,7.2,19888,223,71,4651,3870,22.3,1835.6,red,0.67,5.67,19,17,red
4522487757,2,7,1,0,0,0,0,13685,6.6,16729,182,52,-4011,-2271,18.2,1368.5,7,2,6,2,1,1,0,17696,7.2,19000,243,62,4011,2271,24.3,1769.6,red,0.43,6.5,23,21,red
4524367614,5,10,6,0,0,0,0,15366,6.8,16496,200,40,-2698,-2969,20,1536.6,10,5,8,2,1,1,0,18064,7.2,19465,221,52,2698,2969,22.1,1806.4,blue,1.1,3.6,13,17,blue
4456973095,0,4,0,1,0,1,0,14175,6.6,17400,234,60,-1769,-2076,23.4,1417.5,4,0,6,1,1,0,0,15944,7.4,19476,249,56,1769,2076,24.9,1594.4,red,0,12.65,16,19,red
4476153650,6,5,11,1,1,0,0,15975,6.6,16937,197,46,-166,-337,19.7,1597.5,5,6,4,0,0,0,0,16141,6.8,17274,231,39,166,337,23.1,1614.1,red,3.4,1.5,59,23,red
4494291659,1,7,2,0,0,0,0,13099,5.8,14520,191,28,-3521,-4416,19.1,1309.9,7,1,8,1,1,0,0,16620,7.2,18936,247,44,3521,4416,24.7,1662,red,0.43,15,13,16,blue
4458373823,3,0,0,1,1,0,0,15578,7.4,19730,249,64,611,1554,24.9,1557.8,0,3,0,0,0,0,0,14967,6.8,18176,245,59,-611,-1554,24.5,1496.7,blue,12.03,0,22,15,blue
4525383403,2,13,1,0,0,0,0,14218,6.2,15368,200,49,-4511,-4211,20,1421.8,13,2,18,1,1,0,0,18729,7.4,19579,213,44,4511,4211,21.3,1872.9,red,0.23,15.5,13,20,blue
4472012387,2,7,2,0,0,0,0,15198,7,18952,231,67,-1157,-84,23.1,1519.8,7,2,9,1,1,0,0,16355,7.4,19036,211,48,1157,84,21.1,1635.5,blue,0.57,8,17,14,blue
4526047622,7,2,8,0,0,0,0,17474,7.4,19214,238,52,3295,2840,23.8,1747.4,2,7,3,0,0,0,0,14179,6.6,16374,229,36,-3295,-2840,22.9,1417.9,blue,7.5,0.71,14,17,blue
4464534299,9,3,13,1,0,1,0,17786,7.4,19357,235,52,3090,1008,23.5,1778.6,3,9,2,1,1,0,0,14696,7.2,18349,215,60,-3090,-1008,21.5,1469.6,blue,7.33,0.56,18,20,blue
4480350578,7,3,6,0,0,0,0,17082,7.2,19192,224,59,2388,1600,22.4,1708.2,3,7,2,1,1,0,0,14694,7,17592,224,49,-2388,-1600,22.4,1469.4,blue,4.33,0.71,19,38,blue
4485783788,4,4,6,0,0,0,0,15711,7.4,19278,210,57,-204,1135,21,1571.1,4,4,4,1,1,0,0,15915,7,18143,229,58,204,-1135,22.9,1591.5,red,2.5,2,15,19,blue
4473966825,4,4,6,1,1,0,0,16112,7.2,18545,240,62,451,1068,24,1611.2,4,4,2,0,0,0,0,15661,7,17477,236,53,-451,-1068,23.6,1566.1,blue,2.5,1.5,41,15,red
4526382734,4,8,4,0,0,0,0,15700,7.2,17892,190,59,-2943,-1203,19,1570,8,4,6,2,1,1,1,18643,7.2,19095,225,45,2943,1203,22.5,1864.3,red,1,3.5,13,15,red
4522483751,8,8,9,0,0,0,0,17885,7,18417,209,52,1419,557,20.9,1788.5,8,8,7,1,1,0,0,16466,7,17860,187,47,-1419,-557,18.7,1646.6,blue,2.12,1.88,45,14,blue
4475134384,2,3,2,0,0,0,0,15705,6.6,17630,230,57,856,-268,23,1570.5,3,2,6,1,1,0,0,14849,7,17898,219,56,-856,268,21.9,1484.9,blue,1.33,4.5,32,136,blue
4452362820,0,8,0,0,0,0,0,13364,6.6,16851,203,63,-5088,-3911,20.3,1336.4,8,0,8,2,1,1,0,18452,7.6,20762,259,60,5088,3911,25.9,1845.2,red,0,12.65,14,19,red
4454677034,8,11,9,1,0,1,0,17080,7.2,18330,196,41,-2247,-1938,19.6,1708,11,8,6,0,0,0,0,19327,7.4,20268,227,60,2247,1938,22.7,1932.7,red,1.55,2.12,19,19,red
4455218616,11,2,15,0,0,0,0,17395,6.8,17215,170,40,3298,1038,17,1739.5,2,11,1,0,0,0,0,14097,6.6,16177,210,44,-3298,-1038,21,1409.7,blue,13,0.27,14,18,blue
4526234148,8,7,6,1,0,1,0,17498,7.2,19132,240,34,744,927,24,1749.8,7,8,7,0,0,0,0,16754,7.2,18205,199,47,-744,-927,19.9,1675.4,blue,2,1.75,23,24,red
4517196528,6,4,4,0,0,0,0,17649,7.4,19655,276,50,2194,2684,27.6,1764.9,4,6,3,1,1,0,0,15455,6.8,16971,221,58,-2194,-2684,22.1,1545.5,blue,2.5,1.17,13,14,red
4517734414,10,2,5,1,1,0,0,18717,7.4,20051,247,57,4865,4641,24.7,1871.7,2,10,4,0,0,0,0,13852,6.6,15410,191,32,-4865,-4641,19.1,1385.2,blue,7.5,0.6,13,15,blue
4503773782,4,4,5,1,1,0,0,15736,7.2,18719,231,56,131,1381,23.1,1573.6,4,4,4,0,0,0,0,15605,7,17338,246,43,-131,-1381,24.6,1560.5,blue,2.25,2,41,15,blue
4410686846,3,12,1,0,0,0,0,13800,6.4,15275,165,44,-4921,-2826,16.5,1380,12,3,16,1,1,0,0,18721,7,18101,208,60,4921,2826,20.8,1872.1,red,0.33,9.33,21,20,red
4526094722,7,8,6,0,0,0,0,15772,6.8,17144,204,40,-1502,-429,20.4,1577.2,8,7,11,2,1,1,0,17274,6.8,17573,225,44,1502,429,22.5,1727.4,red,1.62,2.71,20,19,red
4526825925,7,7,5,1,1,0,0,16825,7.4,19699,229,48,389,1652,22.9,1682.5,7,7,8,1,0,1,0,16436,7,18047,194,47,-389,-1652,19.4,1643.6,blue,1.71,2.14,22,43,blue
4526662466,7,5,8,1,0,1,0,17315,6.8,18122,229,50,1792,217,22.9,1731.5,5,7,8,1,1,0,0,15523,6.8,17905,226,47,-1792,-217,22.6,1552.3,red,3,1.86,15,42,blue
4519524460,2,4,1,0,0,0,0,14144,6.8,17041,208,42,-1122,-643,20.8,1414.4,4,2,1,1,1,0,0,15266,6.8,17684,230,46,1122,643,23,1526.6,red,0.75,2.5,19,20,red
4526148132,5,4,4,1,1,0,0,16328,6.8,17531,223,62,1192,836,22.3,1632.8,4,5,4,0,0,0,0,15136,6.4,16695,219,52,-1192,-836,21.9,1513.6,blue,2.25,1.6,16,18,blue
4510326831,3,5,3,0,0,0,0,15135,7,17610,213,59,-1161,-1685,21.3,1513.5,5,3,8,0,0,0,0,16296,7.4,19295,251,58,1161,1685,25.1,1629.6,blue,1.2,4.33,20,21,blue
4525621331,9,6,10,0,0,0,0,17719,7,18085,215,44,618,-308,21.5,1771.9,6,9,7,1,1,0,0,17101,7.2,18393,213,84,-618,308,21.3,1710.1,red,3.17,1.44,23,19,red
4527165791,8,8,12,0,0,0,0,16291,6.4,16508,180,33,-870,-1348,18,1629.1,8,8,11,1,1,0,0,17161,7,17856,207,46,870,1348,20.7,1716.1,red,2.5,2.38,25,39,blue
4521180315,5,6,3,1,0,1,0,15048,6.6,16313,209,47,-2099,-2717,20.9,1504.8,6,5,6,1,1,0,0,17147,7.4,19030,239,55,2099,2717,23.9,1714.7,red,1.33,2.4,17,18,blue
4513313637,2,4,1,0,0,0,0,14155,6.6,16974,226,46,-1735,-1786,22.6,1415.5,4,2,3,1,1,0,0,15890,7,18760,258,59,1735,1786,25.8,1589,red,0.75,3.5,19,20,red
4459784621,5,9,4,0,0,0,0,15102,6.8,18032,174,68,-5691,-2006,17.4,1510.2,9,5,8,2,1,1,2,20793,7.4,20038,226,56,5691,2006,22.6,2079.3,red,1,3.4,12,16,red
4485854145,6,13,7,0,0,0,0,15522,6.8,16999,182,55,-3819,-2264,18.2,1552.2,13,6,16,1,1,0,0,19341,7.2,19263,220,40,3819,2264,22,1934.1,red,1,4.83,18,18,red
4489994401,11,6,12,1,0,1,0,17850,7.4,18858,204,64,1926,3729,20.4,1785,6,11,8,1,1,0,0,15924,6.4,15129,167,39,-1926,-3729,16.7,1592.4,blue,3.83,1.27,23,17,red
4513778272,8,8,8,1,1,0,0,16720,6.8,16905,181,48,-1884,-2885,18.1,1672,8,8,4,0,0,0,0,18604,7.4,19790,248,66,1884,2885,24.8,1860.4,red,2,1.5,14,16,blue
4475476612,8,7,5,0,0,0,0,17321,7.6,19677,238,48,703,477,23.8,1732.1,7,8,6,1,1,0,0,16618,7.2,19200,212,68,-703,-477,21.2,1661.8,blue,1.86,1.62,163,16,red
4502735326,7,6,7,0,0,0,0,16672,7,18698,210,58,-521,860,21,1667.2,6,7,11,1,1,0,0,17193,7,17838,250,48,521,-860,25,1719.3,blue,2.33,2.43,17,17,blue
4526608631,2,1,3,1,1,0,0,15426,7.4,19072,230,79,711,1245,23,1542.6,1,2,1,0,0,0,0,14715,6.8,17827,255,54,-711,-1245,25.5,1471.5,blue,5,1,23,18,blue
4472905174,6,3,4,1,1,0,0,16404,7,19029,246,43,736,1019,24.6,1640.4,3,6,4,0,0,0,0,15668,6.8,18010,203,73,-736,-1019,20.3,1566.8,blue,3.33,1.17,20,18,blue
4527426713,11,3,14,1,1,0,0,18293,7.2,19481,218,52,2685,1151,21.8,1829.3,3,11,4,0,0,0,0,15608,7,18330,228,55,-2685,-1151,22.8,1560.8,blue,8.33,0.64,25,24,red
4526326638,5,7,4,1,1,0,0,16605,7,17961,207,69,31,-189,20.7,1660.5,7,5,7,0,0,0,0,16574,7,18150,207,63,-31,189,20.7,1657.4,red,1.29,2.8,87,19,blue
4492351873,10,10,8,0,0,0,1,18544,6.4,17072,182,60,1060,7,18.2,1854.4,10,10,11,1,1,0,0,17484,6.8,17065,174,36,-1060,-7,17.4,1748.4,red,1.8,2.1,15,41,blue
4438396733,12,5,14,1,1,0,0,18499,7,17823,210,36,3473,2812,21,1849.9,5,12,6,0,0,0,0,15026,6.2,15011,204,20,-3473,-2812,20.4,1502.6,blue,5.2,0.92,20,16,blue
4509930075,6,3,10,0,0,0,0,16911,6.8,17876,224,44,1913,842,22.4,1691.1,3,6,3,1,1,0,0,14998,6.8,17034,222,55,-1913,-842,22.2,1499.8,blue,5.33,1,16,17,blue
4512073832,7,6,12,0,0,0,0,16963,7,17857,212,45,707,730,21.2,1696.3,6,7,7,0,0,0,0,16256,6.6,17127,200,50,-707,-730,20,1625.6,blue,3.17,1.86,18,15,blue
4520909804,9,5,3,2,1,1,0,17669,7.4,20105,218,64,2227,2792,21.8,1766.9,5,9,4,0,0,0,0,15442,6.8,17313,203,40,-2227,-2792,20.3,1544.2,blue,2.4,1,43,17,blue
4500305709,6,10,8,1,1,0,0,15875,7,18029,191,60,-2901,-1904,19.1,1587.5,10,6,8,0,0,0,0,18776,7.2,19933,230,56,2901,1904,23,1877.6,red,1.4,3,17,18,red
4486211322,5,4,4,0,0,0,0,16273,7.2,19371,241,48,1161,2387,24.1,1627.3,4,5,3,1,1,0,0,15112,6.6,16984,224,44,-1161,-2387,22.4,1511.2,red,2.25,1.4,39,15,red
4515529980,4,8,7,1,0,1,0,15848,6.6,17347,238,56,-1845,-606,23.8,1584.8,8,4,14,1,1,0,0,17693,6.8,17953,224,60,1845,606,22.4,1769.3,red,1.38,5.5,60,18,red
4496506174,4,5,4,1,1,0,0,15297,6.6,17644,201,48,-502,-413,20.1,1529.7,5,4,7,0,0,0,0,15799,7,18057,209,52,502,413,20.9,1579.9,red,1.6,3,15,23,red
4521580366,6,10,5,1,0,1,0,16406,7,17714,208,55,-1530,-988,20.8,1640.6,10,6,10,1,1,0,0,17936,7,18702,224,56,1530,988,22.4,1793.6,red,1.1,3.33,35,18,red
4519393462,8,11,7,0,0,0,0,17509,7.2,18038,234,28,-2118,-2158,23.4,1750.9,11,8,9,1,1,0,0,19627,7.4,20196,209,89,2118,2158,20.9,1962.7,red,1.36,2.5,14,13,blue
4505404755,4,4,5,1,1,0,0,15398,6.8,17802,200,60,-893,771,20,1539.8,4,4,4,0,0,0,1,16291,6.8,17031,212,36,893,-771,21.2,1629.1,blue,2.25,2,14,17,red
4467567796,9,8,10,2,1,1,0,17431,6.8,18061,178,60,253,-121,17.8,1743.1,8,9,6,0,0,0,0,17178,7,18182,224,56,-253,121,22.4,1717.8,red,2.38,1.56,19,15,blue
4508088834,9,0,7,1,1,0,0,18968,7.6,20401,239,56,5344,3793,23.9,1896.8,0,9,0,0,0,0,0,13624,6.4,16608,225,51,-5344,-3793,22.5,1362.4,blue,12.03,0,90,15,blue
4480357961,4,5,5,1,0,1,0,16318,6.6,17365,218,48,-326,315,21.8,1631.8,5,4,9,1,1,0,0,16644,6.8,17050,209,51,326,-315,20.9,1664.4,red,1.8,3.5,24,20,red
4436976598,13,6,11,0,0,0,0,18896,7.4,19340,198,55,2663,1537,19.8,1889.6,6,13,5,1,1,0,0,16233,6.8,17803,201,52,-2663,-1537,20.1,1623.3,blue,4,0.85,15,20,blue
4487018877,5,8,4,1,1,0,0,15964,6.8,17011,204,53,-1399,-1727,20.4,1596.4,8,5,7,0,0,0,0,17363,7.2,18738,217,49,1399,1727,21.7,1736.3,blue,1.12,3,20,54,blue
4500167662,6,7,7,2,1,1,0,15924,6.8,16695,184,64,-903,-729,18.4,1592.4,7,6,8,0,0,0,0,16827,7,17424,215,29,903,729,21.5,1682.7,red,1.86,2.5,17,13,red
4516664706,4,7,2,1,1,0,0,15190,7,18507,215,61,-2134,-339,21.5,1519,7,4,8,1,0,1,0,17324,7,18846,227,48,2134,339,22.7,1732.4,red,0.86,3.75,20,18,red
4503387883,6,0,8,1,1,0,0,17482,7.2,19196,216,65,3781,3184,21.6,1748.2,0,6,0,0,0,0,0,13701,6.4,16012,223,56,-3781,-3184,22.3,1370.1,blue,12.03,0,19,19,blue
4496152088,2,4,1,1,1,0,0,14492,7,16869,211,57,-611,-1958,21.1,1449.2,4,2,3,0,0,0,0,15103,7.2,18827,230,57,611,1958,23,1510.3,blue,0.75,3.5,14,25,blue
4507750551,8,2,8,0,0,0,0,17055,7,17638,225,34,2603,1105,22.5,1705.5,2,8,0,1,1,0,0,14452,6.8,16533,238,44,-2603,-1105,23.8,1445.2,blue,8,0.25,17,21,blue
4452482397,4,4,3,0,0,0,0,14559,6.8,17491,191,44,-1348,-10,19.1,1455.9,4,4,6,1,0,1,0,15907,6.6,17501,202,54,1348,10,20.2,1590.7,blue,1.75,2.5,19,93,blue
4494104479,6,11,4,0,0,0,0,15838,7,18031,204,52,-2468,-1853,20.4,1583.8,11,6,9,1,1,0,0,18306,7.4,19884,219,80,2468,1853,21.9,1830.6,red,0.91,3.33,80,91,red
4525301191,6,8,6,0,0,0,0,16047,6.8,18460,250,32,-518,-268,25,1604.7,8,6,3,2,1,1,0,16565,7.2,18728,211,47,518,268,21.1,1656.5,blue,1.5,1.83,14,19,red
4523445811,6,4,6,0,0,0,0,16513,7.2,18896,241,48,752,1146,24.1,1651.3,4,6,6,1,1,0,0,15761,7,17750,216,51,-752,-1146,21.6,1576.1,red,3,1.67,18,18,blue
4456684874,4,9,2,0,0,0,0,15445,6.6,17280,222,51,-1775,-2698,22.2,1544.5,9,4,6,1,0,1,0,17220,7.4,19978,228,38,1775,2698,22.8,1722,red,0.67,3.75,18,17,red
4501067949,9,2,11,0,0,0,0,18124,7.4,19613,213,48,4232,3448,21.3,1812.4,2,9,0,0,0,0,0,13892,6.6,16165,205,52,-4232,-3448,20.5,1389.2,blue,10,0.22,82,57,blue
4473134497,3,11,4,0,0,0,0,14268,6.4,15723,213,42,-4962,-2384,21.3,1426.8,11,3,14,0,0,0,0,19230,7,18107,216,56,4962,2384,21.6,1923,red,0.64,8.33,19,17,red
4503192981,6,5,5,1,0,1,0,16000,6.8,17778,206,60,379,406,20.6,1600,5,6,5,1,1,0,0,15621,6.8,17372,214,44,-379,-406,21.4,1562.1,blue,2.2,1.67,21,17,red
4474405300,6,6,3,0,0,0,0,15040,6.8,17558,184,37,-2006,-101,18.4,1504,6,6,5,0,0,0,0,17046,6.8,17659,236,43,2006,101,23.6,1704.6,red,1.5,1.83,18,21,red
4477447831,6,5,8,1,1,0,0,15416,6.8,17061,199,55,-1342,-713,19.9,1541.6,5,6,7,0,0,0,0,16758,6.8,17774,248,50,1342,713,24.8,1675.8,blue,2.8,2,23,38,red
4504683209,7,6,9,1,1,0,0,17844,7.2,18825,232,56,1037,111,23.2,1784.4,6,7,5,0,0,0,0,16807,7.2,18714,243,55,-1037,-111,24.3,1680.7,red,2.67,1.57,17,14,blue
4520030026,5,4,9,2,1,1,0,16455,7.2,17798,229,44,1844,1397,22.9,1645.5,4,5,6,0,0,0,0,14611,6.6,16401,213,36,-1844,-1397,21.3,1461.1,red,3.5,2,16,23,blue
4511605459,6,2,8,1,1,0,0,17368,7.2,18140,252,56,3524,2086,25.2,1736.8,2,6,2,0,0,0,0,13844,6.4,16054,195,54,-3524,-2086,19.5,1384.4,blue,7,0.67,19,16,blue
4482504692,7,2,5,0,0,0,0,16503,7,19371,218,51,2169,2322,21.8,1650.3,2,7,4,1,1,0,0,14334,6.6,17049,220,56,-2169,-2322,22,1433.4,red,6,0.86,20,18,red
4526364415,5,6,4,1,1,0,0,15063,6.6,16316,198,43,-1547,-1049,19.8,1506.3,6,5,3,0,0,0,0,16610,6.8,17365,229,40,1547,1049,22.9,1661,blue,1.5,1.8,18,20,blue
4524539386,6,4,12,1,1,0,0,17733,7.2,19290,221,59,1995,2344,22.1,1773.3,4,6,6,0,0,0,0,15738,6.8,16946,225,44,-1995,-2344,22.5,1573.8,blue,4.5,1.67,26,45,blue
4513287361,4,3,5,0,0,0,0,15720,7,18012,224,50,1146,1440,22.4,1572,3,4,3,1,1,0,0,14574,6.8,16572,211,53,-1146,-1440,21.1,1457.4,blue,3,1.5,18,17,blue
4475435726,5,3,9,2,1,1,0,16457,7,17837,228,68,1418,716,22.8,1645.7,3,5,2,0,0,0,0,15039,6.4,17121,238,40,-1418,-716,23.8,1503.9,blue,4.67,1,20,22,red
4448657505,8,7,8,1,1,0,0,17526,7.2,18287,220,45,307,-269,22,1752.6,7,8,7,0,0,0,0,17219,7.2,18556,225,52,-307,269,22.5,1721.9,blue,2.29,1.75,133,45,blue
4515483154,8,5,8,1,1,0,0,17204,7.2,19878,215,66,803,2597,21.5,1720.4,5,8,7,0,0,0,0,16401,6.8,17281,216,53,-803,-2597,21.6,1640.1,blue,3.2,1.5,35,18,red
4527082240,4,1,5,2,1,1,0,16973,7.2,19798,271,72,2420,2428,27.1,1697.3,1,4,2,0,0,0,0,14553,6.6,17370,247,48,-2420,-2428,24.7,1455.3,blue,9,0.75,18,16,blue
4520727484,1,5,1,0,0,0,0,12713,6,14245,192,23,-2976,-2255,19.2,1271.3,5,1,8,2,1,1,0,15689,6.6,16500,237,44,2976,2255,23.7,1568.9,red,0.4,13,19,15,blue
4526939278,8,8,8,0,0,0,0,16488,6.8,17583,217,47,-451,-1201,21.7,1648.8,8,8,4,0,0,0,0,16939,7,18784,196,69,451,1201,19.6,1693.9,red,2,1.5,18,16,red
4525622541,6,5,6,0,0,0,0,15801,7,17655,208,45,161,1546,20.8,1580.1,5,6,3,0,0,0,0,15640,6.6,16109,197,34,-161,-1546,19.7,1564,red,2.4,1.33,33,25,red
4457799018,5,10,4,0,0,0,0,14750,6.6,15820,185,44,-3688,-4038,18.5,1475,10,5,12,2,1,1,0,18438,7.2,19858,189,60,3688,4038,18.9,1843.8,red,0.9,4.4,11,77,red
4456395862,9,12,7,0,0,0,0,17709,6.6,17077,213,35,-653,-1717,21.3,1770.9,12,9,15,0,0,0,0,18362,7,18794,193,40,653,1717,19.3,1836.2,blue,1.33,3,17,15,red
4527033162,6,9,7,0,0,0,0,15827,6.8,17027,181,46,-2327,-2250,18.1,1582.7,9,6,5,2,1,1,0,18154,7.4,19277,251,60,2327,2250,25.1,1815.4,red,1.44,2.33,16,19,red
4437860358,10,6,23,0,0,0,0,17482,6.8,17024,206,38,1875,-622,20.6,1748.2,6,10,6,1,1,0,0,15607,6.8,17646,179,60,-1875,622,17.9,1560.7,red,5.5,1.2,31,21,blue
4510113331,4,3,5,0,0,0,0,15450,7,17766,202,61,312,33,20.2,1545,3,4,8,2,1,1,0,15138,7.2,17733,243,52,-312,-33,24.3,1513.8,red,3,2.75,44,50,red
4456971409,7,3,5,1,1,0,0,15728,6.8,17209,208,30,989,-477,20.8,1572.8,3,7,2,0,0,0,0,14739,6.6,17686,208,62,-989,477,20.8,1473.9,red,4,0.71,17,14,blue
4498748724,5,3,7,1,0,1,0,15588,6.6,16904,202,44,414,-1224,20.2,1558.8,3,5,2,1,1,0,0,15174,7,18128,207,68,-414,1224,20.7,1517.4,blue,4,1,37,43,blue
4524065745,10,12,16,1,1,0,0,18676,7,18145,217,76,416,1133,21.7,1867.6,12,10,14,0,0,0,0,18260,6.6,17012,211,31,-416,-1133,21.1,1826,blue,2.17,2.6,25,21,red
4417883002,4,6,6,0,0,0,0,15829,6.8,17626,185,68,-869,-814,18.5,1582.9,6,4,2,1,1,0,0,16698,6.8,18440,231,56,869,814,23.1,1669.8,red,1.67,2,35,18,red
4506933329,4,6,2,1,1,0,0,15340,7.2,18245,228,44,-1031,122,22.8,1534,6,4,7,0,0,0,0,16371,7,18123,228,51,1031,-122,22.8,1637.1,blue,1,3.25,16,17,red
4519376490,7,8,7,1,0,1,0,17140,7.2,18192,207,52,-389,226,20.7,1714,8,7,9,1,1,0,0,17529,7,17966,208,48,389,-226,20.8,1752.9,red,1.75,2.43,14,17,blue
4526390951,2,9,2,0,0,0,0,14606,6.8,17633,200,71,-3513,-1630,20,1460.6,9,2,6,1,1,0,0,18119,7.4,19263,221,60,3513,1630,22.1,1811.9,red,0.44,7.5,13,14,red
4489894297,6,2,4,1,0,1,0,17528,7.2,20077,257,64,2605,2260,25.7,1752.8,2,6,3,1,1,0,0,14923,6.8,17817,254,51,-2605,-2260,25.4,1492.3,blue,5,0.83,25,20,red
4497671680,5,4,7,0,0,0,0,16035,6.6,17246,193,44,408,165,19.3,1603.5,4,5,6,1,1,0,0,15627,6.8,17081,224,56,-408,-165,22.4,1562.7,red,3,2,85,17,blue
4499525448,3,9,5,1,1,0,0,14559,6.8,17148,193,56,-4140,-2177,19.3,1455.9,9,3,8,0,0,0,0,18699,7.4,19325,236,42,4140,2177,23.6,1869.9,red,0.89,5.67,16,107,red
4519807061,12,4,16,1,1,0,0,19726,7.4,19180,246,48,5020,3785,24.6,1972.6,4,12,6,0,0,0,0,14706,6.4,15395,192,48,-5020,-3785,19.2,1470.6,blue,7,0.83,21,15,red
4526594871,5,4,5,0,0,0,0,16508,7.2,18959,230,56,616,1673,23,1650.8,4,5,6,0,0,0,0,15892,6.8,17286,238,48,-616,-1673,23.8,1589.2,blue,2.5,2,42,16,red
4505122795,1,5,1,0,0,0,0,14001,6.4,16037,221,52,-2744,-1330,22.1,1400.1,5,1,11,1,1,0,0,16745,7,17367,244,44,2744,1330,24.4,1674.5,red,0.4,16,17,23,red
4506324067,4,3,8,1,1,0,0,15650,7,17837,224,51,-249,-1163,22.4,1565,3,4,3,1,0,1,0,15899,7.2,19000,254,58,249,1163,25.4,1589.9,blue,4,1.5,24,17,red
4527210853,6,5,4,0,0,0,0,16663,7,18493,227,64,-29,-997,22.7,1666.3,5,6,4,1,1,0,0,16692,7.4,19490,225,76,29,997,22.5,1669.2,red,2,1.5,16,13,blue
4486520653,7,4,5,0,0,0,0,17052,6.8,17766,241,44,1475,-95,24.1,1705.2,4,7,5,1,1,0,0,15577,6.6,17861,206,60,-1475,95,20.6,1557.7,blue,3,1.29,12,38,blue
4486259038,7,9,12,0,0,0,0,16242,6.4,16365,209,40,-2055,-2649,20.9,1624.2,9,7,12,0,0,0,0,18297,7.2,19014,202,56,2055,2649,20.2,1829.7,red,2.11,3,35,27,blue
4460106105,4,6,2,0,0,0,0,15009,6.4,16571,211,44,-1806,-1419,21.1,1500.9,6,4,7,2,1,1,0,16815,7,17990,220,59,1806,1419,22,1681.5,red,1,3.25,18,25,red
4505558146,4,7,8,0,0,0,0,15462,6.6,17446,209,54,-2237,-885,20.9,1546.2,7,4,12,1,1,0,0,17699,6.8,18331,256,46,2237,885,25.6,1769.9,red,1.71,4.75,46,21,red
4488272023,7,4,6,0,0,0,0,16972,7.2,19381,222,57,1992,3174,22.2,1697.2,4,7,6,1,1,0,0,14980,6.4,16207,221,36,-1992,-3174,22.1,1498,blue,3.25,1.43,44,22,red
4511153388,4,2,2,0,0,0,0,17005,7.2,19366,268,60,1973,1236,26.8,1700.5,2,4,0,1,1,0,0,15032,6.8,18130,241,72,-1973,-1236,24.1,1503.2,blue,3,0.5,15,18,red
4456461566,4,5,4,0,0,0,0,15845,6.8,17682,225,48,463,-8,22.5,1584.5,5,4,5,0,0,0,0,15382,7,17690,214,42,-463,8,21.4,1538.2,blue,1.6,2.5,17,21,blue
4467814898,2,9,1,0,0,0,0,14048,6.4,16395,209,36,-4004,-3300,20.9,1404.8,9,2,9,2,1,1,0,18052,7.2,19695,237,56,4004,3300,23.7,1805.2,red,0.33,9,15,19,red
4494040158,6,8,10,1,1,0,0,15388,6.4,15544,153,60,-3077,-3160,15.3,1538.8,8,6,5,1,0,1,1,18465,7,18704,214,59,3077,3160,21.4,1846.5,blue,2,2.17,17,15,blue
4492179998,4,7,3,1,1,0,0,14622,6.6,17798,176,67,-2542,-388,17.6,1462.2,7,4,10,0,0,0,0,17164,7,18186,238,48,2542,388,23.8,1716.4,red,1,4.25,17,18,red
4485773420,4,5,4,1,1,0,0,15184,6.8,17545,199,48,-700,906,19.9,1518.4,5,4,5,1,0,1,0,15884,6.6,16639,215,38,700,-906,21.5,1588.4,blue,1.6,2.5,41,16,red
4493766811,10,12,8,0,0,0,0,17607,7,18633,195,41,-740,396,19.5,1760.7,12,10,11,1,1,0,0,18347,7,18237,214,40,740,-396,21.4,1834.7,red,1.5,2.3,86,14,red
4408530058,6,10,7,0,0,0,0,15258,6.8,17586,179,50,-3222,-1976,17.9,1525.8,10,6,11,1,1,0,0,18480,7.2,19562,240,56,3222,1976,24,1848,red,1.3,3.5,21,19,red
4478937217,13,4,24,1,1,0,0,19669,7,17978,207,32,6876,6535,20.7,1966.9,4,13,8,0,0,0,0,12793,5.2,11443,149,8,-6876,-6535,14.9,1279.3,blue,9.25,0.92,47,15,blue
4526100030,7,4,8,2,1,1,0,17865,7.4,19417,251,48,2871,1581,25.1,1786.5,4,7,4,0,0,0,0,14994,7.2,17836,215,51,-2871,-1581,21.5,1499.4,blue,3.75,1.14,15,13,blue
4526707938,9,9,8,1,0,1,1,19206,7,17896,219,30,2422,1048,21.9,1920.6,9,9,15,1,1,0,0,16784,6.6,16848,181,39,-2422,-1048,18.1,1678.4,red,1.89,2.67,88,17,red
4504180691,7,3,8,1,1,0,0,18068,7.2,19266,252,60,3299,1803,25.2,1806.8,3,7,3,1,0,1,0,14769,6.8,17463,201,59,-3299,-1803,20.1,1476.9,blue,5,0.86,16,17,blue
4464495832,6,7,12,1,1,0,0,17397,7,18389,235,48,751,615,23.5,1739.7,7,6,11,0,0,0,0,16646,6.8,17774,210,48,-751,-615,21,1664.6,blue,2.57,3,205,13,blue
4469530341,6,6,3,0,0,0,0,15933,7.2,18813,221,52,-866,259,22.1,1593.3,6,6,3,1,1,0,0,16799,7.2,18554,249,52,866,-259,24.9,1679.9,red,1.5,1.5,16,20,red
4524698989,5,5,4,1,1,0,0,15552,6.8,17498,239,25,-164,94,23.9,1555.2,5,5,6,1,0,1,0,15716,7,17404,203,62,164,-94,20.3,1571.6,red,1.8,2.2,19,17,blue
4494911672,4,5,3,1,1,0,0,16675,7.2,18462,240,72,93,1943,24,1667.5,5,4,7,0,0,0,0,16582,6.6,16519,209,46,-93,-1943,20.9,1658.2,red,1.4,3,21,22,red
4437927077,6,9,6,0,0,0,0,16585,7,18342,231,55,-991,-844,23.1,1658.5,9,6,7,0,0,0,0,17576,7.4,19186,223,40,991,844,22.3,1757.6,red,1.33,2.67,199,13,blue
4514140656,12,6,15,1,1,0,0,18665,7,17762,213,37,2524,1040,21.3,1866.5,6,12,7,1,0,1,0,16141,6.6,16722,202,43,-2524,-1040,20.2,1614.1,blue,4.5,1.08,22,16,blue
4526313173,9,4,10,1,1,0,0,17555,6.8,17779,223,56,2875,1386,22.3,1755.5,4,9,4,0,0,0,0,14680,6.4,16393,196,44,-2875,-1386,19.6,1468,blue,4.75,0.89,14,17,blue
4518035453,5,9,5,0,0,0,0,15942,6.8,17493,215,48,-1590,-1375,21.5,1594.2,9,5,13,1,1,0,0,17532,7,18868,221,70,1590,1375,22.1,1753.2,red,1.11,4.4,10,43,red
4509363345,6,8,9,0,0,0,0,16185,6.8,17924,204,40,-2100,-925,20.4,1618.5,8,6,12,2,1,1,1,18285,7,18849,199,40,2100,925,19.9,1828.5,red,1.88,3.33,42,34,blue
4518030452,7,11,11,0,0,0,0,17444,6.4,16497,213,42,-1642,-4442,21.3,1744.4,11,7,16,1,1,0,0,19086,7.6,20939,223,71,1642,4442,22.3,1908.6,red,1.64,3.86,13,12,blue
4476285822,4,4,7,1,1,0,0,15471,6.8,18216,220,57,-499,260,22,1547.1,4,4,4,0,0,0,0,15970,7,17956,252,44,499,-260,25.2,1597,red,2.75,2,19,17,red
4466552109,3,5,3,1,1,0,0,15043,6.8,17227,225,47,-1591,-1829,22.5,1504.3,5,3,4,1,0,1,0,16634,7.4,19056,236,52,1591,1829,23.6,1663.4,red,1.2,3,27,17,blue
4463212406,7,5,5,1,1,0,0,16424,7.2,18793,217,56,-158,-688,21.7,1642.4,5,7,2,0,0,0,0,16582,7.2,19481,243,77,158,688,24.3,1658.2,blue,2.4,1,94,19,red
4479318487,6,3,6,0,0,0,0,16061,6.8,17186,158,60,1195,538,15.8,1606.1,3,6,1,1,1,0,0,14866,6.6,16648,210,56,-1195,-538,21,1486.6,blue,4,0.67,18,43,red
4484030443,5,13,3,0,0,0,0,14910,6.4,16295,198,40,-4644,-3580,19.8,1491,13,5,13,0,0,0,0,19554,7.4,19875,247,46,4644,3580,24.7,1955.4,red,0.62,5.2,13,15,red
4459790893,5,11,8,0,0,0,0,15127,6.4,16197,193,28,-4099,-4129,19.3,1512.7,11,5,11,0,0,0,0,19226,7.4,20326,225,52,4099,4129,22.5,1922.6,red,1.18,4.4,9,10,red
4506198990,0,8,0,0,0,0,0,12682,6.6,15784,173,50,-4944,-3928,17.3,1268.2,8,0,4,1,1,0,0,17626,7.4,19712,233,60,4944,3928,23.3,1762.6,red,0,12.65,14,15,red
4471977008,5,6,3,1,1,0,0,16298,7.4,19831,231,64,96,2988,23.1,1629.8,6,5,8,0,0,0,0,16202,6.6,16843,201,44,-96,-2988,20.1,1620.2,blue,1.33,2.8,19,19,red
4467720133,10,4,10,2,1,1,0,18818,7.4,19037,215,60,4107,1820,21.5,1881.8,4,10,2,0,0,0,0,14711,6.8,17217,209,49,-4107,-1820,20.9,1471.1,blue,5,0.6,23,21,blue
4472854192,7,4,7,1,1,0,0,17221,7.4,18574,199,68,1823,1574,19.9,1722.1,4,7,3,0,0,0,0,15398,6.6,17000,208,60,-1823,-1574,20.8,1539.8,blue,3.5,1,22,18,blue
4519990304,7,4,9,2,1,1,0,17897,7,18898,237,46,2332,637,23.7,1789.7,4,7,4,0,0,0,0,15565,7,18261,190,68,-2332,-637,19,1556.5,blue,4,1.14,19,18,blue
4524114538,4,7,11,0,0,0,0,14657,6.2,15612,194,48,-2710,-2319,19.4,1465.7,7,4,9,1,1,0,0,17367,7,17931,227,60,2710,2319,22.7,1736.7,blue,2.14,4,48,16,red
4498851074,8,8,5,0,0,0,0,17232,6.8,17997,231,32,260,-108,23.1,1723.2,8,8,7,0,0,0,0,16972,7,18105,205,50,-260,108,20.5,1697.2,red,1.62,1.88,14,18,blue
4505063876,2,2,3,0,0,0,0,15830,7.2,19605,255,80,909,2001,25.5,1583,2,2,3,0,0,0,0,14921,7,17604,219,63,-909,-2001,21.9,1492.1,blue,2.5,2.5,18,13,red
4507908715,3,5,2,0,0,0,0,14992,6.4,16189,214,53,-1984,-2084,21.4,1499.2,5,3,8,1,1,0,0,16976,6.8,18273,246,56,1984,2084,24.6,1697.6,red,1,4.33,19,23,red
4521648781,10,6,11,0,0,0,0,19000,7.2,18915,233,39,1259,-60,23.3,1900,6,10,7,0,0,0,0,17741,7,18975,264,44,-1259,60,26.4,1774.1,blue,3.5,1.3,23,22,blue
4491789559,5,7,5,0,0,0,0,15723,6.8,17429,203,50,-1522,-1611,20.3,1572.3,7,5,4,1,1,0,0,17245,7,19040,241,56,1522,1611,24.1,1724.5,red,1.43,2.2,20,23,blue
4454570782,4,8,6,0,0,0,0,15428,6.8,16985,213,54,-2190,-3375,21.3,1542.8,8,4,7,2,1,1,0,17618,7.6,20360,218,67,2190,3375,21.8,1761.8,red,1.25,3.75,15,17,blue
4504999462,4,4,5,1,1,0,0,14592,6.6,16682,204,47,-1208,-1061,20.4,1459.2,4,4,3,0,0,0,0,15800,6.8,17743,205,60,1208,1061,20.5,1580,red,2.25,1.75,19,20,red
4508098561,4,11,5,0,0,0,0,15613,6.8,17057,202,53,-2952,-2963,20.2,1561.3,11,4,8,1,1,0,0,18565,7.4,20020,221,63,2952,2963,22.1,1856.5,red,0.82,4.75,17,18,blue
4494693050,7,5,11,1,1,0,0,16844,6.8,18255,217,51,749,570,21.7,1684.4,5,7,8,0,0,0,0,16095,7,17685,233,44,-749,-570,23.3,1609.5,red,3.6,1.86,80,17,blue
4527243776,7,1,11,1,1,0,0,17709,7.2,19221,242,52,3324,1398,24.2,1770.9,1,7,0,1,0,1,0,14385,6.6,17823,227,68,-3324,-1398,22.7,1438.5,blue,18,0.14,23,33,blue
4452033938,3,2,3,1,0,1,0,15028,6.8,18170,212,52,147,1258,21.2,1502.8,2,3,5,1,1,0,0,14881,6.8,16912,231,52,-147,-1258,23.1,1488.1,red,3,2.33,19,22,red
4472833324,6,7,5,0,0,0,0,16399,6.8,17056,219,43,580,-54,21.9,1639.9,7,6,7,0,0,0,0,15819,6.6,17110,189,43,-580,54,18.9,1581.9,blue,1.57,2.33,16,15,blue
4471979738,12,8,10,1,1,0,0,19079,7,18774,206,58,1330,854,20.6,1907.9,8,12,7,0,0,0,0,17749,7,17920,212,48,-1330,-854,21.2,1774.9,red,2.75,1.25,18,17,blue
4473156943,6,9,7,0,0,0,0,15809,7,18227,202,62,-2167,-1158,20.2,1580.9,9,6,6,0,0,0,0,17976,7.2,19385,243,53,2167,1158,24.3,1797.6,blue,1.44,2.5,14,34,red
4523427985,5,5,4,1,1,0,0,16755,7.2,18596,261,56,1470,498,26.1,1675.5,5,5,3,0,0,0,0,15285,7,18098,217,46,-1470,-498,21.7,1528.5,red,1.8,1.6,18,17,blue
4525572602,3,4,3,0,0,0,0,15043,6.8,17669,203,69,-635,202,20.3,1504.3,4,3,3,1,1,0,0,15678,6.8,17467,242,40,635,-202,24.2,1567.8,red,1.5,2.33,15,17,red
4483653964,6,10,7,1,1,0,0,16832,6.8,17641,222,60,-1467,-1504,22.2,1683.2,10,6,12,0,0,0,0,18299,7.4,19145,210,64,1467,1504,21,1829.9,blue,1.3,3.67,72,16,red
4452899588,9,2,8,1,1,0,0,17580,7.2,19527,210,46,3391,2897,21,1758,2,9,1,0,0,0,0,14189,6.6,16630,195,64,-3391,-2897,19.5,1418.9,blue,8.5,0.33,16,16,blue
4525377275,5,11,5,0,0,0,0,15453,6.6,16291,193,43,-2980,-2882,19.3,1545.3,11,5,15,0,0,0,0,18433,7.2,19173,233,45,2980,2882,23.3,1843.3,blue,0.91,5.2,20,23,blue
4527387593,3,5,3,0,0,0,0,15869,7,18217,261,48,-397,-163,26.1,1586.9,5,3,5,1,1,0,0,16266,7,18380,227,54,397,163,22.7,1626.6,red,1.2,3.33,15,17,blue
4526773374,5,2,9,0,0,0,0,15917,7.2,18903,220,49,1528,1785,22,1591.7,2,5,4,1,1,0,0,14389,6.8,17118,199,64,-1528,-1785,19.9,1438.9,blue,7,1.2,61,18,red
4461218405,11,4,9,1,1,0,0,19612,7.6,20290,259,50,4871,2019,25.9,1961.2,4,11,1,0,0,0,0,14741,7,18271,210,53,-4871,-2019,21,1474.1,blue,5,0.45,18,17,blue
4481181249,1,14,0,0,0,0,0,12519,6,13642,152,41,-7527,-4309,15.2,1251.9,14,1,14,0,0,0,0,20046,7.2,17951,220,43,7527,4309,22,2004.6,red,0.07,28,19,27,red
4526454387,5,6,7,1,1,0,0,16227,7.2,19425,221,68,131,735,22.1,1622.7,6,5,8,0,0,0,0,16096,7,18690,206,44,-131,-735,20.6,1609.6,red,2,2.8,18,20,red
4475315521,6,9,7,0,0,0,0,15291,6.2,15389,190,56,-2889,-3905,19,1529.1,9,6,10,1,1,0,0,18180,7.2,19294,228,51,2889,3905,22.8,1818,red,1.44,3.17,19,19,blue
4525998328,3,5,2,0,0,0,0,14442,6.8,16949,209,47,-2402,-1269,20.9,1444.2,5,3,7,2,1,1,0,16844,7,18218,240,60,2402,1269,24,1684.4,red,1,4,19,22,red
4522209183,12,8,12,0,0,0,0,18968,7,18902,201,36,1686,886,20.1,1896.8,8,12,8,0,0,0,0,17282,7,18016,186,64,-1686,-886,18.6,1728.2,blue,3,1.33,13,18,red
4525533039,5,3,4,2,1,1,0,16187,6.8,18182,239,60,1408,1663,23.9,1618.7,3,5,3,0,0,0,0,14779,6.6,16519,204,60,-1408,-1663,20.4,1477.9,blue,3,1.2,21,26,blue
4465150081,10,10,10,1,1,0,0,18062,7,17871,190,62,-1293,-713,19,1806.2,10,10,10,0,0,0,0,19355,7.2,18584,247,50,1293,713,24.7,1935.5,blue,2,2,20,15,blue
4451694219,1,5,0,0,0,0,0,14824,7.2,18421,230,72,-1424,-2416,23,1482.4,5,1,3,1,1,0,0,16248,7.6,20837,228,68,1424,2416,22.8,1624.8,red,0.2,8,24,16,red
4497078527,3,7,2,0,0,0,0,15195,7,18046,217,64,-2336,-1282,21.7,1519.5,7,3,8,1,1,0,0,17531,7.4,19328,247,60,2336,1282,24.7,1753.1,red,0.71,5,15,17,blue
4489369709,7,6,6,0,0,0,0,16457,7,18265,202,56,265,-267,20.2,1645.7,6,7,4,1,1,0,0,16192,7,18532,234,63,-265,267,23.4,1619.2,red,2.17,1.43,21,20,blue
4499238278,5,5,6,1,0,1,1,18317,7,19181,238,60,3006,1814,23.8,1831.7,5,5,5,1,1,0,0,15311,6.8,17367,208,48,-3006,-1814,20.8,1531.1,blue,2.2,2,33,39,blue
4525639504,7,5,6,1,1,0,0,16319,7.4,19461,218,55,1110,1898,21.8,1631.9,5,7,4,0,0,0,0,15209,6.8,17563,198,44,-1110,-1898,19.8,1520.9,blue,2.6,1.29,16,19,blue
4523531334,11,8,18,0,0,0,0,19275,7.2,18899,233,58,2711,1931,23.3,1927.5,8,11,15,1,1,0,0,16564,6.8,16968,183,48,-2711,-1931,18.3,1656.4,blue,3.62,2.09,16,18,blue
4492137398,6,2,6,1,1,0,0,16605,6.8,17533,219,46,2086,360,21.9,1660.5,2,6,1,1,0,1,0,14519,6.6,17173,210,44,-2086,-360,21,1451.9,blue,6,0.5,19,22,blue
4524203497,6,3,5,2,1,1,0,17898,7,19735,238,67,3477,3386,23.8,1789.8,3,6,3,0,0,0,0,14421,6.6,16349,224,44,-3477,-3386,22.4,1442.1,blue,3.67,1,15,12,blue
4464462624,3,5,2,0,0,0,0,14745,6.8,17586,213,44,-1815,-671,21.3,1474.5,5,3,5,1,1,0,0,16560,7,18257,211,76,1815,671,21.1,1656,red,1,3.33,17,46,blue
4526716205,2,4,2,1,0,1,1,16417,6.8,18414,249,63,1086,1804,24.9,1641.7,4,2,8,1,1,0,0,15331,6.6,16610,219,52,-1086,-1804,21.9,1533.1,blue,1,6,19,23,red
4460977711,4,7,2,0,0,0,0,15169,7,17363,217,44,-145,120,21.7,1516.9,7,4,3,0,0,0,0,15314,6.8,17243,205,39,145,-120,20.5,1531.4,blue,0.86,2.5,20,53,blue
4477402246,2,4,2,2,1,1,0,15197,7,17925,233,64,-1519,-1363,23.3,1519.7,4,2,4,0,0,0,0,16716,7.2,19288,245,63,1519,1363,24.5,1671.6,red,1,4,18,21,red
4522633983,8,4,8,1,1,0,0,18208,7.2,19824,248,56,4538,3618,24.8,1820.8,4,8,1,0,0,0,0,13670,6.4,16206,176,51,-4538,-3618,17.6,1367,blue,4,0.62,19,10,blue
4518069516,7,3,4,1,1,0,0,17879,7.4,19767,241,63,4864,5310,24.1,1787.9,3,7,1,0,0,0,0,13015,6,14457,185,28,-4864,-5310,18.5,1301.5,blue,3.67,0.57,18,48,blue
4527443985,9,2,6,0,0,0,0,17947,7.2,19669,239,36,4121,3050,23.9,1794.7,2,9,1,0,0,0,0,13826,6.8,16619,177,62,-4121,-3050,17.7,1382.6,blue,7.5,0.33,18,51,blue
4434935044,3,5,3,1,1,0,0,15393,7,18185,243,56,-1101,-306,24.3,1539.3,5,3,7,0,0,0,0,16494,7,18491,267,48,1101,306,26.7,1649.4,blue,1.2,4,22,17,red
4525584889,4,6,2,0,0,0,0,15729,7,18102,205,60,-448,-163,20.5,1572.9,6,4,6,1,1,0,0,16177,7,18265,232,43,448,163,23.2,1617.7,blue,1,3,17,19,blue
4455737926,10,5,13,1,0,1,0,18560,7.2,19924,244,38,3373,2383,24.4,1856,5,10,3,0,0,0,0,15187,6.8,17541,210,44,-3373,-2383,21,1518.7,blue,4.6,0.8,24,18,blue
4495132329,3,4,3,1,1,0,0,15718,6.8,17585,256,57,86,-315,25.6,1571.8,4,3,6,0,0,0,0,15632,6.8,17900,220,42,-86,315,22,1563.2,blue,1.5,3.33,16,20,blue
4526563599,2,8,0,0,0,0,0,14021,6.2,15684,200,55,-3792,-3472,20,1402.1,8,2,8,1,1,0,0,17813,7.2,19156,236,43,3792,3472,23.6,1781.3,red,0.25,8,13,19,blue
4455235066,13,5,10,0,0,0,0,19485,7.4,19900,196,58,3823,2563,19.6,1948.5,5,13,5,0,0,0,0,15662,6.6,17337,201,44,-3823,-2563,20.1,1566.2,blue,4.6,0.77,16,14,blue
4523641234,6,8,6,1,1,0,0,16029,6.8,17293,198,48,-1350,-1765,19.8,1602.9,8,6,6,0,0,0,0,17379,7.2,19058,206,51,1350,1765,20.6,1737.9,red,1.5,2.33,19,15,red
4526844816,4,6,2,1,0,1,0,14372,6.8,16842,205,40,-1864,-2124,20.5,1437.2,6,4,3,0,0,0,0,16236,7.2,18966,216,54,1864,2124,21.6,1623.6,red,1,2.25,15,23,red
4295358071,10,6,13,0,0,0,0,18348,6.6,17087,195,52,1864,-797,19.5,1834.8,6,10,7,1,1,0,0,16484,7,17884,211,59,-1864,797,21.1,1648.4,blue,3.83,1.3,23,23,red
4456599389,7,4,11,1,1,0,0,16464,6.8,17678,206,40,441,130,20.6,1646.4,4,7,5,0,0,0,0,16023,6.8,17548,229,51,-441,-130,22.9,1602.3,red,4.5,1.29,17,16,red
4489502517,4,9,5,0,0,0,0,16377,6.8,18575,213,67,-2218,-1083,21.3,1637.7,9,4,7,2,1,1,1,18595,7.2,19658,222,60,2218,1083,22.2,1859.5,red,1,4,15,25,red
4523651481,9,10,9,1,1,0,0,17421,6.6,17407,203,40,-120,-394,20.3,1742.1,10,9,11,0,0,0,0,17541,6.8,17801,225,32,120,394,22.5,1754.1,blue,1.8,2.33,24,20,red
4472755349,4,5,4,0,0,0,0,15284,6.8,17975,221,53,-188,899,22.1,1528.4,5,4,6,0,0,0,0,15472,6.8,17076,226,44,188,-899,22.6,1547.2,blue,1.6,2.75,44,19,red
4441631647,3,7,3,1,1,0,0,14900,7,18354,214,60,-1966,263,21.4,1490,7,3,7,0,0,0,0,16866,7.2,18091,214,54,1966,-263,21.4,1686.6,red,0.86,4.67,21,24,blue
4518881897,7,6,5,0,0,0,0,16345,6.6,16530,204,47,-323,-992,20.4,1634.5,6,7,8,1,1,0,0,16668,7,17522,190,56,323,992,19,1666.8,blue,2,2,17,56,blue
4482030809,6,11,6,0,0,0,0,17982,7,18687,244,56,-708,387,24.4,1798.2,11,6,9,1,1,0,0,18690,7.2,18300,203,44,708,-387,20.3,1869,red,1.09,3.33,14,12,red
4526204172,6,6,5,0,0,0,0,16259,7.2,18818,232,43,-147,184,23.2,1625.9,6,6,6,1,1,0,0,16406,7,18634,237,51,147,-184,23.7,1640.6,red,1.83,2,17,19,red
4483322661,10,11,8,0,0,0,0,18472,7.2,19144,228,47,1041,1187,22.8,1847.2,11,10,8,1,1,0,0,17431,6.8,17957,175,50,-1041,-1187,17.5,1743.1,blue,1.64,1.9,22,20,blue
4477707123,7,5,6,1,1,0,0,16099,7,18219,203,48,873,678,20.3,1609.9,5,7,2,0,0,0,0,15226,6.8,17541,208,44,-873,-678,20.8,1522.6,blue,2.6,1,22,19,blue
4499396422,4,4,8,0,0,0,0,15947,6.8,17352,231,41,247,-1191,23.1,1594.7,4,4,5,1,1,0,0,15700,6.8,18543,219,75,-247,1191,21.9,1570,blue,3,2.25,46,19,blue
4517748263,6,5,3,0,0,0,0,16590,7,19180,228,43,1209,1099,22.8,1659,5,6,10,1,1,0,0,15381,7,18081,202,52,-1209,-1099,20.2,1538.1,blue,1.8,2.5,18,14,blue
4475232216,3,4,3,1,0,1,0,14986,6.4,16975,229,53,-495,-724,22.9,1498.6,4,3,4,1,1,0,0,15481,7,17699,246,42,495,724,24.6,1548.1,red,1.5,2.67,16,17,blue
4474642048,16,5,21,1,1,0,0,19234,7,18339,193,32,2899,1508,19.3,1923.4,5,16,7,0,0,0,0,16335,6.8,16831,211,61,-2899,-1508,21.1,1633.5,red,7.4,0.75,21,20,blue
4499380853,3,4,4,2,1,1,1,16657,7.2,18356,228,52,1129,218,22.8,1665.7,4,3,4,0,0,0,0,15528,7.2,18138,238,40,-1129,-218,23.8,1552.8,blue,1.75,2.67,42,14,blue
4508126925,16,7,22,2,1,1,0,21512,7.2,19190,218,35,5514,3051,21.8,2151.2,7,16,9,0,0,0,0,15998,6.4,16139,196,47,-5514,-3051,19.6,1599.8,blue,5.43,1,19,20,blue
4451057396,6,7,5,1,0,1,0,15905,7,17754,200,52,-1317,-1427,20,1590.5,7,6,10,1,1,0,0,17222,7.2,19181,203,67,1317,1427,20.3,1722.2,red,1.57,2.83,18,15,blue
4524537061,7,7,4,0,0,0,0,15793,6.8,17795,191,41,-571,-932,19.1,1579.3,7,7,3,1,0,1,0,16364,7.2,18727,227,53,571,932,22.7,1636.4,red,1.57,1.43,39,39,red
4478403685,10,8,12,0,0,0,0,17883,6.8,17407,198,40,1485,-264,19.8,1788.3,8,10,10,1,1,0,0,16398,6.8,17671,194,52,-1485,264,19.4,1639.8,red,2.75,1.8,20,19,blue
4527385549,4,2,6,0,0,0,0,15744,7,18381,219,60,1185,1042,21.9,1574.4,2,4,3,0,0,0,0,14559,6.8,17339,231,60,-1185,-1042,23.1,1455.9,red,5,1.25,20,18,blue
4525379386,5,7,3,1,1,0,0,14765,6.8,16480,189,38,-2108,-1510,18.9,1476.5,7,5,8,0,0,0,0,16873,7.4,17990,212,66,2108,1510,21.2,1687.3,red,1.14,3,18,17,red
4435697365,5,2,5,2,1,1,0,17446,7.4,20350,255,63,3229,3548,25.5,1744.6,2,5,2,0,0,0,0,14217,6.6,16802,221,48,-3229,-3548,22.1,1421.7,blue,5,0.8,19,16,blue
4526620747,6,4,10,1,1,0,0,16190,7,17477,233,36,1267,920,23.3,1619,4,6,4,0,0,0,0,14923,6.4,16557,190,59,-1267,-920,19,1492.3,blue,4,1.33,23,15,blue
4525336028,2,6,2,1,1,0,0,14967,6.8,16756,221,54,-1513,-2959,22.1,1496.7,6,2,7,0,0,0,0,16480,7.2,19715,224,62,1513,2959,22.4,1648,blue,0.67,6.5,18,14,blue
4474818952,9,3,12,2,1,1,0,18108,7,18738,218,45,2967,947,21.8,1810.8,3,9,1,0,0,0,0,15141,6.8,17791,228,76,-2967,-947,22.8,1514.1,blue,7,0.44,15,16,red
4473009756,7,7,10,1,1,0,0,16397,6.6,17090,222,40,-1023,-2028,22.2,1639.7,7,7,6,0,0,0,0,17420,7.2,19118,243,52,1023,2028,24.3,1742,red,2.43,1.86,15,40,red
4519538851,6,4,8,1,0,1,0,16606,7,18225,237,48,1385,969,23.7,1660.6,4,6,2,0,0,0,0,15221,7,17256,217,60,-1385,-969,21.7,1522.1,blue,3.5,1,57,21,blue
4520532306,3,9,5,0,0,0,0,14351,6.8,16380,172,62,-3540,-3645,17.2,1435.1,9,3,4,2,1,1,0,17891,7.6,20025,224,69,3540,3645,22.4,1789.1,blue,0.89,4.33,17,16,red
4486112923,2,7,2,1,0,1,0,14864,6.6,16742,249,41,-2219,-1498,24.9,1486.4,7,2,15,1,1,0,0,17083,7,18240,229,52,2219,1498,22.9,1708.3,red,0.57,11,17,22,red
4478112089,10,8,8,1,1,0,0,18214,7.2,19620,227,66,1295,1330,22.7,1821.4,8,10,9,0,0,0,0,16919,7,18290,205,52,-1295,-1330,20.5,1691.9,blue,2.25,1.7,15,16,blue
4516032625,8,3,12,0,0,0,0,17059,7.2,18162,200,37,1601,1229,20,1705.9,3,8,3,2,1,1,0,15458,6.8,16933,206,52,-1601,-1229,20.6,1545.8,red,6.67,0.75,20,14,blue
4464704394,2,4,2,1,1,0,0,14353,6.4,16624,215,53,-874,-1635,21.5,1435.3,4,2,5,0,0,0,0,15227,7,18259,216,62,874,1635,21.6,1522.7,red,1,4.5,21,27,red
4497491291,4,6,6,1,0,1,1,16580,7,17438,205,45,-551,-551,20.5,1658,6,4,10,1,1,0,0,17131,6.8,17989,218,55,551,551,21.8,1713.1,red,1.67,4,18,56,red
4477250448,9,8,11,0,0,0,0,17426,7,17243,234,33,395,-504,23.4,1742.6,8,9,9,0,0,0,0,17031,6.8,17747,188,60,-395,504,18.8,1703.1,blue,2.5,1.89,177,18,red
4469567856,6,7,3,2,1,1,0,16308,7,18718,227,65,-52,430,22.7,1630.8,7,6,5,0,0,0,0,16360,7.2,18288,208,52,52,-430,20.8,1636,red,1.29,2,18,16,blue
4466009861,9,3,11,1,0,1,1,19723,7.2,19678,249,35,4609,1189,24.9,1972.3,3,9,2,1,1,0,0,15114,7.2,18489,226,63,-4609,-1189,22.6,1511.4,blue,6.67,0.56,18,17,blue
4515907973,6,9,6,0,0,0,0,15946,7,17404,222,32,-1565,-467,22.2,1594.6,9,6,15,0,0,0,0,17511,6.8,17871,187,40,1565,467,18.7,1751.1,red,1.33,4,18,17,blue
4526227837,11,7,9,0,0,0,0,19425,7.4,20998,218,67,3143,2852,21.8,1942.5,7,11,5,1,1,0,0,16282,7,18146,216,56,-3143,-2852,21.6,1628.2,blue,2.86,1.09,17,18,red
4522430578,14,7,5,2,1,1,0,18135,7,19550,198,56,1490,1854,19.8,1813.5,7,14,7,0,0,0,0,16645,7,17696,180,43,-1490,-1854,18,1664.5,blue,2.71,1,39,11,red
4523589488,9,10,6,0,0,0,0,16774,7,17746,176,64,-1130,275,17.6,1677.4,10,9,12,0,0,0,0,17904,6.8,17471,206,32,1130,-275,20.6,1790.4,red,1.5,2.44,16,61,red
4468369355,6,5,5,1,1,0,0,16637,7.2,17981,215,60,370,212,21.5,1663.7,5,6,5,0,0,0,0,16267,7,17769,207,60,-370,-212,20.7,1626.7,blue,2.2,1.67,19,19,red
4477496962,7,7,14,0,0,0,0,16750,6.6,17492,214,44,-2128,-1873,21.4,1675,7,7,3,2,1,1,1,18878,7.2,19365,236,72,2128,1873,23.6,1887.8,red,3,1.43,17,22,red
4520341861,1,8,0,1,1,0,0,13493,6.6,16560,218,44,-3700,-2221,21.8,1349.3,8,1,8,0,0,0,0,17193,7,18781,229,39,3700,2221,22.9,1719.3,blue,0.12,16,21,21,red
4469779402,6,12,5,0,0,0,0,15794,6.8,17285,192,49,-4649,-1914,19.2,1579.4,12,6,11,1,1,0,1,20443,7.4,19199,213,47,4649,1914,21.3,2044.3,red,0.92,3.83,18,20,red
4517900276,9,6,12,1,1,0,0,16574,6.6,17052,203,36,144,-227,20.3,1657.4,6,9,4,0,0,0,0,16430,6.8,17279,229,56,-144,227,22.9,1643,blue,3.5,1.11,17,19,blue
4499273242,17,7,24,1,0,1,0,20182,7.6,20589,199,44,3404,2667,19.9,2018.2,7,17,5,1,1,0,0,16778,7,17922,206,61,-3404,-2667,20.6,1677.8,blue,5.86,0.71,39,14,blue
4526842255,4,11,6,0,0,0,0,15402,6.2,15435,205,48,-2180,-3706,20.5,1540.2,11,4,12,0,0,0,0,17582,7.2,19141,204,54,2180,3706,20.4,1758.2,red,0.91,5.75,13,18,blue
4472496029,6,6,5,1,1,0,0,15414,6.4,16960,188,43,-2545,-761,18.8,1541.4,6,6,5,1,0,1,1,17959,6.8,17721,225,51,2545,761,22.5,1795.9,red,1.83,1.83,17,19,blue
4518196735,5,4,6,2,1,1,0,16982,6.8,17866,225,34,1935,162,22.5,1698.2,4,5,6,0,0,0,0,15047,6.8,17704,208,64,-1935,-162,20.8,1504.7,red,2.75,2,17,21,blue
4521580882,5,5,3,2,1,1,0,15193,6.8,16642,208,50,-404,-419,20.8,1519.3,5,5,11,0,0,0,0,15597,6.8,17061,216,42,404,419,21.6,1559.7,blue,1.6,3.2,21,43,red
4456030876,5,9,4,0,0,0,0,15968,6.8,17837,226,55,-1624,-1067,22.6,1596.8,9,5,13,1,1,0,0,17592,7.2,18904,198,64,1624,1067,19.8,1759.2,red,1,4.4,19,21,blue
4464488268,2,2,2,1,0,1,0,15260,7,18522,220,71,-505,-602,22,1526,2,2,1,1,1,0,0,15765,7.2,19124,249,71,505,602,24.9,1576.5,blue,2,1.5,21,19,blue
4444346582,7,9,8,0,0,0,0,17115,6.8,17857,203,33,47,-856,20.3,1711.5,9,7,6,0,0,0,0,17068,7,18713,219,26,-47,856,21.9,1706.8,blue,1.67,2.14,18,14,red
4479812747,5,8,7,0,0,0,0,16365,6.8,17954,225,51,-1754,-149,22.5,1636.5,8,5,13,1,1,0,0,18119,7,18103,243,48,1754,149,24.3,1811.9,red,1.5,4.2,21,20,red
4407656540,7,7,9,0,0,0,0,16712,7,18681,190,64,-424,308,19,1671.2,7,7,7,0,0,0,0,17136,7.2,18373,203,52,424,-308,20.3,1713.6,blue,2.29,2,18,17,red
4526764469,13,7,15,1,1,0,0,18236,6.8,17766,202,32,2369,1517,20.2,1823.6,7,13,6,0,0,0,0,15867,6.8,16249,191,43,-2369,-1517,19.1,1586.7,blue,4,1,19,15,blue
4508732146,13,10,15,0,0,0,0,20067,7,18286,206,43,2778,-247,20.6,2006.7,10,13,4,1,1,0,0,17289,7,18533,184,44,-2778,247,18.4,1728.9,blue,2.8,1.08,87,19,blue
4521822365,3,6,4,1,1,0,0,14792,6.6,16218,205,52,-1183,-1235,20.5,1479.2,6,3,5,0,0,0,0,15975,6.8,17453,211,42,1183,1235,21.1,1597.5,red,1.17,3.67,18,21,blue
4513334307,1,6,0,0,0,0,0,14748,6.8,17867,212,61,-2619,-1215,21.2,1474.8,6,1,8,1,1,0,0,17367,7.2,19082,237,65,2619,1215,23.7,1736.7,red,0.17,14,12,45,red
4475540931,10,5,18,2,1,1,0,18682,7.4,19196,207,67,2733,2062,20.7,1868.2,5,10,6,0,0,0,0,15949,6.8,17134,216,49,-2733,-2062,21.6,1594.9,blue,5.6,1.1,24,21,blue
4459959828,3,4,2,0,0,0,0,15883,6.8,18069,229,60,-277,-123,22.9,1588.3,4,3,5,0,0,0,0,16160,7,18192,242,52,277,123,24.2,1616,blue,1.25,3,37,14,blue
4468070903,5,4,5,0,0,0,0,15938,6.8,17167,200,41,673,-64,20,1593.8,4,5,3,1,0,1,0,15265,6.6,17231,210,50,-673,64,21,1526.5,blue,2.5,1.4,21,19,blue
4515544332,11,2,16,0,0,0,0,18405,7,19055,228,45,4817,4522,22.8,1840.5,2,11,2,0,0,0,0,13588,6.2,14533,193,43,-4817,-4522,19.3,1358.8,blue,13.5,0.36,33,24,blue
4503345780,4,2,5,0,0,0,0,16164,7.2,19020,246,46,956,-27,24.6,1616.4,2,4,3,1,1,0,0,15208,7.2,19047,242,73,-956,27,24.2,1520.8,blue,4.5,1.25,15,60,blue
4527370035,3,7,2,1,0,1,0,15000,6.8,17095,212,48,-3290,-1243,21.2,1500,7,3,7,1,1,0,0,18290,7.2,18338,252,51,3290,1243,25.2,1829,red,0.71,4.67,14,17,red
4493167660,3,7,3,0,0,0,0,14454,6.6,17394,191,46,-3003,-2118,19.1,1445.4,7,3,5,1,1,0,0,17457,7.4,19512,239,56,3003,2118,23.9,1745.7,red,0.86,4,91,19,red
4503591121,7,8,7,1,1,0,0,17459,6.8,17773,209,56,-1,-459,20.9,1745.9,8,7,6,0,0,0,0,17460,6.8,18232,231,52,1,459,23.1,1746,blue,1.75,2,23,47,red
4445877402,10,4,9,1,0,1,0,17933,7.2,19728,217,52,2690,2444,21.7,1793.3,4,10,6,1,1,0,0,15243,6.8,17284,213,56,-2690,-2444,21.3,1524.3,blue,4.75,1,18,16,blue
4489234827,2,1,1,1,0,1,1,14780,6,14277,188,44,3568,2926,18.8,1478,1,2,0,0,0,0,0,11212,4.8,11351,132,27,-3568,-2926,13.2,1121.2,blue,3,0.5,10,6,blue
4484094490,4,1,5,1,1,0,0,15056,7,18484,226,44,777,742,22.6,1505.6,1,4,0,1,0,1,0,14279,7,17742,234,51,-777,-742,23.4,1427.9,red,9,0.25,23,28,red
4527285889,2,8,3,0,0,0,0,13337,6,14550,158,44,-5735,-5547,15.8,1333.7,8,2,6,2,1,1,1,19072,7.6,20097,232,68,5735,5547,23.2,1907.2,red,0.62,7,15,96,red
4492762371,13,6,18,1,1,0,0,20169,7,17549,205,52,4453,337,20.5,2016.9,6,13,9,0,0,0,0,15716,6.6,17212,162,52,-4453,-337,16.2,1571.6,blue,5.17,1.15,20,20,blue
4493337415,5,4,5,1,0,1,0,15549,6.8,17486,222,52,-193,-607,22.2,1554.9,4,5,2,1,1,0,0,15742,6.8,18093,248,48,193,607,24.8,1574.2,blue,2.5,1.2,11,19,red
4479699071,10,5,14,1,1,0,0,18392,7.2,17969,221,48,2119,209,22.1,1839.2,5,10,6,0,0,0,0,16273,7,17760,206,48,-2119,-209,20.6,1627.3,blue,4.8,1.1,20,18,blue
4467677156,5,4,6,0,0,0,0,15865,6.8,16893,208,43,-480,-1045,20.8,1586.5,4,5,3,1,1,0,0,16345,6.6,17938,226,57,480,1045,22.6,1634.5,blue,2.75,1.4,22,22,red
4525352232,9,5,11,2,1,1,0,17498,7,18424,209,52,1885,1636,20.9,1749.8,5,9,3,0,0,0,0,15613,6.6,16788,200,60,-1885,-1636,20,1561.3,blue,4,0.89,50,20,blue
4526112054,2,5,3,1,1,0,0,14606,7,17820,221,65,-1605,237,22.1,1460.6,5,2,7,0,0,0,0,16211,7,17583,235,44,1605,-237,23.5,1621.1,red,1,6,17,25,red
4526011384,0,11,0,0,0,0,0,13590,6.6,16558,200,49,-5691,-3094,20,1359,11,0,11,1,1,0,0,19281,7.4,19652,220,52,5691,3094,22,1928.1,red,0,12.65,38,16,red
4464904147,5,5,3,1,0,1,0,16259,7.2,18538,242,58,-995,181,24.2,1625.9,5,5,5,0,0,0,0,17254,7.2,18357,256,42,995,-181,25.6,1725.4,red,1.6,2,18,20,blue
4462936541,9,11,7,0,0,0,0,17137,7,18112,188,46,-1730,24,18.8,1713.7,11,9,11,2,1,1,0,18867,7,18088,211,40,1730,-24,21.1,1886.7,red,1.45,2.44,18,16,red
4526510226,2,4,4,0,0,0,0,14775,6.8,17337,206,45,-1285,-1925,20.6,1477.5,4,2,7,1,0,1,0,16060,7.2,19262,227,63,1285,1925,22.7,1606,red,1.5,5.5,19,62,blue
4485937828,11,11,17,0,0,0,0,17571,6.8,16712,174,31,-3024,-2806,17.4,1757.1,11,11,9,1,0,1,1,20595,7.2,19518,243,51,3024,2806,24.3,2059.5,blue,2.55,1.82,21,20,blue
4475122609,5,7,3,0,0,0,0,16946,7.2,18333,230,56,368,-774,23,1694.6,7,5,6,2,1,1,0,16578,7.2,19107,220,64,-368,774,22,1657.8,red,1.14,2.6,18,31,blue
4506039178,2,1,4,1,0,1,1,16437,6.8,18096,244,44,969,-409,24.4,1643.7,1,2,3,1,1,0,0,15468,7,18505,236,66,-969,409,23.6,1546.8,red,6,2,19,20,blue
4512529380,6,8,5,0,0,0,0,16881,7.2,18875,241,52,-259,1059,24.1,1688.1,8,6,9,0,0,0,0,17140,7,17816,188,47,259,-1059,18.8,1714,red,1.38,2.83,17,17,red
4492237019,2,3,3,1,1,0,0,15938,7.2,19963,242,72,443,1911,24.2,1593.8,3,2,1,0,0,0,0,15495,7,18052,244,56,-443,-1911,24.4,1549.5,blue,1.67,2,17,17,red
4464829363,4,4,4,1,1,0,0,15639,7,18956,230,60,-1233,270,23,1563.9,4,4,5,0,0,0,0,16872,7.2,18686,243,56,1233,-270,24.3,1687.2,red,2,2.25,164,22,red
4497800773,4,7,6,1,1,0,0,14582,6.4,16375,214,37,-2298,-2281,21.4,1458.2,7,4,7,0,0,0,0,16880,7,18656,213,53,2298,2281,21.3,1688,red,1.43,3.5,22,16,blue
4516015369,13,6,8,0,0,0,0,19537,7.4,19905,242,46,3608,2893,24.2,1953.7,6,13,10,1,1,0,0,15929,6.6,17012,188,53,-3608,-2893,18.8,1592.9,blue,3.5,1.23,15,18,blue
4513523498,1,5,2,0,0,0,0,14031,6.6,16789,223,52,-1762,-1592,22.3,1403.1,5,1,5,2,1,1,0,15793,7,18381,216,52,1762,1592,21.6,1579.3,red,0.6,10,20,25,red
4482210564,7,11,6,0,0,0,0,16749,7,17716,192,40,-2233,-1112,19.2,1674.9,11,7,10,1,1,0,0,18982,7.2,18828,215,58,2233,1112,21.5,1898.2,red,1.18,3,18,19,red
4484642493,6,3,5,0,0,0,0,16542,7,19014,214,63,1428,1200,21.4,1654.2,3,6,4,1,1,0,0,15114,7,17814,238,56,-1428,-1200,23.8,1511.4,blue,3.67,1.17,17,20,blue
4501540670,7,7,4,0,0,0,1,18053,7.4,19492,230,41,891,1526,23,1805.3,7,7,11,1,1,0,0,17162,7,17966,202,54,-891,-1526,20.2,1716.2,blue,1.57,2.57,81,15,blue
4515960899,11,3,13,1,1,0,0,18102,7,18787,216,56,1712,1178,21.6,1810.2,3,11,1,1,0,1,1,16390,6.8,17609,226,36,-1712,-1178,22.6,1639,red,8,0.36,16,17,blue
4495398614,9,12,11,0,0,0,0,17332,6.8,16861,170,47,-874,-1370,17,1733.2,12,9,11,0,0,0,0,18206,7.2,18231,218,48,874,1370,21.8,1820.6,blue,1.67,2.56,15,18,blue
4391260446,10,7,11,2,1,1,0,17748,7,19116,206,43,1212,2099,20.6,1774.8,7,10,10,0,0,0,0,16536,7,17017,191,40,-1212,-2099,19.1,1653.6,blue,3,1.7,48,22,red
4497828505,6,10,4,0,0,0,0,17034,7.2,18358,210,60,-370,555,21,1703.4,10,6,11,1,1,0,0,17404,6.8,17803,201,47,370,-555,20.1,1740.4,red,1,3.5,79,18,red
4470106010,6,5,4,1,1,0,0,16000,7.2,18965,181,79,230,1894,18.1,1600,5,6,4,0,0,0,0,15770,6.8,17071,236,36,-230,-1894,23.6,1577,red,2,1.5,22,17,red
4526078945,6,4,7,0,0,0,0,16655,7,18545,217,51,474,-102,21.7,1665.5,4,6,11,1,1,0,0,16181,7.2,18647,234,63,-474,102,23.4,1618.1,blue,3.25,2.5,24,16,blue
4526009569,1,9,3,0,0,0,0,13719,6.4,16024,202,43,-4492,-4085,20.2,1371.9,9,1,8,0,0,0,0,18211,7.6,20109,219,75,4492,4085,21.9,1821.1,red,0.44,17,39,19,red
4472995795,5,3,7,0,0,0,0,17264,7,18301,248,44,3037,2561,24.8,1726.4,3,5,2,0,0,0,0,14227,6.4,15740,174,60,-3037,-2561,17.4,1422.7,blue,4,1,13,26,blue
4505777098,3,7,2,0,0,0,0,14725,6.6,17519,210,36,-2686,-1780,21,1472.5,7,3,11,0,0,0,0,17411,7.2,19299,242,39,2686,1780,24.2,1741.1,red,0.71,6,91,15,blue
4467751536,4,6,2,0,0,0,0,14360,6.6,16876,175,39,-3424,-1550,17.5,1436,6,4,4,1,1,0,1,17784,7.2,18426,207,48,3424,1550,20.7,1778.4,red,1,2.5,17,22,red
4511833279,6,6,6,0,0,0,0,16223,6.8,17419,233,52,135,-338,23.3,1622.3,6,6,9,1,1,0,0,16088,6.8,17757,202,56,-135,338,20.2,1608.8,blue,2,2.5,20,21,blue
4465757156,6,2,7,0,0,0,0,16695,6.8,17863,236,51,1755,717,23.6,1669.5,2,6,1,1,1,0,0,14940,6.8,17146,234,52,-1755,-717,23.4,1494,blue,6.5,0.5,20,40,blue
4461974957,5,10,5,0,0,0,0,16297,7.2,19135,212,66,-2523,-1057,21.2,1629.7,10,5,10,0,0,0,0,18820,7.4,20192,236,60,2523,1057,23.6,1882,blue,1,4,35,16,red
4462322651,2,6,2,2,1,1,0,15386,7.2,18832,246,60,-1402,-1003,24.6,1538.6,6,2,4,0,0,0,0,16788,7.6,19835,264,51,1402,1003,26.4,1678.8,blue,0.67,5,18,15,red
4523976473,6,1,9,2,1,1,1,18435,7.2,18643,254,44,4751,641,25.4,1843.5,1,6,0,0,0,0,0,13684,6.8,18002,203,52,-4751,-641,20.3,1368.4,blue,15,0.17,18,12,blue
4462203064,7,4,8,0,0,0,0,17008,7.2,18978,216,44,1238,1037,21.6,1700.8,4,7,5,1,1,0,0,15770,6.8,17941,231,52,-1238,-1037,23.1,1577,blue,3.75,1.29,21,20,red
4503181649,5,2,8,0,0,0,0,16684,7.4,19585,240,59,2672,1784,24,1668.4,2,5,2,0,0,0,0,14012,7,17801,220,47,-2672,-1784,22,1401.2,blue,6.5,0.8,22,17,blue
4442045981,9,4,5,1,1,0,0,17965,7.4,20621,229,64,2954,4490,22.9,1796.5,4,9,8,0,0,0,0,15011,6.4,16131,208,41,-2954,-4490,20.8,1501.1,blue,3.5,1.33,74,20,blue
4500506484,5,5,10,1,1,0,0,16737,6.8,17553,231,52,272,-467,23.1,1673.7,5,5,8,0,0,0,0,16465,7,18020,218,48,-272,467,21.8,1646.5,blue,3,2.6,35,17,blue
4479932808,1,3,1,0,0,0,0,13638,6.8,16479,190,59,-2033,-1612,19,1363.8,3,1,3,0,0,0,0,15671,7.2,18091,238,47,2033,1612,23.8,1567.1,red,0.67,6,18,22,red
4409386215,4,3,4,0,0,0,0,15838,6.8,18368,221,62,-348,-901,22.1,1583.8,3,4,4,1,1,0,0,16186,7.2,19269,261,66,348,901,26.1,1618.6,red,2.67,1.75,26,21,blue
4437014946,3,2,3,0,0,0,0,15734,7,18750,236,68,465,-911,23.6,1573.4,2,3,1,1,1,0,0,15269,7.2,19661,226,76,-465,911,22.6,1526.9,red,3,1,16,85,blue
4491431889,8,9,8,0,0,0,0,17802,7.2,18241,226,55,-201,-14,22.6,1780.2,9,8,11,1,1,0,0,18003,6.8,18255,203,52,201,14,20.3,1800.3,red,1.78,2.5,18,22,blue
4486499465,7,9,7,0,0,0,0,16149,6.4,16018,186,48,-393,-478,18.6,1614.9,9,7,7,0,0,0,0,16542,6.4,16496,173,48,393,478,17.3,1654.2,blue,1.56,2.29,18,16,blue
4512587987,3,9,3,0,0,0,0,14719,6.6,16608,195,52,-3485,-2423,19.5,1471.9,9,3,12,1,1,0,0,18204,7.2,19031,237,50,3485,2423,23.7,1820.4,red,0.67,7,17,40,blue
4410192659,6,8,6,0,0,0,0,15883,6.8,16480,228,28,-791,-2157,22.8,1588.3,8,6,7,0,0,0,0,16674,6.8,18637,213,48,791,2157,21.3,1667.4,red,1.5,2.5,14,17,red
4505610970,15,8,24,0,0,0,0,19917,7,18396,209,28,3759,1339,20.9,1991.7,8,15,8,1,1,0,0,16158,6.8,17057,172,55,-3759,-1339,17.2,1615.8,blue,4.88,1.07,31,19,blue
4526544291,7,8,10,0,0,0,0,16137,6.4,17136,203,48,-1563,-1007,20.3,1613.7,8,7,8,1,1,0,0,17700,7,18143,219,48,1563,1007,21.9,1770,red,2.12,2.29,20,19,red
4514425607,7,4,4,1,0,1,0,17994,7.2,20156,269,48,3033,3187,26.9,1799.4,4,7,4,1,1,0,0,14961,6.6,16969,206,44,-3033,-3187,20.6,1496.1,red,2.75,1.14,19,17,red
4452228031,9,5,4,1,1,0,0,17693,7.2,19209,226,60,2120,2142,22.6,1769.3,5,9,6,0,0,0,0,15573,6.8,17067,178,52,-2120,-2142,17.8,1557.3,blue,2.6,1.22,131,46,blue
4423136265,6,4,6,0,0,0,0,16184,6.8,18288,224,48,-382,-247,22.4,1618.4,4,6,6,0,0,0,0,16566,7.2,18535,242,59,382,247,24.2,1656.6,blue,3,1.67,17,21,blue
4526920856,4,5,3,1,1,0,0,15791,7,18218,220,56,-478,346,22,1579.1,5,4,4,0,0,0,0,16269,7,17872,247,42,478,-346,24.7,1626.9,red,1.4,2.25,26,19,red
4489787025,3,2,2,0,0,0,0,15426,7,17927,202,64,566,-248,20.2,1542.6,2,3,0,0,0,0,0,14860,6.8,18175,249,52,-566,248,24.9,1486,red,2.5,0.67,20,137,blue
4491765762,5,3,7,1,1,0,0,16885,7.2,18326,229,52,2657,2468,22.9,1688.5,3,5,4,0,0,0,0,14228,6.4,15858,200,36,-2657,-2468,20,1422.8,red,4,1.4,18,16,blue
4451821740,5,6,7,1,1,0,0,15880,7.2,18313,219,64,-1891,263,21.9,1588,6,5,4,0,0,0,1,17771,7,18050,236,56,1891,-263,23.6,1777.1,red,2,2,17,17,red
4463266834,6,6,10,1,1,0,0,16701,7,17762,196,56,-16,-467,19.6,1670.1,6,6,3,0,0,0,0,16717,7.2,18229,232,47,16,467,23.2,1671.7,blue,2.67,1.5,17,18,red
4415176080,8,6,6,0,0,0,0,17040,7.2,18469,230,56,1740,929,23,1704,6,8,5,1,1,0,0,15300,6.8,17540,198,48,-1740,-929,19.8,1530,red,2.33,1.38,14,16,blue
4526130313,2,3,2,1,0,1,0,13703,6.8,16964,187,48,-1912,-957,18.7,1370.3,3,2,0,0,0,0,0,15615,7,17921,241,56,1912,957,24.1,1561.5,blue,1.33,1.5,26,15,red
4526546441,8,9,1,1,1,0,0,16953,7,18996,238,52,-515,649,23.8,1695.3,9,8,11,0,0,0,0,17468,7.2,18347,211,40,515,-649,21.1,1746.8,red,1,2.5,15,20,red
4524250490,6,4,1,0,0,0,0,16327,7,18521,190,59,1570,1320,19,1632.7,4,6,1,1,1,0,0,14757,6.8,17201,214,56,-1570,-1320,21.4,1475.7,blue,1.75,0.83,19,17,red
4526934596,6,3,6,0,0,0,0,17854,7.6,20729,260,80,3215,3092,26,1785.4,3,6,3,0,0,0,0,14639,6.6,17637,194,55,-3215,-3092,19.4,1463.9,blue,4,1,22,18,blue
4520794662,12,7,14,0,0,0,0,19970,7.2,19994,221,56,3605,3504,22.1,1997,7,12,8,0,0,0,0,16365,6.4,16490,186,53,-3605,-3504,18.6,1636.5,blue,3.71,1.25,13,23,red
4474203677,6,6,5,1,1,0,0,16010,7,17522,231,50,-210,-589,23.1,1601,6,6,7,0,0,0,0,16220,7,18111,218,53,210,589,21.8,1622,red,1.83,2.17,28,26,blue
4525011437,9,11,12,0,0,0,0,16899,6.8,16675,180,39,-1507,-1389,18,1689.9,11,9,14,2,1,1,0,18406,7,18064,217,48,1507,1389,21.7,1840.6,blue,1.91,2.78,20,17,red
4504994778,9,11,10,0,0,0,0,16256,6.6,16283,154,44,-1114,-1440,15.4,1625.6,11,9,15,1,1,0,0,17370,7,17723,191,40,1114,1440,19.1,1737,red,1.73,2.89,13,179,blue
4519487063,6,5,6,0,0,0,0,16676,7,18660,238,60,333,926,23.8,1667.6,5,6,9,0,0,0,0,16343,6.8,17734,241,44,-333,-926,24.1,1634.3,red,2.4,2.33,15,16,red
4462140519,11,7,13,1,1,0,0,18877,7.2,19556,209,54,1711,1767,20.9,1887.7,7,11,7,0,0,0,0,17166,7,17789,215,46,-1711,-1767,21.5,1716.6,blue,3.43,1.27,18,18,red
4526575643,4,6,6,0,0,0,0,14827,6.6,16610,187,43,-2322,-1522,18.7,1482.7,6,4,5,1,1,0,0,17149,7,18132,222,68,2322,1522,22.2,1714.9,red,1.67,2.75,22,18,red
4512536744,5,5,3,0,0,0,0,16098,7,17950,244,47,65,351,24.4,1609.8,5,5,9,0,0,0,0,16033,6.6,17599,208,63,-65,-351,20.8,1603.3,red,1.6,2.8,27,25,blue
4511705430,4,4,3,1,1,0,0,15237,6.8,17162,224,56,-305,242,22.4,1523.7,4,4,5,0,0,0,0,15542,6.4,16920,201,57,305,-242,20.1,1554.2,red,1.75,2.25,17,30,blue
4518980020,6,4,3,0,0,0,0,16796,7.4,19792,256,59,311,707,25.6,1679.6,4,6,4,1,1,0,0,16485,7.2,19085,241,66,-311,-707,24.1,1648.5,red,2.25,1.33,11,18,red
4478853146,10,5,11,1,0,1,1,19323,7.4,19481,220,57,2728,1681,22,1932.3,5,10,7,0,0,0,0,16595,7,17800,241,34,-2728,-1681,24.1,1659.5,blue,4.2,1.2,19,19,red
4526978661,6,2,4,1,0,1,0,16127,6.8,17096,237,40,2329,1331,23.7,1612.7,2,6,4,1,1,0,0,13798,6.2,15765,186,47,-2329,-1331,18.6,1379.8,blue,5,1,18,19,blue
4459102512,9,6,12,0,0,0,0,17027,6.8,17004,175,49,573,48,17.5,1702.7,6,9,11,0,0,0,0,16454,7,16956,191,56,-573,-48,19.1,1645.4,blue,3.5,1.89,16,18,blue
4445714594,6,6,5,1,0,1,0,15965,6.8,17701,213,40,-865,-20,21.3,1596.5,6,6,7,1,1,0,0,16830,7,17721,204,59,865,20,20.4,1683,red,1.83,2.17,22,63,blue
4508898898,6,11,5,0,0,0,0,16167,7,18659,202,60,-2055,-214,20.2,1616.7,11,6,11,2,1,1,0,18222,7.2,18873,204,56,2055,214,20.4,1822.2,red,1,3.67,16,23,red
4438606528,10,3,9,1,1,0,0,18334,7,18032,225,40,3485,2447,22.5,1833.4,3,10,3,0,0,0,0,14849,6.4,15585,188,32,-3485,-2447,18.8,1484.9,blue,6.33,0.6,26,15,red
4526028711,3,7,4,0,0,0,0,15191,6.6,17269,214,61,-1848,-1472,21.4,1519.1,7,3,9,2,1,1,0,17039,7,18741,219,47,1848,1472,21.9,1703.9,red,1,5.33,22,24,red
4500313763,6,7,3,1,0,1,0,16132,7,18044,222,52,-1989,-735,22.2,1613.2,7,6,6,1,1,0,1,18121,7.4,18779,218,52,1989,735,21.8,1812.1,red,1.29,2.17,15,20,red
4486645307,3,6,2,0,0,0,0,15098,6.6,16937,232,50,-100,-305,23.2,1509.8,6,3,4,1,1,0,0,15198,6.8,17242,178,41,100,305,17.8,1519.8,blue,0.83,3.33,23,19,blue
4475586744,5,4,3,1,1,0,0,16261,7.2,19301,221,51,1320,839,22.1,1626.1,4,5,6,0,0,0,0,14941,7,18462,204,60,-1320,-839,20.4,1494.1,blue,2,2,15,16,blue
4502364167,5,7,9,0,0,0,0,16427,7.2,18653,248,44,-311,-544,24.8,1642.7,7,5,10,0,0,0,0,16738,7.2,19197,227,32,311,544,22.7,1673.8,blue,2,3.4,17,56,red
4474734161,6,10,10,0,0,0,0,14901,6.2,14483,170,38,-2834,-3402,17,1490.1,10,6,9,1,1,0,0,17735,7,17885,216,56,2834,3402,21.6,1773.5,red,1.6,3.17,14,30,red
4504658470,7,6,10,1,1,0,0,17070,6.8,18022,232,47,365,356,23.2,1707,6,7,10,0,0,0,0,16705,7,17666,201,50,-365,-356,20.1,1670.5,blue,2.83,2.29,19,17,red
4521311431,6,7,5,0,0,0,0,16217,6.8,17326,217,41,112,79,21.7,1621.7,7,6,8,2,1,1,0,16105,6.8,17247,225,43,-112,-79,22.5,1610.5,blue,1.57,2.5,19,18,blue
4448303779,10,2,10,1,0,1,0,18822,7.2,20135,253,59,4577,3717,25.3,1882.2,2,10,2,1,1,0,0,14245,6.6,16418,192,48,-4577,-3717,19.2,1424.5,blue,10,0.4,41,20,blue
4417418392,14,2,14,1,1,0,0,19185,7,18543,196,48,5794,3899,19.6,1918.5,2,14,1,0,0,0,0,13391,6,14644,166,46,-5794,-3899,16.6,1339.1,blue,14,0.21,20,20,blue
4517772897,3,9,3,0,0,0,0,14220,6.4,16333,203,41,-3673,-2973,20.3,1422,9,3,9,1,1,0,0,17893,7.4,19306,234,58,3673,2973,23.4,1789.3,red,0.67,6,15,20,blue
4526224124,8,2,8,1,1,0,0,18477,7.2,19589,248,51,3593,1136,24.8,1847.7,2,8,0,0,0,0,0,14884,7,18453,236,64,-3593,-1136,23.6,1488.4,blue,8,0.25,18,20,blue
4501238105,5,7,4,0,0,0,0,16324,7,18159,231,60,-330,55,23.1,1632.4,7,5,7,1,1,0,0,16654,7,18104,213,60,330,-55,21.3,1665.4,blue,1.29,2.8,17,19,blue
4476983984,4,8,4,1,1,0,0,15247,6.6,17064,209,56,-2720,-2473,20.9,1524.7,8,4,9,0,0,0,0,17967,7.2,19537,207,64,2720,2473,20.7,1796.7,red,1,4.25,18,15,blue
4508068981,6,4,4,1,1,0,0,17361,7.2,19308,208,72,1670,1765,20.8,1736.1,4,6,6,0,0,0,0,15691,6.8,17543,217,55,-1670,-1765,21.7,1569.1,blue,2.5,1.67,15,15,blue
4448434808,10,3,11,1,1,0,0,17793,7.6,19766,208,55,1988,1552,20.8,1779.3,3,10,2,0,0,0,0,15805,7,18214,217,53,-1988,-1552,21.7,1580.5,blue,7,0.5,14,17,red
4413141960,2,2,3,0,0,0,0,14619,6.6,16874,244,40,622,-1048,24.4,1461.9,2,2,1,1,1,0,0,13997,6.8,17922,198,51,-622,1048,19.8,1399.7,blue,2.5,1.5,19,44,blue
4481260961,5,5,5,0,0,0,0,15552,7,16960,211,44,726,-512,21.1,1555.2,5,5,3,1,1,0,0,14826,6.8,17472,192,42,-726,512,19.2,1482.6,blue,2,1.6,17,19,red
4527067159,5,1,5,1,0,1,0,17170,7.2,19662,258,48,2695,1696,25.8,1717,1,5,2,1,1,0,0,14475,6.8,17966,233,69,-2695,-1696,23.3,1447.5,blue,10,0.6,27,14,blue
4471738335,11,5,12,1,0,1,0,18658,7,19117,203,44,1603,1389,20.3,1865.8,5,11,6,0,0,0,0,17055,6.8,17728,229,51,-1603,-1389,22.9,1705.5,red,4.6,1,22,15,blue
4489690611,10,5,14,1,0,1,0,17857,6.8,17155,211,38,1879,-344,21.1,1785.7,5,10,5,0,0,0,0,15978,6.8,17499,227,34,-1879,344,22.7,1597.8,blue,4.8,1,21,20,blue
4456255419,2,7,3,0,0,0,0,14613,6.6,16611,219,44,-3238,-4114,21.9,1461.3,7,2,8,1,1,0,0,17851,7.6,20725,255,64,3238,4114,25.5,1785.1,red,0.71,7.5,22,20,red
4508671448,5,8,5,1,1,0,0,15359,6.8,17087,197,64,-2039,-484,19.7,1535.9,8,5,11,0,0,0,0,17398,7.2,17571,230,44,2039,484,23,1739.8,blue,1.25,3.8,23,20,red
4524784360,7,6,2,1,0,1,0,16756,7,18790,239,52,773,1285,23.9,1675.6,6,7,6,1,1,0,0,15983,6.8,17505,190,44,-773,-1285,19,1598.3,red,1.5,1.71,16,18,blue
4512998598,14,7,14,2,1,1,0,19984,7,19327,207,64,3140,3525,20.7,1998.4,7,14,9,0,0,0,0,16844,6.4,15802,201,40,-3140,-3525,20.1,1684.4,blue,4,1.14,21,44,blue
4472899697,5,6,2,0,0,0,0,15470,6.8,17451,211,44,-522,-577,21.1,1547,6,5,4,1,1,0,0,15992,7,18028,209,52,522,577,20.9,1599.2,red,1.17,2,15,43,blue
4519053243,9,12,15,0,0,0,0,16494,6.2,15865,156,40,-1484,-1528,15.6,1649.4,12,9,14,1,1,0,0,17978,6.6,17393,196,56,1484,1528,19.6,1797.8,red,2,2.89,18,16,blue
4518453664,6,5,6,0,0,0,0,15904,6.8,17623,201,48,-73,217,20.1,1590.4,5,6,6,2,1,1,0,15977,6.6,17406,228,48,73,-217,22.8,1597.7,red,2.4,1.83,48,19,red
4516120877,3,11,4,1,0,1,0,14423,6.8,16642,190,51,-4452,-3726,19,1442.3,11,3,8,1,1,0,0,18875,7.4,20368,238,64,4452,3726,23.8,1887.5,red,0.64,6.33,44,19,red
4470228230,3,5,3,0,0,0,0,15136,6.8,17202,216,52,-401,-995,21.6,1513.6,5,3,2,0,0,0,0,15537,7,18197,240,40,401,995,24,1553.7,red,1.2,2.33,13,13,red
4491884142,8,3,9,0,0,0,0,16681,7.2,18901,216,42,1650,1230,21.6,1668.1,3,8,1,2,1,1,0,15031,7,17671,224,54,-1650,-1230,22.4,1503.1,red,5.67,0.5,15,38,red
4468730592,2,6,2,0,0,0,0,14868,6.8,18004,230,58,-2681,-1941,23,1486.8,6,2,6,1,1,0,0,17549,7.2,19945,269,60,2681,1941,26.9,1754.9,red,0.67,6,20,15,red
4500229448,5,7,3,1,1,0,0,16103,6.8,17939,216,52,-511,303,21.6,1610.3,7,5,9,0,0,0,0,16614,7,17636,237,36,511,-303,23.7,1661.4,blue,1.14,3.2,51,20,red
4491026919,7,12,5,0,0,0,0,15674,6.4,15931,206,42,-3878,-3868,20.6,1567.4,12,7,15,1,1,0,0,19552,7.2,19799,207,55,3878,3868,20.7,1955.2,red,1,3.86,20,40,red
4469635375,3,9,1,0,0,0,0,14100,6.4,16543,189,52,-4603,-3046,18.9,1410,9,3,8,2,1,1,0,18703,7.2,19589,241,65,4603,3046,24.1,1870.3,red,0.44,5.67,15,21,red
4495742635,14,6,17,1,1,0,0,20177,7.8,21248,236,56,3696,3558,23.6,2017.7,6,14,5,0,0,0,0,16481,7,17690,207,47,-3696,-3558,20.7,1648.1,blue,5.17,0.79,17,10,blue
4466740420,4,4,7,1,1,0,0,15222,6.6,16755,207,51,7,-685,20.7,1522.2,4,4,4,0,0,0,0,15215,6.8,17440,212,52,-7,685,21.2,1521.5,blue,2.75,2,27,21,red
4455694504,4,9,3,0,0,0,0,14731,6.4,16109,188,44,-3354,-2698,18.8,1473.1,9,4,10,1,1,0,0,18085,7.2,18807,241,44,3354,2698,24.1,1808.5,red,0.78,4.75,16,20,blue
4493176020,3,8,2,0,0,0,0,14566,7,16999,190,45,-2414,-959,19,1456.6,8,3,12,0,0,0,0,16980,6.8,17958,218,45,2414,959,21.8,1698,red,0.62,6.67,18,21,blue
4490286186,10,7,13,1,1,0,0,17545,6.8,17316,179,55,-280,-752,17.9,1754.5,7,10,9,0,0,0,0,17825,6.8,18068,217,61,280,752,21.7,1782.5,red,3.29,1.6,18,42,blue
4509271270,3,8,6,1,1,0,0,15159,6.6,17161,221,65,-2341,-2034,22.1,1515.9,8,3,12,0,0,0,0,17500,7.2,19195,214,63,2341,2034,21.4,1750,blue,1.12,6.67,13,16,red
4524340195,4,6,3,0,0,0,0,15855,7,17820,212,71,-891,-768,21.2,1585.5,6,4,1,1,1,0,0,16746,7,18588,264,53,891,768,26.4,1674.6,red,1.17,1.75,16,15,red
4471351121,6,9,6,1,1,0,0,17023,7,17635,224,60,-355,-126,22.4,1702.3,9,6,11,0,0,0,0,17378,6.8,17761,209,39,355,126,20.9,1737.8,red,1.33,3.33,14,19,red
4511067613,8,7,9,1,1,0,0,17163,7.2,18565,221,60,515,1691,22.1,1716.3,7,8,14,0,0,0,0,16648,6.6,16874,211,43,-515,-1691,21.1,1664.8,red,2.43,2.62,21,16,red
4517937172,5,9,3,1,1,0,0,15875,7,18236,224,49,-1663,164,22.4,1587.5,9,5,14,0,0,0,0,17538,7,18072,173,54,1663,-164,17.3,1753.8,red,0.89,4.6,17,41,red
4525171527,6,3,6,1,1,0,0,14887,6.4,14486,159,36,-498,-2244,15.9,1488.7,3,6,1,1,0,1,0,15385,6.6,16730,227,56,498,2244,22.7,1538.5,blue,4,0.67,17,20,blue
4494067243,4,8,3,1,1,0,0,15330,6.6,16197,203,57,-2366,-3382,20.3,1533,8,4,12,0,0,0,0,17696,7.2,19579,229,51,2366,3382,22.9,1769.6,blue,0.88,5,22,21,blue
4518820210,2,6,2,0,0,0,0,14295,6.4,16196,211,40,-2514,-2762,21.1,1429.5,6,2,6,1,1,0,0,16809,7.2,18958,219,67,2514,2762,21.9,1680.9,red,0.67,6,13,59,red
4515686692,6,5,6,1,1,0,0,16454,6.8,17910,209,52,-247,-20,20.9,1645.4,5,6,6,0,0,0,0,16701,7,17930,227,48,247,20,22.7,1670.1,blue,2.4,1.83,17,37,red
4512970043,1,5,2,0,0,0,0,13951,7,17688,211,49,-2847,-318,21.1,1395.1,5,1,7,1,1,0,0,16798,7.2,18006,239,56,2847,318,23.9,1679.8,red,0.6,12,42,23,red
4479605659,3,2,4,0,0,0,0,16307,7.2,19846,255,64,1180,1124,25.5,1630.7,2,3,2,1,1,0,0,15127,7.2,18722,240,52,-1180,-1124,24,1512.7,red,3.5,1.33,14,18,blue
4519055084,8,14,12,2,1,1,0,16072,6.2,15157,170,28,-5540,-5343,17,1607.2,14,8,12,0,0,0,0,21612,7.6,20500,257,64,5540,5343,25.7,2161.2,red,1.43,3.25,24,25,red
4489508995,4,11,2,0,0,0,0,15515,6.8,17838,231,50,-2272,-2400,23.1,1551.5,11,4,7,1,1,0,0,17787,7.6,20238,225,44,2272,2400,22.5,1778.7,red,0.55,4.5,19,38,red
4452015662,3,5,5,2,1,1,0,15188,6.8,17576,221,48,-888,-975,22.1,1518.8,5,3,5,0,0,0,0,16076,7,18551,192,59,888,975,19.2,1607.6,blue,1.6,3.33,14,19,blue
4464761847,9,5,11,2,1,1,0,17791,7.2,18823,198,61,1090,342,19.8,1779.1,5,9,6,0,0,0,0,16701,6.8,18481,265,44,-1090,-342,26.5,1670.1,red,4,1.22,31,41,blue
4502752465,4,4,7,0,0,0,0,15813,7.2,18788,248,46,-80,470,24.8,1581.3,4,4,2,1,1,0,0,15893,7.2,18318,219,72,80,-470,21.9,1589.3,red,2.75,1.5,21,19,red
4486160462,3,2,3,1,0,1,0,14424,6.6,17499,201,48,-541,-66,20.1,1442.4,2,3,2,0,0,0,0,14965,6.8,17565,234,60,541,66,23.4,1496.5,red,3,1.33,14,9,blue
4432016778,12,8,13,0,0,0,0,19306,7.4,19792,218,32,1087,340,21.8,1930.6,8,12,8,2,1,1,0,18219,7.4,19452,222,60,-1087,-340,22.2,1821.9,red,3.12,1.33,17,18,red
4508144536,2,8,3,0,0,0,0,14348,7,17150,196,56,-3489,-2633,19.6,1434.8,8,2,12,1,1,0,0,17837,7.4,19783,239,52,3489,2633,23.9,1783.7,red,0.62,10,16,22,red
4508714816,2,6,1,0,0,0,0,14990,6.8,17870,221,69,-1510,-1756,22.1,1499,6,2,9,1,1,0,0,16500,7.4,19626,228,56,1510,1756,22.8,1650,red,0.5,7.5,15,14,red
4522662878,5,4,7,0,0,0,0,16129,7,18291,222,54,627,174,22.2,1612.9,4,5,5,1,1,0,0,15502,7.2,18117,219,57,-627,-174,21.9,1550.2,red,3,1.8,16,12,red
4467932600,9,4,5,1,1,0,0,18135,7.2,18974,233,48,2649,1251,23.3,1813.5,4,9,3,0,0,0,0,15486,6.8,17723,219,52,-2649,-1251,21.9,1548.6,blue,3.5,0.78,18,19,blue
4471961909,6,5,3,1,0,1,0,17039,7.2,18571,228,68,1008,372,22.8,1703.9,5,6,3,0,0,0,0,16031,6.8,18199,218,48,-1008,-372,21.8,1603.1,red,1.8,1.33,15,39,red
4466097305,3,7,2,1,1,0,0,14761,6.4,16905,194,53,-2553,-2532,19.4,1476.1,7,3,8,1,0,1,0,17314,7,19437,224,52,2553,2532,22.4,1731.4,red,0.71,5,16,18,red
4448485009,0,15,0,0,0,0,0,12971,6.4,14675,181,56,-6850,-6210,18.1,1297.1,15,0,16,1,1,0,0,19821,7.6,20885,236,40,6850,6210,23.6,1982.1,red,0,12.65,18,21,red
4520650769,4,3,3,0,0,0,0,15220,6.8,18562,234,44,-1297,-129,23.4,1522,3,4,4,0,0,0,0,16517,7,18691,241,56,1297,129,24.1,1651.7,blue,2.33,1.75,20,35,red
4509545038,12,6,14,1,1,0,0,18228,7.2,19302,196,55,2894,2297,19.6,1822.8,6,12,5,0,0,0,0,15334,6.6,17005,192,44,-2894,-2297,19.2,1533.4,blue,4.33,0.92,17,20,red
4520706902,6,7,12,0,0,0,0,17490,6.8,17883,226,56,480,-685,22.6,1749,7,6,12,0,0,0,0,17010,7,18568,220,67,-480,685,22,1701,blue,2.57,3.17,11,15,blue
4457611767,4,6,4,0,0,0,0,15338,7,17842,217,56,-849,-1172,21.7,1533.8,6,4,5,0,0,0,0,16187,7,19014,234,46,849,1172,23.4,1618.7,blue,1.33,2.75,22,17,blue
4524672129,11,9,15,1,1,0,0,19421,7.4,19063,215,62,2548,1873,21.5,1942.1,9,11,5,0,0,0,0,16873,7,17190,165,56,-2548,-1873,16.5,1687.3,blue,2.89,1.27,15,12,blue
4479796051,7,4,11,0,0,0,0,17321,7.2,18397,233,41,2091,2518,23.3,1732.1,4,7,6,1,1,0,0,15230,6.6,15879,204,60,-2091,-2518,20.4,1523,blue,4.5,1.43,22,23,red
4479878134,6,5,5,1,1,0,0,17170,7,18247,247,48,2453,1802,24.7,1717,5,6,4,0,0,0,0,14717,6.6,16445,178,40,-2453,-1802,17.8,1471.7,red,2.2,1.5,19,20,blue
4520324538,7,7,11,1,1,0,0,17162,7.2,18810,216,56,-810,123,21.6,1716.2,7,7,10,0,0,0,0,17972,7.2,18687,272,47,810,-123,27.2,1797.2,blue,2.57,2.43,16,24,red
4438638752,7,4,5,1,1,0,0,17382,7.4,19669,218,75,2164,3151,21.8,1738.2,4,7,7,0,0,0,0,15218,6.6,16518,205,48,-2164,-3151,20.5,1521.8,blue,3,1.57,28,37,blue
4518022998,7,7,6,0,0,0,0,16313,6.8,16697,201,40,-1249,-3078,20.1,1631.3,7,7,5,0,0,0,0,17562,7.4,19775,228,59,1249,3078,22.8,1756.2,red,1.86,1.71,28,25,blue
4463024546,2,4,2,0,0,0,0,15264,7,17806,217,64,-286,606,21.7,1526.4,4,2,6,2,1,1,0,15550,6.8,17200,235,47,286,-606,23.5,1555,blue,1,5,67,17,red
4526693928,3,12,2,0,0,0,0,15001,6.8,17600,228,51,-4625,-1892,22.8,1500.1,12,3,16,1,1,0,0,19626,7.2,19492,247,47,4625,1892,24.7,1962.6,red,0.42,9.33,17,12,red
4526974346,4,7,4,1,0,1,0,16938,7.2,18931,248,60,-377,414,24.8,1693.8,7,4,11,1,1,0,0,17315,7.2,18517,224,56,377,-414,22.4,1731.5,red,1.14,4.5,18,18,red
4491586738,10,5,4,1,0,1,1,19634,7.2,19705,242,69,3966,2905,24.2,1963.4,5,10,8,1,1,0,0,15668,6.6,16800,203,48,-3966,-2905,20.3,1566.8,blue,2.8,1.3,14,12,blue
4463159840,7,4,11,1,0,1,0,16782,7.2,19169,213,56,299,874,21.3,1678.2,4,7,3,0,0,0,0,16483,7,18295,230,56,-299,-874,23,1648.3,red,4.5,1,20,20,blue
4458803817,11,8,13,0,0,0,1,18723,6.8,17268,188,35,1844,-34,18.8,1872.3,8,11,6,1,1,0,0,16879,6.6,17302,210,40,-1844,34,21,1687.9,red,3,1.27,20,19,blue
4520878592,5,6,3,1,0,1,0,14644,6.8,16269,201,31,-2896,-2725,20.1,1464.4,6,5,5,1,1,0,0,17540,7.2,18994,242,56,2896,2725,24.2,1754,red,1.33,2.2,15,94,red
4487381952,14,12,11,0,0,0,0,19118,7.2,19312,218,29,646,1756,21.8,1911.8,12,14,13,1,0,1,0,18472,6.8,17556,211,46,-646,-1756,21.1,1847.2,blue,2.08,1.79,21,20,red
4526264918,0,4,0,0,0,0,0,13546,6.6,16240,198,63,-2831,-1725,19.8,1354.6,4,0,5,0,0,0,0,16377,7,17965,219,51,2831,1725,21.9,1637.7,red,0,12.65,40,24,red
4526369291,5,14,2,2,1,1,0,16431,6.6,16968,219,64,-3488,-2682,21.9,1643.1,14,5,18,0,0,0,0,19919,7.4,19650,240,43,3488,2682,24,1991.9,red,0.5,6.4,33,18,blue
4525810853,6,1,7,0,0,0,0,16561,7.4,19634,226,63,1852,2435,22.6,1656.1,1,6,2,1,1,0,0,14709,7,17199,238,60,-1852,-2435,23.8,1470.9,blue,13,0.5,18,18,blue
4457510743,3,7,3,0,0,0,0,14866,6.6,16219,208,43,-2140,-1892,20.8,1486.6,7,3,9,2,1,1,0,17006,6.8,18111,224,51,2140,1892,22.4,1700.6,red,0.86,5.33,60,17,red
4523681256,11,7,11,0,0,0,0,18625,7.2,18941,234,38,1059,683,23.4,1862.5,7,11,4,0,0,0,0,17566,6.8,18258,191,63,-1059,-683,19.1,1756.6,blue,3.14,1,16,11,blue
4523395238,9,2,8,1,1,0,0,17194,7.4,19161,221,40,2410,1034,22.1,1719.4,2,9,0,0,0,0,0,14784,6.8,18127,235,55,-2410,-1034,23.5,1478.4,blue,8.5,0.22,28,14,blue
4467764577,5,4,4,1,1,0,0,15873,7.2,18580,236,44,-14,-19,23.6,1587.3,4,5,4,0,0,0,0,15887,7.2,18599,232,55,14,19,23.2,1588.7,blue,2.25,1.6,19,24,red
4498469396,6,7,6,1,1,0,0,16398,7.2,17998,217,47,-940,-1019,21.7,1639.8,7,6,9,0,0,0,0,17338,7,19017,220,56,940,1019,22,1733.8,blue,1.71,2.67,17,39,blue
4518506408,8,5,4,1,0,1,1,17951,7.2,18661,244,50,2114,1904,24.4,1795.1,5,8,4,1,1,0,0,15837,6.4,16757,220,56,-2114,-1904,22,1583.7,red,2.4,1.12,17,21,blue
4525920930,3,2,4,1,1,0,0,15240,6.6,17591,234,52,323,392,23.4,1524,2,3,3,0,0,0,0,14917,6.6,17199,231,56,-323,-392,23.1,1491.7,red,3.5,1.67,18,15,red
4521657785,10,6,8,1,1,0,0,17561,6.8,18172,203,56,287,568,20.3,1756.1,6,10,4,0,0,0,0,17274,6.6,17604,228,41,-287,-568,22.8,1727.4,red,3,1,25,21,blue
4467685567,2,8,2,0,0,0,0,14200,6.6,17304,191,52,-3805,-2093,19.1,1420,8,2,9,1,1,0,0,18005,7,19397,230,60,3805,2093,23,1800.5,red,0.5,8.5,40,17,red
4512249103,5,9,2,0,0,0,0,16055,6.8,17800,226,50,6,1624,22.6,1605.5,9,5,15,1,1,0,0,16049,6.6,16176,160,40,-6,-1624,16,1604.9,blue,0.78,4.8,13,14,red
4473795908,7,2,6,0,0,0,1,19456,7.8,21097,230,76,4525,4052,23,1945.6,2,7,2,0,0,0,0,14931,6.6,17045,247,52,-4525,-4052,24.7,1493.1,blue,6.5,0.57,20,26,blue
4474429080,5,6,5,0,0,0,0,15923,7,17907,212,62,-228,-387,21.2,1592.3,6,5,5,1,1,0,0,16151,7,18294,230,48,228,387,23,1615.1,red,1.67,2.2,22,25,red
4511773311,2,3,2,1,1,0,0,13879,6.6,16393,194,44,-1499,-1628,19.4,1387.9,3,2,1,0,0,0,0,15378,7,18021,226,40,1499,1628,22.6,1537.8,blue,1.33,2,13,22,red
4518628901,9,4,9,0,0,0,0,17356,7.2,19154,195,50,2356,1297,19.5,1735.6,4,9,3,0,0,0,0,15000,7,17857,193,56,-2356,-1297,19.3,1500,blue,4.5,0.78,40,26,blue
4499790153,5,7,7,0,0,0,0,15861,6.8,17523,182,60,-1340,-228,18.2,1586.1,7,5,7,2,1,1,0,17201,6.8,17751,204,56,1340,228,20.4,1720.1,blue,1.71,2.8,18,18,blue
4518164964,8,2,9,1,1,0,0,17511,7.6,19617,220,60,2745,1800,22,1751.1,2,8,0,0,0,0,0,14766,6.8,17817,235,56,-2745,-1800,23.5,1476.6,blue,8.5,0.25,17,18,red
4476486795,4,6,4,0,0,0,0,15528,6.8,17590,230,43,-2446,-1508,23,1552.8,6,4,4,1,1,0,1,17974,7,19098,248,72,2446,1508,24.8,1797.4,red,1.33,2.5,74,19,red
4477434796,8,2,15,0,0,0,0,16393,7.2,18783,196,48,1131,1370,19.6,1639.3,2,8,3,1,1,0,0,15262,6.8,17413,253,50,-1131,-1370,25.3,1526.2,red,11.5,0.62,20,20,red
4477599823,9,5,16,0,0,0,0,17433,6.8,17284,198,32,1668,-774,19.8,1743.3,5,9,4,2,1,1,0,15765,7,18058,210,72,-1668,774,21,1576.5,blue,5,1,48,22,blue
4471395182,13,12,13,0,0,0,0,19714,7.2,18151,186,40,1460,2108,18.6,1971.4,12,13,13,0,0,0,0,18254,6.6,16043,200,35,-1460,-2108,20,1825.4,blue,2.17,1.92,19,16,red
4507608618,6,10,9,0,0,0,0,15569,6.8,17357,167,48,-4346,-2178,16.7,1556.9,10,6,11,1,1,0,0,19915,7.4,19535,239,72,4346,2178,23.9,1991.5,red,1.5,3.5,34,12,red
4513856068,8,7,14,1,1,0,0,17031,6.6,16530,181,54,-36,-641,18.1,1703.1,7,8,8,1,0,1,0,17067,6.8,17171,224,44,36,641,22.4,1706.7,blue,3.14,1.88,21,17,blue
4459085850,9,8,12,1,1,0,0,18254,7.2,18805,218,52,844,1636,21.8,1825.4,8,9,15,1,0,1,0,17410,6.8,17169,183,52,-844,-1636,18.3,1741,blue,2.62,2.56,14,19,blue
4517525849,6,8,4,0,0,0,0,16126,7,18226,201,61,-842,749,20.1,1612.6,8,6,6,1,1,0,0,16968,6.6,17477,230,51,842,-749,23,1696.8,red,1.25,2.33,19,18,red
4497178201,5,5,8,0,0,0,0,15937,7,17560,212,45,-1321,-1186,21.2,1593.7,5,5,5,1,1,0,0,17258,7.2,18746,241,64,1321,1186,24.1,1725.8,red,2.6,2,48,13,blue
4514268953,5,9,6,0,0,0,0,15595,6.6,16171,208,33,-1780,-2942,20.8,1559.5,9,5,5,1,1,0,0,17375,7,19113,231,44,1780,2942,23.1,1737.5,red,1.22,2.8,15,17,blue
4507604548,5,6,2,2,1,1,1,16874,6.8,17230,226,41,1319,556,22.6,1687.4,6,5,4,0,0,0,0,15555,6.8,16674,212,42,-1319,-556,21.2,1555.5,blue,1.17,2,23,25,blue
4521651698,5,2,2,1,1,0,0,16344,7.4,19730,234,59,2032,2833,23.4,1634.4,2,5,2,0,0,0,0,14312,6.8,16897,212,48,-2032,-2833,21.2,1431.2,blue,3.5,0.8,22,16,red
4504513789,5,3,4,0,0,0,0,15882,7.2,18646,214,63,-27,114,21.4,1588.2,3,5,3,1,1,0,0,15909,7.2,18532,254,53,27,-114,25.4,1590.9,red,3,1.2,22,22,blue
4519347640,6,9,2,0,0,0,0,15498,6.6,16711,201,47,-1384,-853,20.1,1549.8,9,6,9,1,1,0,0,16882,6.6,17564,190,64,1384,853,19,1688.2,red,0.89,3,18,18,blue
4509918642,10,1,5,0,0,0,1,19699,7.4,20307,251,43,5935,2933,25.1,1969.9,1,10,1,1,1,0,0,13764,7,17374,184,70,-5935,-2933,18.4,1376.4,blue,15,0.2,19,14,blue
4513296264,9,6,12,2,1,1,0,17320,6.8,17894,215,52,689,-913,21.5,1732,6,9,6,0,0,0,0,16631,7.2,18807,226,53,-689,913,22.6,1663.1,blue,3.5,1.33,24,26,blue
4436824730,2,6,2,0,0,0,0,14720,7.2,18456,246,46,-2381,-1122,24.6,1472,6,2,3,1,0,1,0,17101,7,19578,237,54,2381,1122,23.7,1710.1,blue,0.67,4.5,16,14,red
4524156095,6,5,6,0,0,0,0,16518,7.2,19187,223,56,51,140,22.3,1651.8,5,6,6,1,1,0,0,16467,7.2,19047,245,44,-51,-140,24.5,1646.7,red,2.4,1.83,19,18,blue
4477630964,8,6,9,0,0,0,0,17926,7.2,18959,245,53,2664,2155,24.5,1792.6,6,8,9,1,1,0,0,15262,6.8,16804,158,48,-2664,-2155,15.8,1526.2,red,2.83,1.88,22,47,blue
4504510674,5,6,6,0,0,0,0,16632,6.8,17833,215,59,999,482,21.5,1663.2,6,5,10,1,1,0,0,15633,7,17351,198,49,-999,-482,19.8,1563.3,blue,1.83,3.2,20,20,blue
4457462757,8,4,15,1,1,0,1,18357,7.2,18461,228,40,2757,970,22.8,1835.7,4,8,3,1,0,1,0,15600,6.8,17491,209,60,-2757,-970,20.9,1560,red,5.75,0.88,20,17,blue
4471508213,9,0,10,1,1,0,0,18258,7.4,19948,237,67,4535,3490,23.7,1825.8,0,9,0,0,0,0,0,13723,6.6,16458,237,50,-4535,-3490,23.7,1372.3,blue,12.03,0,20,18,blue
4500245820,8,6,6,1,1,0,0,16706,6.8,17561,216,36,31,-741,21.6,1670.6,6,8,7,1,0,1,0,16675,7,18302,231,52,-31,741,23.1,1667.5,red,2.33,1.62,16,18,blue
4526265417,7,2,10,1,1,0,0,18234,7.4,19881,243,64,4651,4293,24.3,1823.4,2,7,2,0,0,0,0,13583,6.2,15588,156,52,-4651,-4293,15.6,1358.3,blue,8.5,0.57,14,10,blue
4487407222,3,12,3,0,0,0,0,14202,6.4,16159,200,42,-4552,-2289,20,1420.2,12,3,16,1,1,0,0,18754,7.2,18448,223,35,4552,2289,22.3,1875.4,red,0.5,9.33,12,17,red
4510920346,7,3,4,1,1,0,0,17911,7.2,18635,248,60,3969,1119,24.8,1791.1,3,7,2,0,0,0,0,13942,6.8,17516,164,37,-3969,-1119,16.4,1394.2,blue,3.67,0.71,22,17,blue
4519835303,0,5,0,0,0,0,0,13094,6.4,15865,205,44,-3915,-4094,20.5,1309.4,5,0,2,1,1,0,0,17009,7.4,19959,259,73,3915,4094,25.9,1700.9,red,0,12.65,17,45,red
4502054946,8,4,11,0,0,0,0,17476,7.2,19033,245,52,1716,1970,24.5,1747.6,4,8,8,0,0,0,0,15760,6.6,17063,209,48,-1716,-1970,20.9,1576,red,4.75,1.5,19,18,red
4499336930,5,8,6,0,0,0,0,16979,7.2,19193,247,56,-988,-797,24.7,1697.9,8,5,6,1,1,0,0,17967,7.4,19990,219,63,988,797,21.9,1796.7,red,1.38,2.8,19,13,blue
4479685423,2,9,2,0,0,0,0,13977,6.2,15531,197,52,-4221,-3570,19.7,1397.7,9,2,14,1,1,0,0,18198,7,19101,233,44,4221,3570,23.3,1819.8,red,0.44,11.5,27,17,red
4526199821,4,6,8,1,1,0,0,14345,6.4,15396,172,41,-2053,-2608,17.2,1434.5,6,4,10,0,0,0,0,16398,6.8,18004,208,56,2053,2608,20.8,1639.8,red,2,4,19,16,blue
4508246222,4,4,3,0,0,0,0,15601,6.8,17171,232,48,415,14,23.2,1560.1,4,4,5,1,1,0,0,15186,6.8,17157,202,70,-415,-14,20.2,1518.6,red,1.75,2.25,20,18,blue
4462682935,5,5,8,0,0,0,0,14966,6.4,16483,177,45,-1470,-1837,17.7,1496.6,5,5,10,1,1,0,0,16436,7,18320,220,59,1470,1837,22,1643.6,red,2.6,3,26,22,blue
4486463961,4,2,2,0,0,0,0,16127,7.2,18510,225,63,1439,755,22.5,1612.7,2,4,1,1,1,0,0,14688,6.8,17755,210,72,-1439,-755,21,1468.8,blue,3,0.75,16,13,blue
4488120738,8,11,5,0,0,0,0,17156,6.8,17559,195,61,-1534,-1425,19.5,1715.6,11,8,16,1,1,0,0,18690,7.2,18984,204,45,1534,1425,20.4,1869,red,1.18,3.38,21,15,red
4494758719,5,5,2,0,0,0,0,15790,6.6,16936,221,48,-175,-624,22.1,1579,5,5,5,2,1,1,0,15965,7,17560,205,59,175,624,20.5,1596.5,red,1.4,2,21,15,red
4518204100,6,9,5,0,0,0,0,16462,7.2,18654,212,59,-1785,-940,21.2,1646.2,9,6,8,1,1,0,0,18247,7.2,19594,232,54,1785,940,23.2,1824.7,red,1.22,2.83,40,140,red
4489127821,4,7,3,1,0,1,0,15798,6.8,17608,225,52,-2289,-2259,22.5,1579.8,7,4,10,1,1,0,0,18087,7.4,19867,239,60,2289,2259,23.9,1808.7,red,1,4.25,15,18,red
4448198434,6,1,7,0,0,0,0,17666,7.2,20014,264,63,3749,3555,26.4,1766.6,1,6,1,0,0,0,0,13917,6.4,16459,214,47,-3749,-3555,21.4,1391.7,blue,13,0.33,16,20,red
4475014594,9,1,8,0,0,0,0,18018,7.4,19634,234,60,4287,3536,23.4,1801.8,1,9,0,1,1,0,0,13731,6.6,16098,209,47,-4287,-3536,20.9,1373.1,blue,17,0.11,19,15,red
4474906958,6,7,10,1,0,1,0,16027,6.6,16856,212,44,-177,-113,21.2,1602.7,7,6,8,1,1,0,0,16204,6.4,16969,183,48,177,113,18.3,1620.4,blue,2.29,2.5,22,21,red
4481320434,9,1,12,0,0,0,0,18681,7.4,20293,249,59,5492,4505,24.9,1868.1,1,9,1,1,0,1,0,13189,6.4,15788,181,48,-5492,-4505,18.1,1318.9,blue,21,0.22,25,12,blue
4521695253,10,5,7,1,1,0,0,17671,7,18386,231,44,1726,1158,23.1,1767.1,5,10,3,0,0,0,0,15945,6.6,17228,199,56,-1726,-1158,19.9,1594.5,blue,3.4,0.8,23,15,blue
4476404495,4,7,2,1,1,0,0,15974,6.8,17188,227,48,-836,-839,22.7,1597.4,7,4,10,0,0,0,0,16810,6.8,18027,217,40,836,839,21.7,1681,red,0.86,4.25,19,25,red
4470317561,6,1,4,0,0,0,0,16656,7.4,18706,230,56,2082,1304,23,1665.6,1,6,3,1,1,0,0,14574,6.8,17402,213,68,-2082,-1304,21.3,1457.4,blue,10,0.67,21,35,blue
4522332403,1,4,1,0,0,0,0,14224,6.8,16992,229,41,-1325,-1348,22.9,1422.4,4,1,4,1,1,0,0,15549,7,18340,223,72,1325,1348,22.3,1554.9,red,0.5,8,16,16,red
4525816909,4,7,4,1,1,0,0,16526,7,18314,237,63,-36,-752,23.7,1652.6,7,4,8,0,0,0,0,16562,7.2,19066,225,60,36,752,22.5,1656.2,blue,1.14,3.75,20,21,red
4494820470,7,8,9,1,1,0,0,16890,6.8,17686,221,53,-1647,-1443,22.1,1689,8,7,9,1,0,1,0,18537,7.2,19129,223,60,1647,1443,22.3,1853.7,blue,2,2.43,13,12,blue
4503039394,7,3,11,0,0,0,0,16879,7.4,19019,237,43,2336,2323,23.7,1687.9,3,7,3,0,0,0,0,14543,6.8,16696,194,51,-2336,-2323,19.4,1454.3,blue,6,0.86,42,13,blue
4524768986,12,10,13,1,1,0,0,19622,7,18338,216,54,1997,-800,21.6,1962.2,10,12,8,0,0,0,0,17625,7,19138,211,56,-1997,800,21.1,1762.5,blue,2.5,1.5,18,18,blue
4493885121,7,2,7,0,0,0,0,16867,7.2,18880,226,47,2333,1998,22.6,1686.7,2,7,3,1,1,0,0,14534,6.6,16882,224,56,-2333,-1998,22.4,1453.4,blue,7,0.71,18,15,red
4494027613,4,7,3,1,0,1,0,15874,7,18205,223,68,-1024,940,22.3,1587.4,7,4,10,1,1,0,0,16898,6.8,17265,217,47,1024,-940,21.7,1689.8,red,1,4.25,17,16,red
4513302428,8,9,9,1,1,0,0,16789,6.8,17799,205,40,-898,-1077,20.5,1678.9,9,8,13,0,0,0,0,17687,7.2,18876,199,68,898,1077,19.9,1768.7,red,1.89,2.75,21,19,blue
4525859252,8,4,9,2,1,1,0,17315,7,18205,231,51,1327,566,23.1,1731.5,4,8,5,0,0,0,0,15988,6.8,17639,232,50,-1327,-566,23.2,1598.8,blue,4.25,1.12,19,85,blue
4454291477,5,10,1,0,0,0,0,15605,7,19324,216,58,-2048,-29,21.6,1560.5,10,5,13,1,1,0,0,17653,7.4,19353,221,52,2048,29,22.1,1765.3,blue,0.6,4.6,15,12,red
4470267464,3,11,2,0,0,0,0,15059,6.8,17650,200,57,-3606,-1971,20,1505.9,11,3,18,1,1,0,0,18665,7.2,19621,208,46,3606,1971,20.8,1866.5,red,0.45,9.67,11,13,blue
4526620130,10,2,9,2,1,1,0,18137,7,18171,231,44,3807,1830,23.1,1813.7,2,10,3,0,0,0,0,14330,6.6,16341,204,43,-3807,-1830,20.4,1433,blue,9.5,0.5,20,18,blue
4520936512,4,6,2,0,0,0,0,14698,6.6,16713,192,51,-1341,-339,19.2,1469.8,6,4,9,2,1,1,0,16039,7,17052,197,56,1341,339,19.7,1603.9,blue,1,3.75,18,15,blue
4500348663,5,4,5,0,0,0,0,15788,6.8,18069,200,56,647,481,20,1578.8,4,5,2,2,1,1,0,15141,7,17588,228,56,-647,-481,22.8,1514.1,red,2.5,1.2,46,22,blue
4474924285,2,3,1,0,0,0,0,15464,6.8,17569,237,64,209,250,23.7,1546.4,3,2,1,0,0,0,0,15255,6.8,17319,242,29,-209,-250,24.2,1525.5,blue,1,2,14,16,blue
4524213588,7,5,6,1,0,1,0,17042,7.4,19460,207,60,934,776,20.7,1704.2,5,7,4,0,0,0,0,16108,7.4,18684,248,48,-934,-776,24.8,1610.8,red,2.6,1.29,14,9,red
4492128831,5,8,6,0,0,0,0,15242,6.4,16237,204,44,-1707,-1600,20.4,1524.2,8,5,10,1,1,0,0,16949,6.8,17837,231,51,1707,1600,23.1,1694.9,red,1.38,3.6,22,35,red
4511536801,3,4,4,0,0,0,0,16125,7.2,20079,246,68,-624,1141,24.6,1612.5,4,3,6,1,1,0,0,16749,7,18938,271,60,624,-1141,27.1,1674.9,blue,1.75,3.33,16,16,blue
4526622079,10,2,7,1,1,0,0,17955,7.4,20629,241,54,3912,5044,24.1,1795.5,2,10,3,0,0,0,0,14043,6.2,15585,182,52,-3912,-5044,18.2,1404.3,blue,8.5,0.5,17,15,red
4447355844,5,4,3,1,1,0,0,15277,6.6,17240,207,47,-387,795,20.7,1527.7,4,5,5,0,0,0,0,15664,6.4,16445,217,59,387,-795,21.7,1566.4,blue,2,1.8,46,32,blue
4499643197,5,6,7,1,1,0,0,15087,6.4,16343,213,44,-764,-120,21.3,1508.7,6,5,12,0,0,0,0,15851,6.6,16463,211,48,764,120,21.1,1585.1,blue,2,3.6,21,18,red
4501831991,8,6,9,0,0,0,0,16880,7.2,18007,217,55,1313,1407,21.7,1688,6,8,6,0,0,0,0,15567,6.4,16600,181,52,-1313,-1407,18.1,1556.7,blue,2.83,1.5,15,18,red
4484240174,8,2,10,2,1,1,0,17878,6.8,18056,216,52,4347,2472,21.6,1787.8,2,8,2,0,0,0,0,13531,6.2,15584,179,48,-4347,-2472,17.9,1353.1,blue,9,0.5,38,57,blue
4519341811,12,5,10,0,0,0,0,19270,7.6,19668,229,55,3855,1646,22.9,1927,5,12,1,2,1,1,0,15415,7,18022,213,56,-3855,-1646,21.3,1541.5,blue,4.4,0.5,43,13,blue
4514842699,6,0,6,1,1,0,0,15318,7,17999,191,58,1125,299,19.1,1531.8,0,6,0,0,0,0,0,14193,7,17700,251,40,-1125,-299,25.1,1419.3,blue,12.03,0,18,18,blue
4468739944,8,5,16,1,1,0,0,16291,6.8,16847,179,42,478,1166,17.9,1629.1,5,8,8,0,0,0,0,15813,6.4,15681,205,40,-478,-1166,20.5,1581.3,blue,4.8,1.62,19,24,red
4524775496,8,7,9,1,1,0,0,17738,7.2,18849,209,63,1868,1432,20.9,1773.8,7,8,3,0,0,0,0,15870,7,17417,207,49,-1868,-1432,20.7,1587,blue,2.43,1.25,13,19,red
4525368268,6,4,6,0,0,0,0,16765,7,19056,201,46,1711,1464,20.1,1676.5,4,6,2,1,1,0,0,15054,6.6,17592,240,49,-1711,-1464,24,1505.4,blue,3,1,22,17,blue
4451359541,8,4,10,1,1,0,0,16912,7,17678,222,38,1416,-211,22.2,1691.2,4,8,3,0,0,0,0,15496,6.8,17889,196,60,-1416,211,19.6,1549.6,blue,4.5,0.88,14,15,blue
4512183773,2,5,1,1,0,1,0,14534,7,17364,224,60,-2269,-1616,22.4,1453.4,5,2,7,1,1,0,0,16803,7,18980,250,64,2269,1616,25,1680.3,blue,0.6,6,18,19,blue
4502501343,8,7,10,1,1,0,0,17289,6.8,18113,201,62,69,-119,20.1,1728.9,7,8,5,1,0,1,0,17220,7,18232,237,49,-69,119,23.7,1722,blue,2.57,1.5,15,19,blue
4526952901,6,5,3,2,1,1,1,17948,7,18736,247,48,2435,894,24.7,1794.8,5,6,7,0,0,0,0,15513,6.8,17842,219,35,-2435,-894,21.9,1551.3,blue,1.8,2,19,19,blue
4503813130,7,8,3,0,0,0,0,16058,7,17194,200,49,-535,1397,20,1605.8,8,7,5,1,1,0,0,16593,6.6,15797,198,40,535,-1397,19.8,1659.3,blue,1.25,1.86,15,15,blue
4465455214,7,8,8,1,1,0,0,17112,7,18050,215,52,-975,-678,21.5,1711.2,8,7,10,1,0,1,0,18087,7,18728,225,68,975,678,22.5,1808.7,red,1.88,2.57,20,20,blue
4526735110,5,6,3,2,1,1,0,16089,7,18217,227,63,-704,-1227,22.7,1608.9,6,5,4,0,0,0,0,16793,7.2,19444,237,56,704,1227,23.7,1679.3,red,1.33,2,17,43,red
4463080911,6,7,7,0,0,0,0,17132,7.2,19401,237,71,789,1620,23.7,1713.2,7,6,6,0,0,0,0,16343,7,17781,209,32,-789,-1620,20.9,1634.3,red,1.86,2.17,21,17,red
4498444821,8,6,9,0,0,0,0,17777,7.4,18847,232,52,1317,1480,23.2,1777.7,6,8,8,1,0,1,0,16460,6.8,17367,202,40,-1317,-1480,20.2,1646,blue,2.83,1.75,25,15,blue
4519327182,9,8,13,0,0,0,0,18808,7.2,19323,244,40,948,292,24.4,1880.8,8,9,10,1,1,0,0,17860,7,19031,234,71,-948,-292,23.4,1786,blue,2.75,2,16,18,red
4525329096,2,4,2,0,0,0,0,14842,7,17857,231,48,270,679,23.1,1484.2,4,2,3,1,1,0,0,14572,6.8,17178,193,41,-270,-679,19.3,1457.2,red,1,3.5,17,19,blue
4484449974,5,0,4,1,0,1,0,16475,7.2,18879,231,55,2741,868,23.1,1647.5,0,5,0,1,1,0,0,13734,7,18011,233,60,-2741,-868,23.3,1373.4,blue,12.03,0,18,14,blue
4512485280,8,2,10,0,0,0,0,17917,7,17502,239,48,3201,276,23.9,1791.7,2,8,3,1,1,0,0,14716,6.8,17226,197,72,-3201,-276,19.7,1471.6,blue,9,0.62,19,16,red
4526992864,6,4,11,0,0,0,0,16324,6.8,17601,197,47,541,875,19.7,1632.4,4,6,3,0,0,0,0,15783,6.8,16726,240,44,-541,-875,24,1578.3,red,4.25,1.17,17,17,blue
4518157842,5,6,5,1,1,0,0,16308,7.2,18876,245,64,-1055,-207,24.5,1630.8,6,5,5,1,0,1,0,17363,7.2,19083,259,60,1055,207,25.9,1736.3,blue,1.67,2.2,46,32,red
4526466522,4,8,3,0,0,0,0,14756,6.8,17655,184,56,-4105,-2279,18.4,1475.6,8,4,8,1,1,0,0,18861,7.4,19934,229,63,4105,2279,22.9,1886.1,red,0.88,4,19,18,red
4517978315,4,9,4,0,0,0,0,14820,6.6,15946,184,44,-4156,-2933,18.4,1482,9,4,15,1,0,1,0,18976,7,18879,240,48,4156,2933,24,1897.6,blue,0.89,6,19,20,red
4451637903,3,1,2,0,0,0,0,15624,6.8,17633,233,56,1579,893,23.3,1562.4,1,3,1,2,1,1,0,14045,6.6,16740,222,64,-1579,-893,22.2,1404.5,blue,5,0.67,22,20,blue
4439856081,4,11,3,0,0,0,0,15098,6.8,18104,225,55,-3779,-1537,22.5,1509.8,11,4,10,2,1,1,0,18877,7.4,19641,227,42,3779,1537,22.7,1887.7,red,0.64,5.25,18,14,red
4476200313,8,2,6,1,1,0,0,17315,7.2,18903,232,47,4064,3736,23.2,1731.5,2,8,1,0,0,0,0,13251,6.2,15167,181,45,-4064,-3736,18.1,1325.1,blue,7,0.38,20,22,red
4462311511,1,6,2,0,0,0,0,13981,6.6,16753,220,52,-2494,-996,22,1398.1,6,1,3,0,0,0,0,16475,6.8,17749,250,44,2494,996,25,1647.5,red,0.5,9,40,16,blue
4526394559,6,6,9,1,1,0,0,15602,6.6,16235,195,48,-1081,-2155,19.5,1560.2,6,6,4,0,0,0,0,16683,7,18390,214,48,1081,2155,21.4,1668.3,red,2.5,1.67,18,15,blue
4505679661,9,3,9,0,0,0,0,17569,6.8,17425,191,61,2975,994,19.1,1756.9,3,9,4,0,0,0,0,14594,6.8,16431,180,53,-2975,-994,18,1459.4,blue,6,0.78,17,38,blue
4523304225,7,8,15,1,1,0,0,15381,6.2,14805,167,39,-1611,-1901,16.7,1538.1,8,7,8,0,0,0,0,16992,6.6,16706,201,53,1611,1901,20.1,1699.2,red,2.75,2.29,15,15,blue
4477340034,3,6,3,1,0,1,0,14840,6.8,17620,226,56,-2579,-626,22.6,1484,6,3,9,0,0,0,0,17419,7,18246,245,56,2579,626,24.5,1741.9,red,1,5,22,20,red
4524928050,5,11,2,0,0,0,0,15346,6.4,15646,187,38,-2764,-2934,18.7,1534.6,11,5,13,1,1,0,0,18110,7.2,18580,202,44,2764,2934,20.2,1811,red,0.64,4.8,61,17,red
4526739859,4,4,8,0,0,0,0,16530,7,18713,243,60,837,1199,24.3,1653,4,4,3,1,1,0,0,15693,6.6,17514,233,56,-837,-1199,23.3,1569.3,blue,3,1.75,17,14,blue
4506831821,2,12,3,0,0,0,0,14379,6.6,16423,203,49,-6676,-3924,20.3,1437.9,12,2,14,1,1,0,1,21055,7.2,20347,223,66,6676,3924,22.3,2105.5,red,0.42,13,17,17,blue
4526108615,7,11,11,0,0,0,0,16792,6.4,16518,198,52,-2787,-2662,19.8,1679.2,11,7,11,2,1,1,0,19579,7.2,19180,216,63,2787,2662,21.6,1957.9,red,1.64,3.14,19,19,red
4433327463,5,8,4,0,0,0,0,15243,6.4,16159,193,35,-2449,-3095,19.3,1524.3,8,5,8,1,1,0,0,17692,7.2,19254,257,49,2449,3095,25.7,1769.2,red,1.12,3.2,33,42,red
4440545159,10,6,6,0,0,0,0,17332,7.2,19582,235,65,1372,1668,23.5,1733.2,6,10,6,0,0,0,0,15960,7,17914,207,48,-1372,-1668,20.7,1596,blue,2.67,1.2,21,16,blue
4522839923,3,5,6,1,1,0,0,16120,7,18058,246,53,-576,-1269,24.6,1612,5,3,6,1,0,1,0,16696,7.2,19327,228,59,576,1269,22.8,1669.6,blue,1.8,3.67,19,89,blue
4488711535,7,6,10,0,0,0,0,17013,7.4,19131,230,48,447,1096,23,1701.3,6,7,5,1,1,0,0,16566,7,18035,228,44,-447,-1096,22.8,1656.6,blue,2.83,1.57,22,123,blue
4525305174,5,8,6,0,0,0,0,15754,6.8,16911,196,44,-1157,-573,19.6,1575.4,8,5,12,1,1,0,0,16911,6.6,17484,228,48,1157,573,22.8,1691.1,blue,1.38,4,20,27,blue
4522574543,11,7,15,1,1,0,0,20007,7,19097,241,60,3774,4377,24.1,2000.7,7,11,9,0,0,0,0,16233,6,14720,184,28,-3774,-4377,18.4,1623.3,red,3.71,1.45,23,17,red
4459407300,14,7,14,1,1,0,0,20063,7.4,20273,244,39,3702,3355,24.4,2006.3,7,14,8,1,0,1,0,16361,6.8,16918,175,56,-3702,-3355,17.5,1636.1,blue,4,1.07,45,19,red
4501853954,8,2,8,0,0,0,0,17263,7,18277,222,41,2622,1080,22.2,1726.3,2,8,0,1,1,0,0,14641,6.8,17197,212,54,-2622,-1080,21.2,1464.1,blue,8,0.25,31,38,blue
4486718307,7,5,9,0,0,0,0,16793,6.8,17671,242,48,620,-226,24.2,1679.3,5,7,7,1,1,0,0,16173,7,17897,237,44,-620,226,23.7,1617.3,red,3.2,1.71,34,22,red
4483926766,5,10,5,1,0,1,0,14982,6.6,15862,171,48,-2690,-743,17.1,1498.2,10,5,14,0,0,0,0,17672,6.6,16605,187,36,2690,743,18.7,1767.2,blue,1,4.8,19,86,red
4484792751,6,8,4,2,1,1,0,16385,6.6,17327,215,58,-219,-589,21.5,1638.5,8,6,15,0,0,0,0,16604,6.8,17916,199,48,219,589,19.9,1660.4,red,1.25,3.83,159,15,blue
4523961836,7,6,6,0,0,0,0,17135,7,18089,227,46,754,159,22.7,1713.5,6,7,9,0,0,0,0,16381,6.8,17930,195,38,-754,-159,19.5,1638.1,blue,2.17,2.14,35,27,blue
4515886739,8,4,15,0,0,0,0,16894,7.2,18333,219,40,1077,1096,21.9,1689.4,4,8,4,0,0,0,0,15817,6.8,17237,208,63,-1077,-1096,20.8,1581.7,blue,5.75,1,16,17,red
4524656302,6,4,8,1,1,0,0,16869,7.2,19165,232,63,840,2240,23.2,1686.9,4,6,5,1,0,1,0,16029,6.8,16925,210,52,-840,-2240,21,1602.9,blue,3.5,1.5,19,16,red
4459707188,7,8,10,1,1,0,0,17201,7,17805,221,44,317,944,22.1,1720.1,8,7,9,0,0,0,0,16884,6.8,16861,174,56,-317,-944,17.4,1688.4,blue,2.12,2.43,19,16,blue
4506871596,7,5,8,1,1,0,0,16864,7,18073,224,52,1040,1194,22.4,1686.4,5,7,3,0,0,0,0,15824,6.6,16879,198,44,-1040,-1194,19.8,1582.4,blue,3,1.14,18,19,blue
4526085370,12,6,8,1,1,0,0,18432,7.2,19560,224,41,2495,3183,22.4,1843.2,6,12,8,0,0,0,0,15937,6.8,16377,193,52,-2495,-3183,19.3,1593.7,blue,3.33,1.17,26,21,blue
4526079366,7,6,6,0,0,0,0,17232,7.2,18525,238,54,672,411,23.8,1723.2,6,7,13,1,1,0,0,16560,7,18114,210,52,-672,-411,21,1656,blue,2.17,2.71,40,18,blue
4483586875,12,6,13,1,1,0,0,18704,7.4,19748,223,56,2765,2798,22.3,1870.4,6,12,5,0,0,0,0,15939,6.8,16950,233,42,-2765,-2798,23.3,1593.9,blue,4.17,0.92,13,31,blue
4298114879,6,2,8,0,0,0,0,16818,6.8,16961,204,52,1448,-664,20.4,1681.8,2,6,2,1,1,0,0,15370,7,17625,250,60,-1448,664,25,1537,blue,7,0.67,23,23,red
4515698630,7,9,8,0,0,0,0,16595,7.2,18645,231,47,-997,-330,23.1,1659.5,9,7,11,0,0,0,0,17592,7.2,18975,225,52,997,330,22.5,1759.2,red,1.67,2.86,20,17,red
4515321502,6,1,6,0,0,0,0,17592,7.6,19904,259,61,3031,1196,25.9,1759.2,1,6,1,0,0,0,0,14561,7.2,18708,224,77,-3031,-1196,22.4,1456.1,blue,12,0.33,61,15,blue
4478790073,8,3,10,1,1,0,0,17775,7.2,19408,256,49,2009,2090,25.6,1777.5,3,8,2,0,0,0,0,15766,6.6,17318,248,53,-2009,-2090,24.8,1576.6,blue,6,0.62,18,20,red
4510349153,5,8,3,0,0,0,0,15817,7.2,18561,212,64,-2378,-478,21.2,1581.7,8,5,10,1,1,0,0,18195,7.2,19039,226,68,2378,478,22.6,1819.5,red,1,3.6,13,19,red
4487951010,7,12,10,1,0,1,0,16222,6.6,16170,184,48,-3561,-1911,18.4,1622.2,12,7,17,1,1,0,0,19783,6.8,18081,237,36,3561,1911,23.7,1978.3,red,1.42,4.14,18,17,red
4526229522,3,8,2,1,1,0,0,16451,6.8,18027,234,72,-700,-1628,23.4,1645.1,8,3,12,0,0,0,0,17151,7.2,19655,222,46,700,1628,22.2,1715.1,red,0.62,6.67,16,13,blue
4508130828,10,3,3,2,1,1,1,19904,7.6,21324,272,68,5305,4619,27.2,1990.4,3,10,3,0,0,0,0,14599,6.6,16705,210,58,-5305,-4619,21,1459.9,blue,4.33,0.6,22,18,blue
4499573481,8,8,14,0,0,0,0,16907,6.8,17497,185,44,-47,487,18.5,1690.7,8,8,8,0,0,0,0,16954,6.6,17010,219,32,47,-487,21.9,1695.4,blue,2.75,2,20,16,red
4489696116,0,8,0,0,0,0,0,13728,6.6,16556,211,60,-5040,-1496,21.1,1372.8,8,0,8,0,0,0,1,18768,6.6,18052,239,46,5040,1496,23.9,1876.8,red,0,12.65,21,19,red
4465548347,3,8,4,0,0,0,0,14324,6.4,16390,217,43,-2808,-1555,21.7,1432.4,8,3,12,0,0,0,0,17132,7,17945,231,35,2808,1555,23.1,1713.2,red,0.88,6.67,50,40,blue
4524178545,2,6,4,1,1,0,0,15175,6.8,17282,214,52,-1409,-16,21.4,1517.5,6,2,5,0,0,0,0,16584,6.8,17298,234,50,1409,16,23.4,1658.4,red,1,5.5,21,20,red
4469945673,3,8,4,0,0,0,0,14108,6.4,16327,188,48,-4316,-2717,18.8,1410.8,8,3,7,2,1,1,0,18424,7.4,19044,262,64,4316,2717,26.2,1842.4,red,0.88,5,74,24,red
4510215799,9,8,8,1,1,0,0,18239,7.2,19135,228,54,640,411,22.8,1823.9,8,9,8,0,0,0,0,17599,7.2,18724,240,35,-640,-411,24,1759.9,red,2.12,1.78,15,13,blue
4512096466,8,1,11,1,1,0,0,18178,7,18563,233,52,5174,3105,23.3,1817.8,1,8,0,0,0,0,0,13004,6.2,15458,182,54,-5174,-3105,18.2,1300.4,blue,19,0.12,17,11,blue
4495207982,6,5,3,2,1,1,0,15711,6.8,18516,196,56,458,2243,19.6,1571.1,5,6,4,0,0,0,0,15253,6.6,16273,219,32,-458,-2243,21.9,1525.3,blue,1.8,1.5,23,25,blue
4515656149,13,6,18,1,1,0,0,20666,7.2,19611,220,60,5525,3383,22,2066.6,6,13,7,0,0,0,0,15141,6.6,16228,185,48,-5525,-3383,18.5,1514.1,blue,5.17,1,17,14,blue
4486831645,6,2,6,1,1,0,0,15721,6.8,17894,203,48,1900,1732,20.3,1572.1,2,6,0,0,0,0,0,13821,6.4,16162,187,59,-1900,-1732,18.7,1382.1,blue,6,0.33,18,13,red
4468528737,7,5,9,1,1,0,0,16100,6.6,16520,189,48,-488,-1312,18.9,1610,5,7,7,0,0,0,0,16588,7,17832,240,40,488,1312,24,1658.8,blue,3.2,1.71,27,23,blue
4525624857,4,11,3,0,0,0,0,15017,6.6,16114,203,52,-2936,-2856,20.3,1501.7,11,4,12,1,1,0,0,17953,7.2,18970,232,44,2936,2856,23.2,1795.3,red,0.64,5.75,23,18,blue
4504999388,3,9,4,0,0,0,0,13771,6.8,16290,174,50,-4907,-2874,17.4,1377.1,9,3,12,1,1,0,0,18678,7.2,19164,241,61,4907,2874,24.1,1867.8,blue,0.78,7,17,16,red
4436737489,9,8,7,0,0,0,0,17061,7,18530,197,42,744,461,19.7,1706.1,8,9,14,0,0,0,0,16317,7,18069,178,34,-744,-461,17.8,1631.7,red,2,2.44,17,36,red
4447992971,6,4,10,1,1,0,0,16993,7.2,18935,262,57,422,-758,26.2,1699.3,4,6,6,0,0,0,0,16571,7.4,19693,254,60,-422,758,25.4,1657.1,blue,4,1.67,18,19,blue
4505940402,3,3,6,0,0,0,0,14127,6.6,16566,186,44,-1171,-1157,18.6,1412.7,3,3,4,1,1,0,0,15298,6.6,17723,233,60,1171,1157,23.3,1529.8,blue,3,2.33,16,19,red
4477701411,6,10,7,1,0,1,0,16100,7,17451,192,60,-2907,-1376,19.2,1610,10,6,9,1,1,0,0,19007,7.2,18827,260,40,2907,1376,26,1900.7,blue,1.3,3.17,22,21,red
4492671924,6,4,5,1,1,0,0,16229,7.2,18988,200,62,164,486,20,1622.9,4,6,4,0,0,0,0,16065,7.2,18502,230,54,-164,-486,23,1606.5,blue,2.75,1.33,22,18,blue
4474087282,6,4,5,0,0,0,0,15724,6.8,17512,217,46,81,1865,21.7,1572.4,4,6,7,1,1,0,0,15643,6.4,15647,219,58,-81,-1865,21.9,1564.3,blue,2.75,1.83,44,24,red
4457599634,7,8,4,1,1,0,0,17222,7.2,19032,216,75,485,219,21.6,1722.2,8,7,7,0,0,0,0,16737,7,18813,202,28,-485,-219,20.2,1673.7,blue,1.38,2.14,19,18,blue
4513213507,10,11,14,1,1,0,0,19020,6.8,18128,216,52,609,-19,21.6,1902,11,10,14,1,0,1,0,18411,6.8,18147,221,31,-609,19,22.1,1841.1,red,2.18,2.5,43,21,blue
4497064417,10,1,10,2,1,1,0,19847,7.2,20768,250,64,6658,6189,25,1984.7,1,10,2,0,0,0,0,13189,6.2,14579,166,55,-6658,-6189,16.6,1318.9,blue,20,0.3,16,11,blue
4480485955,3,5,4,1,0,1,0,14814,6.8,16691,216,39,-3082,-1694,21.6,1481.4,5,3,4,1,1,0,1,17896,6.8,18385,242,57,3082,1694,24.2,1789.6,red,1.4,3,16,17,red
4451891772,7,9,4,0,0,0,0,15002,6.4,15784,170,37,-3255,-1798,17,1500.2,9,7,10,1,1,0,0,18257,7,17582,240,46,3255,1798,24,1825.7,red,1.22,2.71,18,18,red
4448344869,8,3,8,0,0,0,0,17605,7.2,19955,247,40,2897,3195,24.7,1760.5,3,8,2,0,0,0,0,14708,6.6,16760,223,44,-2897,-3195,22.3,1470.8,blue,5.33,0.62,21,18,blue
4507906686,3,9,0,0,0,0,0,14502,6.8,17558,213,40,-3041,-1317,21.3,1450.2,9,3,7,2,1,1,0,17543,7,18875,223,50,3041,1317,22.3,1754.3,red,0.33,5.33,15,18,red
4478771848,2,9,4,0,0,0,0,14599,6.8,17147,220,45,-4196,-1649,22,1459.9,9,2,7,1,0,1,1,18795,7,18796,244,52,4196,1649,24.4,1879.5,red,0.67,8,21,20,red
4508073234,1,5,3,0,0,0,0,13686,6.8,16575,213,48,-2755,-2255,21.3,1368.6,5,1,4,2,1,1,0,16441,7.2,18830,230,59,2755,2255,23,1644.1,red,0.8,9,12,17,red
4519181243,5,6,5,0,0,0,0,16449,6.8,17858,207,56,973,825,20.7,1644.9,6,5,8,0,0,0,0,15476,6.8,17033,192,52,-973,-825,19.2,1547.6,red,1.67,2.8,18,14,red
4464656056,13,7,12,1,0,1,1,21783,7.6,20533,244,43,5638,3250,24.4,2178.3,7,13,7,0,0,0,0,16145,6.8,17283,167,47,-5638,-3250,16.7,1614.5,blue,3.57,1.08,21,40,blue
4514072089,6,6,7,0,0,0,0,15867,7,17569,210,48,-430,159,21,1586.7,6,6,5,1,0,1,0,16297,6.8,17410,203,40,430,-159,20.3,1629.7,red,2.17,1.83,49,18,red
4509731255,8,9,5,2,1,1,0,15889,6.8,17078,177,36,-2212,-1682,17.7,1588.9,9,8,8,0,0,0,0,18101,7.2,18760,212,55,2212,1682,21.2,1810.1,red,1.44,2.12,34,20,red
4480429854,7,4,6,1,1,0,0,16988,7.2,18623,196,56,1575,-516,19.6,1698.8,4,7,1,0,0,0,0,15413,7.2,19139,224,76,-1575,516,22.4,1541.3,blue,3.25,0.71,14,12,blue
4493814352,5,3,5,0,0,0,0,16076,7.2,18917,245,48,1067,1824,24.5,1607.6,3,5,2,0,0,0,0,15009,6.8,17093,235,48,-1067,-1824,23.5,1500.9,blue,3.33,1,15,21,red
4440425565,13,6,13,2,1,1,2,22162,7.8,21254,249,72,6578,5388,24.9,2216.2,6,13,7,0,0,0,0,15584,6.2,15866,156,68,-6578,-5388,15.6,1558.4,blue,4.33,1,18,12,red
4486426740,3,4,4,1,1,0,0,15178,7,18172,209,64,-767,-606,20.9,1517.8,4,3,4,1,0,1,0,15945,7,18778,229,64,767,606,22.9,1594.5,blue,1.75,2.67,14,16,red
4524439900,6,9,6,0,0,0,0,15196,6.6,16925,188,34,-2560,-826,18.8,1519.6,9,6,18,1,1,0,0,17756,7,17751,211,44,2560,826,21.1,1775.6,red,1.33,4.5,25,44,red
4505385341,4,5,3,0,0,0,0,15600,6.8,17354,229,57,-226,-157,22.9,1560,5,4,6,0,0,0,0,15826,6.6,17511,191,44,226,157,19.1,1582.6,blue,1.4,2.75,18,43,blue
4514389880,7,3,5,2,1,1,0,16742,7.4,19145,215,67,1468,932,21.5,1674.2,3,7,2,0,0,0,0,15274,7.2,18213,247,60,-1468,-932,24.7,1527.4,blue,4,0.71,22,86,blue
4526206684,5,6,3,0,0,0,0,15580,6.6,17286,197,44,-502,-1113,19.7,1558,6,5,4,1,0,1,0,16082,7.2,18399,197,55,502,1113,19.7,1608.2,red,1.33,2,20,15,red
4451346822,5,7,7,1,0,1,0,16111,6.8,17724,211,61,-1090,555,21.1,1611.1,7,5,16,1,1,0,0,17201,7,17169,196,52,1090,-555,19.6,1720.1,blue,1.71,4.6,19,20,red
4522846190,3,5,3,0,0,0,0,15404,7,17893,244,52,-1793,-1226,24.4,1540.4,5,3,7,1,1,0,0,17197,7,19119,254,68,1793,1226,25.4,1719.7,red,1.2,4,20,19,red
4526199603,5,15,6,0,0,0,0,15147,6.4,15110,201,33,-4470,-3848,20.1,1514.7,15,5,20,1,1,0,0,19617,7.4,18958,193,50,4470,3848,19.3,1961.7,red,0.73,7,18,19,red
4527239272,11,5,11,2,1,1,0,17058,7.2,18736,178,49,2107,2032,17.8,1705.8,5,11,1,0,0,0,0,14951,6.6,16704,211,48,-2107,-2032,21.1,1495.1,blue,4.4,0.55,15,27,blue
4419845019,4,13,3,0,0,0,0,14129,6.6,16038,174,32,-5489,-3743,17.4,1412.9,13,4,21,1,1,0,0,19618,7.4,19781,185,69,5489,3743,18.5,1961.8,red,0.54,8.5,15,20,red
4523781567,5,5,4,0,0,0,0,16368,7,18622,250,48,1079,1363,25,1636.8,5,5,7,1,1,0,0,15289,7,17259,206,56,-1079,-1363,20.6,1528.9,blue,1.8,2.4,13,17,red
4525161155,4,8,5,1,0,1,0,15577,6.6,16808,235,42,-2268,-1851,23.5,1557.7,8,4,7,1,1,0,0,17845,7,18659,239,63,2268,1851,23.9,1784.5,red,1.12,3.75,16,24,red
4296036692,9,7,10,1,1,0,0,17102,7.2,18327,207,46,339,261,20.7,1710.2,7,9,10,1,0,1,0,16763,6.8,18066,252,45,-339,-261,25.2,1676.3,red,2.71,1.89,20,22,blue
4444365266,3,9,3,0,0,0,0,14323,6.4,15853,206,40,-3016,-3479,20.6,1432.3,9,3,4,1,1,0,0,17339,7,19332,235,56,3016,3479,23.5,1733.9,red,0.67,4.33,18,22,red
4493317372,5,4,5,1,1,0,0,15807,7,18131,219,59,70,409,21.9,1580.7,4,5,8,0,0,0,0,15737,7,17722,221,60,-70,-409,22.1,1573.7,blue,2.5,2.4,13,15,blue
4523121371,5,13,4,0,0,0,0,14988,6.2,15585,186,40,-3562,-3319,18.6,1498.8,13,5,20,0,0,0,0,18550,7.2,18904,208,52,3562,3319,20.8,1855,red,0.69,6.6,18,13,blue
4464614548,2,7,1,1,0,1,0,15051,6.8,17519,220,57,-2815,-1204,22,1505.1,7,2,8,0,0,0,0,17866,7.2,18723,236,52,2815,1204,23.6,1786.6,red,0.43,7.5,13,17,red
4525947675,3,7,4,1,1,0,0,15641,7,18490,261,56,-371,-444,26.1,1564.1,7,3,7,0,0,0,0,16012,7,18934,209,53,371,444,20.9,1601.2,blue,1,4.67,18,66,blue
4523431479,9,4,4,0,0,0,0,16715,7,19011,227,48,911,713,22.7,1671.5,4,9,5,1,1,0,0,15804,6.8,18298,191,64,-911,-713,19.1,1580.4,blue,3.25,1,20,21,blue
4487218004,10,7,11,0,0,0,0,18423,7.2,18773,212,40,2514,1424,21.2,1842.3,7,10,6,1,0,1,0,15909,6.8,17349,200,40,-2514,-1424,20,1590.9,blue,3,1.3,41,20,blue
4488919662,4,6,4,1,1,0,0,15289,6.4,16346,193,52,-282,-740,19.3,1528.9,6,4,6,0,0,0,0,15571,6.8,17086,197,34,282,740,19.7,1557.1,blue,1.33,3,18,39,blue
4464639816,3,7,0,0,0,0,0,14467,7,17728,220,58,-2287,-735,22,1446.7,7,3,6,1,1,0,0,16754,7,18463,218,40,2287,735,21.8,1675.4,red,0.43,4.33,51,19,red
4459818225,3,1,5,1,1,0,0,15544,7,18418,236,64,-590,558,23.6,1554.4,1,3,1,1,0,1,1,16134,6.8,17860,228,52,590,-558,22.8,1613.4,red,8,0.67,19,19,red
4489141814,2,5,4,0,0,0,0,14743,6.8,17174,228,44,-1625,-2061,22.8,1474.3,5,2,8,2,1,1,0,16368,7.4,19235,239,60,1625,2061,23.9,1636.8,red,1.2,6.5,15,24,red
4476670198,3,8,3,1,1,0,0,14591,6.8,16795,224,46,-3236,-2874,22.4,1459.1,8,3,8,1,0,1,0,17827,7.4,19669,252,50,3236,2874,25.2,1782.7,blue,0.75,5.33,20,19,red
4513140089,10,6,10,0,0,0,0,18787,7.2,18788,212,46,2048,1050,21.2,1878.7,6,10,7,0,0,0,0,16739,7,17738,228,52,-2048,-1050,22.8,1673.9,blue,3.33,1.3,33,15,blue
4527328418,8,10,11,0,0,0,0,16671,7,17530,181,39,-1141,-630,18.1,1667.1,10,8,5,1,0,1,0,17812,6.8,18160,216,48,1141,630,21.6,1781.2,red,1.9,1.88,19,18,blue
4527458073,8,4,12,1,1,0,0,17134,6.8,17172,222,51,1167,-814,22.2,1713.4,4,8,6,0,0,0,0,15967,6.8,17986,221,58,-1167,814,22.1,1596.7,red,5,1.25,27,21,blue
4501133727,3,7,5,0,0,0,0,14996,6.4,16234,221,44,-1502,-959,22.1,1499.6,7,3,13,0,0,0,0,16498,6.8,17193,229,48,1502,959,22.9,1649.8,red,1.14,6.67,23,21,red
4483881099,7,4,14,1,0,1,0,17610,6.8,17839,236,47,3259,2282,23.6,1761,4,7,6,1,1,0,0,14351,6.4,15557,199,38,-3259,-2282,19.9,1435.1,blue,5.25,1.43,21,23,blue
4504857073,9,10,5,1,1,0,0,17302,6.8,17065,197,39,-1085,-1716,19.7,1730.2,10,9,9,0,0,0,0,18387,7.2,18781,208,67,1085,1716,20.8,1838.7,blue,1.4,2.11,17,17,red
4468770669,6,8,6,1,1,0,0,16877,7,18403,203,66,-147,273,20.3,1687.7,8,6,7,0,0,0,0,17024,6.8,18130,214,39,147,-273,21.4,1702.4,red,1.5,2.5,14,15,red
4478560803,9,12,9,1,1,0,0,16218,6,15119,154,40,-3070,-3027,15.4,1621.8,12,9,12,1,0,1,0,19288,7,18146,194,42,3070,3027,19.4,1928.8,red,1.5,2.67,118,20,red
4524615690,5,7,8,1,1,0,0,15680,6.8,17983,201,58,-638,1771,20.1,1568,7,5,12,0,0,0,0,16318,6.6,16212,219,28,638,-1771,21.9,1631.8,red,1.86,3.8,20,21,red
4527087399,6,7,6,0,0,0,0,16070,6.6,17613,194,48,-1245,-971,19.4,1607,7,6,10,1,1,0,0,17315,7,18584,237,60,1245,971,23.7,1731.5,blue,1.71,2.83,14,15,red
4482569036,4,7,5,0,0,0,0,15267,6.8,17008,212,52,-1002,-2319,21.2,1526.7,7,4,9,1,0,1,0,16269,7,19327,209,60,1002,2319,20.9,1626.9,red,1.29,4,24,15,blue
4494125131,1,4,0,1,1,0,0,14894,6.6,16548,244,44,-2094,-2508,24.4,1489.4,4,1,7,0,0,0,0,16988,7,19056,230,66,2094,2508,23,1698.8,blue,0.25,11,14,13,blue
4503927654,2,7,2,0,0,0,0,13598,6.2,15349,189,45,-3892,-2725,18.9,1359.8,7,2,7,1,1,0,0,17490,7,18074,223,52,3892,2725,22.3,1749,red,0.57,7,81,19,red
4525819102,3,6,3,0,0,0,0,15373,7.2,18554,225,61,-991,-136,22.5,1537.3,6,3,8,1,1,0,0,16364,7.2,18690,220,51,991,136,22,1636.4,red,1,4.67,22,18,red
4467443224,6,12,6,0,0,0,0,16260,6.8,16989,211,42,-1791,-1671,21.1,1626,12,6,13,0,0,0,0,18051,7,18660,192,49,1791,1671,19.2,1805.1,blue,1,4.17,21,14,red
4519026999,8,6,7,0,0,0,0,16894,7,17731,205,38,1797,1094,20.5,1689.4,6,8,5,1,1,0,0,15097,6.6,16637,190,42,-1797,-1094,19,1509.7,blue,2.5,1.38,41,52,red
4520959679,8,8,9,0,0,0,0,17951,6.8,18517,219,56,680,-704,21.9,1795.1,8,8,9,1,1,0,0,17271,7.2,19221,216,68,-680,704,21.6,1727.1,red,2.12,2.12,20,63,blue
4500621503,4,9,5,0,0,0,0,15054,6.8,16739,204,44,-2327,-2471,20.4,1505.4,9,4,8,0,0,0,0,17381,7.2,19210,209,69,2327,2471,20.9,1738.1,red,1,4.25,19,17,red
4459848079,2,9,2,0,0,0,0,13791,6.6,16220,199,50,-4379,-3811,19.9,1379.1,9,2,6,0,0,0,0,18170,7.4,20031,250,54,4379,3811,25,1817,red,0.44,7.5,20,18,red
4525326887,9,6,16,0,0,0,0,17348,6.6,16417,191,40,1528,-104,19.1,1734.8,6,9,7,1,1,0,0,15820,6.6,16521,191,55,-1528,104,19.1,1582,blue,4.17,1.44,44,18,blue
4526736580,8,7,7,1,1,0,0,16573,6.8,17651,219,38,-438,-634,21.9,1657.3,7,8,7,0,0,0,0,17011,7.2,18285,245,43,438,634,24.5,1701.1,blue,2.14,1.75,15,27,red
4510817893,7,5,8,0,0,0,0,17149,7,17975,247,45,1547,611,24.7,1714.9,5,7,8,0,0,0,0,15602,6.8,17364,210,58,-1547,-611,21,1560.2,red,3,1.86,61,28,blue
4522833025,5,6,3,1,1,0,0,16024,7,18727,228,56,-566,-1162,22.8,1602.4,6,5,8,0,0,0,0,16590,7.2,19889,229,55,566,1162,22.9,1659,red,1.33,2.8,14,19,blue
4501989781,6,4,6,0,0,0,0,16368,7.2,18776,204,52,1418,1328,20.4,1636.8,4,6,4,1,1,0,0,14950,6.8,17448,194,55,-1418,-1328,19.4,1495,blue,3,1.33,12,13,blue
4456942619,9,7,7,0,0,0,0,18351,7,19205,222,57,2556,3518,22.2,1835.1,7,9,11,1,1,0,0,15795,6.6,15687,170,53,-2556,-3518,17,1579.5,blue,2.29,2,27,22,blue
4456745249,1,8,1,1,0,1,0,14044,6.8,16385,231,44,-4107,-3090,23.1,1404.4,8,1,12,1,1,0,0,18151,7.4,19475,234,60,4107,3090,23.4,1815.1,red,0.25,20,29,26,red
4500030602,6,11,8,1,1,0,0,15855,6.8,17383,204,48,-2536,-2343,20.4,1585.5,11,6,11,0,0,0,0,18391,7,19726,218,48,2536,2343,21.8,1839.1,blue,1.27,3.67,13,13,blue
4493956476,10,7,8,1,1,0,1,19301,7.2,19342,212,68,3471,2708,21.2,1930.1,7,10,5,0,0,0,0,15830,6.6,16634,197,55,-3471,-2708,19.7,1583,blue,2.57,1.2,20,20,blue
4468947344,3,5,2,1,1,0,0,15530,6.8,17181,221,60,196,-183,22.1,1553,5,3,4,1,0,1,0,15334,7,17364,202,52,-196,183,20.2,1533.4,blue,1,3,22,31,blue
4470019364,3,8,1,0,0,0,0,14637,6.8,17706,193,48,-2433,-1687,19.3,1463.7,8,3,3,0,0,0,0,17070,7.2,19393,223,43,2433,1687,22.3,1707,red,0.5,3.67,17,20,blue
4518792896,7,8,6,0,0,0,0,15312,6.4,15636,167,45,-1352,-1180,16.7,1531.2,8,7,7,1,1,0,0,16664,6.4,16816,220,41,1352,1180,22,1666.4,red,1.62,2.14,14,25,blue
4488593539,8,5,7,1,1,0,0,17677,7.2,19493,233,66,1715,1973,23.3,1767.7,5,8,8,0,0,0,0,15962,7.2,17520,198,57,-1715,-1973,19.8,1596.2,blue,3,1.62,20,17,red
4494846139,9,4,10,0,0,0,0,18689,7.2,19882,235,51,3634,2422,23.5,1868.9,4,9,1,0,0,0,0,15055,6.6,17460,223,47,-3634,-2422,22.3,1505.5,blue,4.75,0.56,15,24,blue
4444198769,8,6,18,0,0,0,0,17008,6.8,16636,206,40,801,-1533,20.6,1700.8,6,8,6,0,0,0,0,16207,7,18169,223,48,-801,1533,22.3,1620.7,red,4.33,1.5,16,15,blue
4511414132,5,5,7,0,0,0,0,15658,7,17569,224,45,-1047,-1618,22.4,1565.8,5,5,5,0,0,0,0,16705,7.2,19187,251,54,1047,1618,25.1,1670.5,red,2.4,2,16,17,blue
4500070797,5,7,2,0,0,0,0,14318,6.6,16916,180,45,-1575,-1224,18,1431.8,7,5,5,1,1,0,0,15893,7,18140,193,50,1575,1224,19.3,1589.3,red,1,2.4,17,14,red
4463158250,8,9,10,1,1,0,0,16262,6.8,17436,186,59,-867,62,18.6,1626.2,9,8,11,0,0,0,0,17129,7,17374,212,44,867,-62,21.2,1712.9,red,2,2.5,18,16,red
4471792481,6,15,8,0,0,0,0,15653,6.4,16813,158,43,-6105,-4065,15.8,1565.3,15,6,13,0,0,0,1,21758,7.8,20878,223,64,6105,4065,22.3,2175.8,red,0.93,4.67,11,11,red
4484826568,5,9,3,1,1,0,0,15908,6.8,16828,211,44,-2080,-1117,21.1,1590.8,9,5,10,0,0,0,0,17988,7,17945,247,44,2080,1117,24.7,1798.8,red,0.89,3.8,16,21,red
4487506155,5,3,3,2,1,1,0,15884,7.2,19448,241,48,322,1377,24.1,1588.4,3,5,3,0,0,0,0,15562,7.2,18071,236,63,-322,-1377,23.6,1556.2,blue,2.67,1.2,38,45,red
4455587892,7,4,3,0,0,0,0,17399,7.4,20087,245,60,2105,2310,24.5,1739.9,4,7,5,0,0,0,0,15294,7,17777,205,52,-2105,-2310,20.5,1529.4,blue,2.5,1.29,40,36,blue
4492860454,9,3,12,0,0,0,0,17892,7.2,18969,215,56,1873,883,21.5,1789.2,3,9,2,1,1,0,0,16019,7,18086,249,56,-1873,-883,24.9,1601.9,red,7,0.56,17,17,red
4498847348,11,3,19,1,1,0,0,18348,7.2,19343,226,60,3294,1808,22.6,1834.8,3,11,3,0,0,0,0,15054,6.8,17535,218,44,-3294,-1808,21.8,1505.4,blue,10,0.55,20,42,blue
4437508160,2,6,3,0,0,0,0,14287,6.6,17457,225,43,-3045,-1380,22.5,1428.7,6,2,7,2,1,1,0,17332,7.2,18837,261,40,3045,1380,26.1,1733.2,red,0.83,6.5,14,17,red
4527305212,6,10,7,1,1,0,0,16024,6.4,15686,202,40,-1307,-814,20.2,1602.4,10,6,21,0,0,0,0,17331,6.6,16500,201,43,1307,814,20.1,1733.1,red,1.3,5.17,20,21,red
4472722581,5,4,4,0,0,0,0,17039,7.4,19626,261,60,1116,1123,26.1,1703.9,4,5,3,1,1,0,0,15923,7,18503,221,60,-1116,-1123,22.1,1592.3,red,2.25,1.4,17,18,red
4504998560,9,10,10,0,0,0,0,17827,7.2,18573,216,35,24,983,21.6,1782.7,10,9,11,1,0,1,0,17803,6.8,17590,204,52,-24,-983,20.4,1780.3,blue,1.9,2.33,14,19,blue
4490735415,7,4,5,1,1,0,0,16819,7.2,18725,239,60,707,1960,23.9,1681.9,4,7,3,0,0,0,0,16112,6.8,16765,198,52,-707,-1960,19.8,1611.2,blue,3,1,20,39,red
4465315065,2,9,1,0,0,0,0,13709,6.4,15514,199,40,-4681,-2497,19.9,1370.9,9,2,18,1,1,0,0,18390,7,18011,230,51,4681,2497,23,1839,red,0.33,13.5,25,22,red
4527195678,4,8,2,0,0,0,0,15442,6.8,17142,204,52,-3924,-3699,20.4,1544.2,8,4,6,2,1,1,1,19366,7.6,20841,254,76,3924,3699,25.4,1936.6,red,0.75,3.5,12,16,red
4507963275,1,4,2,0,0,0,0,14996,6.8,17555,232,55,-844,-1002,23.2,1499.6,4,1,5,1,1,0,0,15840,7.2,18557,230,64,844,1002,23,1584,red,0.75,9,18,40,red
4503353744,2,9,3,1,0,1,0,15325,6.8,17258,238,53,-2368,-250,23.8,1532.5,9,2,14,1,1,0,0,17693,7,17508,201,48,2368,250,20.1,1769.3,red,0.56,11.5,14,18,red
4439955992,1,8,2,0,0,0,0,13967,6.6,15942,196,52,-3789,-4083,19.6,1396.7,8,1,13,0,0,0,0,17756,7.4,20025,223,52,3789,4083,22.3,1775.6,red,0.38,21,12,16,blue
4470700063,3,8,4,0,0,0,0,15032,6.8,16226,221,48,-2798,-2403,22.1,1503.2,8,3,5,2,1,1,1,17830,7,18629,215,60,2798,2403,21.5,1783,red,0.88,4.33,28,20,blue
4468105635,11,6,9,1,1,0,0,19045,7.4,20131,227,70,3387,2782,22.7,1904.5,6,11,8,0,0,0,0,15658,6.8,17349,187,45,-3387,-2782,18.7,1565.8,blue,3.33,1.27,17,41,blue
4524577264,4,5,7,0,0,0,0,15820,7,18001,242,58,-758,-392,24.2,1582,5,4,4,2,1,1,0,16578,7.2,18393,229,52,758,392,22.9,1657.8,red,2.2,2.25,21,19,red
4513785309,3,10,3,0,0,0,0,14536,6.6,15452,201,44,-3203,-2199,20.1,1453.6,10,3,8,0,0,0,0,17739,7.2,17651,212,36,3203,2199,21.2,1773.9,red,0.6,6,20,22,red
4518324429,5,1,5,2,1,1,0,16833,7,18765,244,65,3246,1680,24.4,1683.3,1,5,0,0,0,0,0,13587,6.6,17085,219,54,-3246,-1680,21.9,1358.7,blue,10,0.2,26,26,blue
4470196498,8,11,8,0,0,0,0,16483,6.8,16652,186,50,-1412,-405,18.6,1648.3,11,8,18,1,1,0,0,17895,6.8,17057,208,38,1412,405,20.8,1789.5,blue,1.45,3.62,15,17,red
4456521073,9,1,8,0,0,0,0,17483,7.8,20101,239,60,3502,3747,23.9,1748.3,1,9,2,0,0,0,0,13981,6.6,16354,214,52,-3502,-3747,21.4,1398.1,blue,17,0.33,21,22,blue
4483263508,1,7,1,0,0,0,0,14400,6.4,16399,215,43,-2884,-3321,21.5,1440,7,1,5,1,1,0,0,17284,7.2,19720,239,66,2884,3321,23.9,1728.4,red,0.29,12,81,35,red
4515791931,12,6,12,2,1,1,0,18661,6.8,18012,197,60,2479,1210,19.7,1866.1,6,12,6,0,0,0,0,16182,6.6,16802,203,44,-2479,-1210,20.3,1618.2,blue,4,1,16,24,blue
4524489570,8,5,8,0,0,0,0,17603,7,18424,224,60,1835,1172,22.4,1760.3,5,8,7,2,1,1,0,15768,6.8,17252,186,60,-1835,-1172,18.6,1576.8,blue,3.2,1.5,16,20,blue
4442539318,1,11,0,0,0,0,0,13643,6.6,16564,199,60,-5479,-3332,19.9,1364.3,11,1,12,0,0,0,0,19122,7.2,19896,226,44,5479,3332,22.6,1912.2,red,0.09,23,16,15,red
4438353686,5,11,5,0,0,0,0,16228,6.6,17098,232,40,-1957,-963,23.2,1622.8,11,5,14,2,1,1,0,18185,7,18061,188,52,1957,963,18.8,1818.5,red,0.91,5,22,23,red
4496821254,9,6,9,2,1,1,0,18050,7.4,19654,239,37,1949,214,23.9,1805,6,9,2,0,0,0,0,16101,7,19440,214,58,-1949,-214,21.4,1610.1,red,3,0.89,17,13,blue
4527154540,5,8,6,0,0,0,0,16007,6.8,17474,206,52,-1729,-2105,20.6,1600.7,8,5,8,2,1,1,0,17736,7.4,19579,209,64,1729,2105,20.9,1773.6,red,1.38,3.2,168,20,blue
4497834161,10,5,8,1,1,0,1,17979,7,17675,194,48,3112,535,19.4,1797.9,5,10,2,0,0,0,0,14867,6.4,17140,189,52,-3112,-535,18.9,1486.7,blue,3.6,0.7,20,17,blue
4527466220,3,6,3,1,0,1,0,15552,7,18535,240,48,-1462,-607,24,1555.2,6,3,7,1,1,0,0,17014,7,19142,245,54,1462,607,24.5,1701.4,red,1,4.33,41,18,red
4472056933,12,6,16,0,0,0,0,18850,6.8,17995,216,55,3293,987,21.6,1885,6,12,7,0,0,0,0,15557,6.8,17008,210,37,-3293,-987,21,1555.7,blue,4.67,1.08,16,16,blue
4445137863,3,7,3,0,0,0,0,14698,6.6,16625,224,53,-1723,-2525,22.4,1469.8,7,3,4,1,1,0,0,16421,7,19150,216,64,1723,2525,21.6,1642.1,red,0.86,3.67,20,20,red
4473216293,2,10,1,0,0,0,0,13456,6.6,16144,164,50,-5199,-3608,16.4,1345.6,10,2,8,1,1,0,0,18655,7.4,19752,245,47,5199,3608,24.5,1865.5,red,0.3,9,102,18,red
4482149055,4,4,4,1,0,1,0,16777,6.8,18671,243,60,441,-233,24.3,1677.7,4,4,5,1,1,0,0,16336,7.2,18904,251,60,-441,233,25.1,1633.6,red,2,2.25,51,15,blue
4484008724,12,7,13,0,0,0,0,19146,7.4,19236,214,55,2994,2952,21.4,1914.6,7,12,7,1,1,0,0,16152,6.6,16284,175,50,-2994,-2952,17.5,1615.2,blue,3.57,1.17,29,14,blue
4449306681,10,11,7,0,0,0,0,18027,6.8,18601,212,46,850,2442,21.2,1802.7,11,10,16,1,1,0,0,17177,6.4,16159,174,42,-850,-2442,17.4,1717.7,red,1.55,2.7,20,16,blue
4513160500,11,6,9,1,0,1,0,17612,6.8,18342,212,46,1227,1050,21.2,1761.2,6,11,5,0,0,0,0,16385,6.8,17292,169,41,-1227,-1050,16.9,1638.5,blue,3.33,1,23,21,red
4478297307,0,4,0,0,0,0,0,14102,6.6,16718,225,64,-1936,-2432,22.5,1410.2,4,0,4,1,1,0,0,16038,7.2,19150,236,56,1936,2432,23.6,1603.8,red,0,12.65,15,15,red
4526158694,13,3,11,1,1,0,0,18000,7,18718,214,40,3330,3501,21.4,1800,3,13,3,0,0,0,0,14670,6.2,15217,209,42,-3330,-3501,20.9,1467,blue,8,0.46,17,17,red
4525865804,8,8,7,1,1,0,0,16613,6.8,17888,229,44,-271,99,22.9,1661.3,8,8,4,0,0,0,0,16884,6.8,17789,232,44,271,-99,23.2,1688.4,blue,1.88,1.5,19,19,blue
4479921636,8,2,11,2,1,1,0,17903,7.4,19614,216,55,3249,1410,21.6,1790.3,2,8,1,0,0,0,0,14654,7,18204,231,60,-3249,-1410,23.1,1465.4,blue,9.5,0.38,18,12,blue
4454104065,10,5,8,0,0,0,0,17907,7.4,19004,203,43,1227,2404,20.3,1790.7,5,10,11,0,0,0,0,16680,6.6,16600,218,40,-1227,-2404,21.8,1668,blue,3.6,1.6,23,45,red
4519295854,8,8,6,1,1,0,0,16002,6.8,17397,177,52,-1260,-1183,17.7,1600.2,8,8,13,0,0,0,0,17262,7,18580,209,56,1260,1183,20.9,1726.2,red,1.75,2.62,12,13,red
4518840459,4,6,4,1,1,0,0,14816,6.8,17070,204,46,-1631,-1140,20.4,1481.6,6,4,9,0,0,0,0,16447,6.8,18210,239,40,1631,1140,23.9,1644.7,red,1.33,3.75,17,50,blue
4455643326,5,3,4,1,1,0,0,16093,7.2,19191,245,49,517,222,24.5,1609.3,3,5,1,0,0,0,0,15576,7,18969,213,78,-517,-222,21.3,1557.6,blue,3,0.8,17,18,red
4497647239,8,6,8,2,1,1,1,18239,7,17409,199,46,2258,-819,19.9,1823.9,6,8,5,0,0,0,0,15981,7,18228,211,50,-2258,819,21.1,1598.1,blue,2.67,1.38,14,42,blue
4497608843,9,7,8,0,0,0,0,16969,7,18552,181,41,416,936,18.1,1696.9,7,9,4,1,1,0,0,16553,6.8,17616,231,42,-416,-936,23.1,1655.3,red,2.43,1.22,39,16,blue
4513532408,6,3,5,2,1,1,0,18596,7,19244,254,71,4633,3451,25.4,1859.6,3,6,3,0,0,0,0,13963,6.6,15793,192,33,-4633,-3451,19.2,1396.3,blue,3.67,1,91,18,blue
4492173417,4,6,7,1,1,0,0,15702,7,17467,230,64,-816,-1189,23,1570.2,6,4,7,0,0,0,0,16518,7.2,18656,224,52,816,1189,22.4,1651.8,red,1.83,3.25,18,65,blue
4507155035,3,4,3,0,0,0,0,15885,7.2,18620,252,60,-390,-52,25.2,1588.5,4,3,4,1,1,0,0,16275,7.2,18672,258,51,390,52,25.8,1627.5,red,1.5,2.67,17,23,red
4523988363,6,10,4,1,0,1,0,15292,6.8,17766,190,47,-2888,-1772,19,1529.2,10,6,11,1,1,0,0,18180,7.2,19538,231,42,2888,1772,23.1,1818,blue,1,3.5,14,14,red
4477273718,4,2,4,0,0,0,0,15843,7.2,18349,236,47,1284,395,23.6,1584.3,2,4,1,1,1,0,0,14559,7,17954,204,64,-1284,-395,20.4,1455.9,blue,4,0.75,15,20,blue
4462513119,5,7,5,1,1,0,0,16028,7,18310,216,65,-1437,-770,21.6,1602.8,7,5,9,0,0,0,0,17465,7,19080,259,48,1437,770,25.9,1746.5,red,1.43,3.2,45,34,red
4492355025,7,8,9,1,1,0,0,15718,6.6,16225,159,32,-1012,-316,15.9,1571.8,8,7,13,0,0,0,0,16730,6.6,16541,192,42,1012,316,19.2,1673,red,2,3,22,19,red
4525968792,11,9,13,1,1,0,0,17378,6.8,17926,167,46,202,1030,16.7,1737.8,9,11,9,1,0,1,0,17176,7,16896,203,42,-202,-1030,20.3,1717.6,red,2.67,1.64,15,14,red
4296004784,6,2,6,1,1,0,0,17354,7.4,19609,263,64,2944,3092,26.3,1735.4,2,6,2,0,0,0,0,14410,6.4,16517,232,44,-2944,-3092,23.2,1441,blue,6,0.67,24,27,blue
4520626535,13,7,13,1,1,0,0,19718,7.6,20453,215,68,3614,3374,21.5,1971.8,7,13,3,1,0,1,0,16104,6.6,17079,192,46,-3614,-3374,19.2,1610.4,blue,3.71,0.77,17,21,red
4474969616,11,5,9,1,1,0,1,20245,7.2,18815,245,47,4733,1669,24.5,2024.5,5,11,8,0,0,0,0,15512,6.8,17146,182,52,-4733,-1669,18.2,1551.2,blue,4,1.18,23,125,red
4469964060,7,12,2,0,0,0,0,15869,6.8,16808,162,48,-4369,-3324,16.2,1586.9,12,7,23,1,1,0,0,20238,7.6,20132,242,45,4369,3324,24.2,2023.8,red,0.75,5,20,22,red
4489610844,4,13,3,0,0,0,0,15321,6.2,16450,198,44,-4562,-2816,19.8,1532.1,13,4,12,1,0,1,0,19883,7.2,19266,222,43,4562,2816,22.2,1988.3,red,0.54,6.25,21,21,red
4417424903,8,6,5,0,0,0,0,16293,7.2,18611,218,44,-176,351,21.8,1629.3,6,8,5,0,0,0,0,16469,7,18260,203,56,176,-351,20.3,1646.9,red,2.17,1.38,10,17,blue
4495098102,10,6,12,2,1,1,1,19669,7.4,19333,220,62,4456,2338,22,1966.9,6,10,3,0,0,0,0,15213,6.6,16995,196,40,-4456,-2338,19.6,1521.3,blue,3.67,0.9,42,17,blue
4525381910,7,10,2,1,1,0,0,17093,7,18200,217,60,-492,175,21.7,1709.3,10,7,10,0,0,0,0,17585,7,18025,214,39,492,-175,21.4,1758.5,red,0.9,2.86,17,13,red
4520723011,5,0,4,1,1,0,0,17434,7.2,18954,257,54,4612,3848,25.7,1743.4,0,5,0,0,0,0,0,12822,6.4,15106,203,44,-4612,-3848,20.3,1282.2,blue,12.03,0,37,12,blue
4456066920,1,5,0,0,0,0,0,14250,6.8,17406,238,49,-1461,241,23.8,1425,5,1,5,2,1,1,0,15711,6.6,17165,228,34,1461,-241,22.8,1571.1,blue,0.2,10,19,25,red
4527078007,12,9,13,1,0,1,0,19104,7,17733,204,48,2241,1077,20.4,1910.4,9,12,11,1,1,0,0,16863,6.8,16656,200,48,-2241,-1077,20,1686.3,blue,2.78,1.67,59,19,blue
4519668670,9,5,9,0,0,0,0,17700,6.8,18269,216,38,2986,2450,21.6,1770,5,9,8,0,0,0,0,14714,6.4,15819,154,48,-2986,-2450,15.4,1471.4,red,3.6,1.44,140,16,blue
4506187953,6,5,5,0,0,0,0,15687,6.6,18199,206,46,-423,716,20.6,1568.7,5,6,6,0,0,0,0,16110,7,17483,219,44,423,-716,21.9,1611,blue,2.2,1.83,13,21,red
4492581093,4,4,6,0,0,0,0,15866,7,18127,221,53,218,-598,22.1,1586.6,4,4,4,1,1,0,0,15648,7.2,18725,219,60,-218,598,21.9,1564.8,blue,2.5,2,14,43,blue
4467013269,6,7,7,2,1,1,0,16079,7,19081,203,48,-1289,918,20.3,1607.9,7,6,8,0,0,0,0,17368,6.8,18163,264,42,1289,-918,26.4,1736.8,blue,1.86,2.5,41,32,red
4491334204,13,5,14,0,0,0,0,19610,7.6,20901,220,51,4491,5575,22,1961,5,13,4,1,1,0,0,15119,6.2,15326,186,51,-4491,-5575,18.6,1511.9,blue,5.4,0.69,26,18,blue
4467843663,7,4,10,0,0,0,0,16597,6.8,17747,232,36,2296,773,23.2,1659.7,4,7,4,0,0,0,0,14301,6.8,16974,153,55,-2296,-773,15.3,1430.1,blue,4.25,1.14,13,13,blue
4497782675,2,3,2,0,0,0,0,14211,6.8,17253,215,41,-1807,-2118,21.5,1421.1,3,2,1,1,1,0,0,16018,7.2,19371,252,75,1807,2118,25.2,1601.8,red,1.33,2,15,64,red
4486554038,4,2,2,2,1,1,0,15897,7,19077,235,68,188,1159,23.5,1589.7,2,4,3,0,0,0,0,15709,6.6,17918,255,53,-188,-1159,25.5,1570.9,blue,3,1.25,53,16,blue
4498463657,6,12,6,1,1,0,0,15740,6,14844,178,36,-5057,-3921,17.8,1574,12,6,16,0,0,0,1,20797,7.2,18765,238,47,5057,3921,23.8,2079.7,red,1,4.67,18,19,red
4440581251,6,9,8,1,1,0,0,17170,7.4,18831,237,54,-815,-699,23.7,1717,9,6,9,0,0,0,0,17985,7.2,19530,244,35,815,699,24.4,1798.5,red,1.56,3,22,18,red
4500406519,4,7,2,0,0,0,0,15950,6.8,17900,235,58,-365,-434,23.5,1595,7,4,7,0,0,0,0,16315,6.8,18334,225,37,365,434,22.5,1631.5,blue,0.86,3.5,22,18,blue
4521767127,9,3,7,0,0,0,0,17990,7,19289,226,51,2964,2253,22.6,1799,3,9,4,1,1,0,0,15026,6.4,17036,232,41,-2964,-2253,23.2,1502.6,blue,5.33,0.78,22,18,blue
4525534351,4,4,4,1,0,1,0,15749,7.4,19614,235,56,362,889,23.5,1574.9,4,4,2,1,1,0,0,15387,7.2,18725,226,59,-362,-889,22.6,1538.7,red,2,1.5,27,40,blue
4478776750,4,4,9,1,1,0,0,15317,6.6,16907,226,52,-1300,-120,22.6,1531.7,4,4,7,1,0,1,1,16617,6.8,17027,211,48,1300,120,21.1,1661.7,red,3.25,2.75,54,20,blue
4449441137,8,3,8,0,0,0,0,16896,7.4,19116,225,45,1447,2623,22.5,1689.6,3,8,2,1,1,0,0,15449,6.4,16493,190,52,-1447,-2623,19,1544.9,blue,5.33,0.62,41,88,red
4474923915,3,8,2,0,0,0,0,15085,6.8,17193,231,56,-2695,-152,23.1,1508.5,8,3,12,0,0,0,0,17780,6.6,17345,218,52,2695,152,21.8,1778,red,0.62,6.67,24,24,red
4488308418,9,6,8,1,0,1,0,17790,7,18908,203,51,1477,691,20.3,1779,6,9,4,0,0,0,0,16313,7,18217,208,48,-1477,-691,20.8,1631.3,blue,2.83,1.11,15,10,blue
4447596592,4,7,6,1,1,0,0,15245,6.8,17542,210,46,-2220,-1492,21,1524.5,7,4,5,0,0,0,0,17465,7.2,19034,218,60,2220,1492,21.8,1746.5,blue,1.43,3,38,16,red
4495930806,9,4,10,2,1,1,1,18654,7,17865,226,36,3054,439,22.6,1865.4,4,9,5,0,0,0,0,15600,6.8,17426,221,56,-3054,-439,22.1,1560,red,4.75,1,13,19,blue
4493176140,1,6,0,0,0,0,0,14266,7.2,18401,223,68,-1659,-874,22.3,1426.6,6,1,4,1,1,0,0,15925,7.2,19275,236,48,1659,874,23.6,1592.5,red,0.17,10,41,17,red
4482012777,9,6,10,0,0,0,0,17742,6.8,18190,185,56,1311,557,18.5,1774.2,6,9,6,1,1,0,0,16431,7,17633,232,54,-1311,-557,23.2,1643.1,blue,3.17,1.33,71,23,blue
4462971469,8,5,8,1,1,0,0,17610,7.4,18827,221,55,1677,809,22.1,1761,5,8,5,0,0,0,0,15933,7.2,18018,212,64,-1677,-809,21.2,1593.3,blue,3.2,1.25,21,18,blue
4527061275,5,8,4,0,0,0,0,15921,6.8,17466,203,40,-1110,-721,20.3,1592.1,8,5,6,0,0,0,0,17031,7.2,18187,215,49,1110,721,21.5,1703.1,red,1.12,2.8,16,16,red
4527162732,7,4,9,0,0,0,0,16860,7,17641,218,48,1293,-262,21.8,1686,4,7,2,0,0,0,0,15567,6.8,17903,219,55,-1293,262,21.9,1556.7,red,4,0.86,94,15,red
4496996454,3,9,4,0,0,0,0,13842,6.4,15669,181,42,-4256,-3319,18.1,1384.2,9,3,11,1,1,0,0,18098,7,18988,240,52,4256,3319,24,1809.8,red,0.78,6.67,15,20,red
4481963149,9,2,8,1,1,0,0,17378,7.4,19405,253,44,3268,2650,25.3,1737.8,2,9,3,0,0,0,0,14110,6.4,16755,212,52,-3268,-2650,21.2,1411,blue,8.5,0.56,14,18,red
4504886310,5,3,4,1,1,0,0,15979,7.2,18795,260,53,1027,615,26,1597.9,3,5,4,0,0,0,0,14952,7,18180,219,60,-1027,-615,21.9,1495.2,blue,3,1.4,22,22,red
4527462322,4,8,3,0,0,0,0,15475,7,17551,216,48,-1892,-2127,21.6,1547.5,8,4,9,1,1,0,0,17367,7.4,19678,211,63,1892,2127,21.1,1736.7,red,0.88,4.25,16,17,blue
4498201124,6,3,6,0,0,0,0,17077,7,16964,228,44,2537,1396,22.8,1707.7,3,6,3,0,0,0,0,14540,6,15568,208,40,-2537,-1396,20.8,1454,blue,4,1,17,65,blue
4451625868,3,8,1,0,0,0,0,14294,7,17770,206,51,-3738,-1260,20.6,1429.4,8,3,8,2,1,1,0,18032,7.2,19030,229,55,3738,1260,22.9,1803.2,red,0.5,5.33,20,16,red
4516532233,2,13,1,0,0,0,0,14504,6.6,16668,203,58,-3966,-3112,20.3,1450.4,13,2,14,1,1,0,0,18470,7.4,19780,192,53,3966,3112,19.2,1847,red,0.23,13.5,17,20,red
4497276216,10,10,7,0,0,0,0,18022,7.4,19347,202,50,1382,2107,20.2,1802.2,10,10,11,1,0,1,0,16640,6.6,17240,186,29,-1382,-2107,18.6,1664,blue,1.7,2.1,21,23,red
4526998867,3,6,5,2,1,1,0,15390,7,17555,230,46,-544,154,23,1539,6,3,4,0,0,0,0,15934,6.8,17401,216,52,544,-154,21.6,1593.4,red,1.33,3.33,18,18,blue
4493030469,8,6,8,0,0,0,0,17251,6.6,17267,192,63,339,876,19.2,1725.1,6,8,7,0,0,0,0,16912,6.4,16391,203,48,-339,-876,20.3,1691.2,red,2.67,1.62,14,16,red
4519809427,4,8,4,0,0,0,0,15337,6.8,17008,186,54,-2284,-3219,18.6,1533.7,8,4,4,1,1,0,0,17621,7.6,20227,230,66,2284,3219,23,1762.1,red,1,3,12,20,blue
4510540310,7,3,7,1,0,1,0,16498,7.2,18955,219,60,468,2091,21.9,1649.8,3,7,4,0,0,0,0,16030,6.6,16864,237,64,-468,-2091,23.7,1603,blue,4.67,1,71,180,red
4527509662,7,2,8,1,1,0,0,17359,7,18203,219,65,3098,1882,21.9,1735.9,2,7,1,1,0,1,0,14261,6.4,16321,213,36,-3098,-1882,21.3,1426.1,blue,7.5,0.43,19,16,blue
4468599765,12,3,14,0,0,0,0,20346,7.4,19902,228,58,5797,4364,22.8,2034.6,3,12,3,1,1,0,0,14549,6.2,15538,203,53,-5797,-4364,20.3,1454.9,blue,8.67,0.5,14,12,blue
4523853295,7,5,8,1,1,0,0,17711,7,18722,238,52,1127,628,23.8,1771.1,5,7,8,0,0,0,0,16584,7,18094,246,54,-1127,-628,24.6,1658.4,red,3,1.86,38,47,red
4507176171,4,4,6,0,0,0,0,15089,6.8,17046,213,40,-494,-817,21.3,1508.9,4,4,4,2,1,1,0,15583,6.8,17863,216,61,494,817,21.6,1558.3,red,2.5,2,21,26,red
4445820546,5,22,4,0,0,0,0,15077,6.4,15707,138,52,-7278,-6021,13.8,1507.7,22,5,12,0,0,0,0,22355,8,21728,229,36,7278,6021,22.9,2235.5,red,0.41,6.8,14,15,red
4518045882,4,5,4,1,1,0,0,15519,6.8,17775,236,45,-859,-1502,23.6,1551.9,5,4,5,0,0,0,0,16378,7.2,19277,237,65,859,1502,23.7,1637.8,blue,1.6,2.5,18,27,blue
4412982614,6,10,5,0,0,0,0,16003,6.8,17857,214,52,-1761,-1446,21.4,1600.3,10,6,9,0,0,0,0,17764,7.2,19303,238,32,1761,1446,23.8,1776.4,blue,1.1,3.17,28,26,blue
4496085988,4,2,5,0,0,0,0,16270,7,18684,248,60,454,333,24.8,1627,2,4,2,1,1,0,0,15816,7,18351,257,48,-454,-333,25.7,1581.6,red,4.5,1,20,19,blue
4492498778,8,11,7,0,0,0,0,17917,7.2,19033,234,55,39,-27,23.4,1791.7,11,8,13,1,1,0,0,17878,7.2,19060,180,59,-39,27,18,1787.8,red,1.36,3,47,32,red
4505942636,9,4,9,0,0,0,0,18099,7,18989,238,56,2420,2272,23.8,1809.9,4,9,4,1,1,0,0,15679,6.6,16717,218,50,-2420,-2272,21.8,1567.9,blue,4.5,0.89,23,22,red
4484058077,6,6,8,1,1,0,0,16073,7,18021,196,52,-570,467,19.6,1607.3,6,6,10,0,0,0,0,16643,6.8,17554,215,46,570,-467,21.5,1664.3,blue,2.33,2.67,38,149,blue
4513597747,5,2,4,1,0,1,0,15887,6.8,17744,240,42,1323,46,24,1588.7,2,5,3,1,1,0,0,14564,7,17698,208,61,-1323,-46,20.8,1456.4,blue,4.5,1,22,19,blue
4514274061,5,5,7,0,0,0,0,14486,6.6,15962,170,29,-3299,-2719,17,1448.6,5,5,4,2,1,1,0,17785,7,18681,256,68,3299,2719,25.6,1778.5,red,2.4,1.8,17,22,red
4466140539,2,5,4,0,0,0,0,14635,7,17734,235,54,-1478,-1388,23.5,1463.5,5,2,2,0,0,0,0,16113,7.2,19122,246,67,1478,1388,24.6,1611.3,red,1.2,3.5,15,16,blue
4503987105,10,4,15,1,1,0,0,18928,7.2,18365,210,47,4165,2230,21,1892.8,4,10,6,1,0,1,0,14763,6.6,16135,197,40,-4165,-2230,19.7,1476.3,blue,6.25,1,18,13,blue
4526764433,6,10,4,1,0,1,0,15649,6.8,17358,185,47,-2558,-828,18.5,1564.9,10,6,16,0,0,0,0,18207,7.2,18186,229,56,2558,828,22.9,1820.7,blue,1,4.33,17,20,red
4526811185,7,5,7,0,0,0,0,16291,7.2,18127,227,39,473,1581,22.7,1629.1,5,7,7,0,0,0,0,15818,6.6,16546,220,32,-473,-1581,22,1581.8,blue,2.8,1.71,17,17,red
4484124501,6,3,5,1,1,0,0,16523,7,18465,238,43,1284,1445,23.8,1652.3,3,6,2,0,0,0,0,15239,6.8,17020,239,56,-1284,-1445,23.9,1523.9,blue,3.67,0.83,17,20,blue
4475220338,3,10,1,1,0,1,0,15084,6.8,17618,188,54,-3847,-933,18.8,1508.4,10,3,11,1,1,0,1,18931,6.8,18551,232,37,3847,933,23.2,1893.1,red,0.4,7,36,14,red
4526169931,6,5,5,0,0,0,0,16146,6.8,17725,210,52,1136,376,21,1614.6,5,6,0,1,1,0,0,15010,6.8,17349,198,58,-1136,-376,19.8,1501,blue,2.2,0.83,16,16,red
4512832249,7,3,8,1,1,0,0,16945,6.8,17981,223,44,2136,-50,22.3,1694.5,3,7,3,0,0,0,0,14809,7,18031,238,41,-2136,50,23.8,1480.9,blue,5,0.86,23,41,blue
4493375568,6,4,5,0,0,0,0,16600,7,18970,208,60,735,161,20.8,1660,4,6,0,1,1,0,0,15865,7.2,18809,252,64,-735,-161,25.2,1586.5,blue,2.75,0.67,15,15,blue
4459091081,5,6,5,1,1,0,0,16941,7,19352,228,52,-441,390,22.8,1694.1,6,5,8,0,0,0,0,17382,7.2,18962,233,41,441,-390,23.3,1738.2,blue,1.67,2.8,21,84,red
4499759194,6,6,6,1,1,0,0,15862,6.8,17707,227,46,-152,-430,22.7,1586.2,6,6,11,1,0,1,0,16014,6.8,18137,210,47,152,430,21,1601.4,blue,2,2.83,17,21,red
4505103694,10,5,11,2,1,1,0,18526,7.4,19693,222,65,1924,1992,22.2,1852.6,5,10,7,0,0,0,0,16602,7,17701,240,42,-1924,-1992,24,1660.2,blue,4.2,1.2,72,13,red
4466463229,1,2,1,0,0,0,0,14399,6.8,18382,229,46,-621,319,22.9,1439.9,2,1,2,0,0,0,0,15020,6.8,18063,228,52,621,-319,22.8,1502,blue,1,4,17,12,red
4470281349,6,4,6,1,1,0,0,16496,7,17575,213,61,615,12,21.3,1649.6,4,6,4,0,0,0,0,15881,6.8,17563,227,40,-615,-12,22.7,1588.1,blue,3,1.33,17,17,blue
4487414658,4,2,3,1,1,0,0,16521,7.2,18785,261,48,2101,1400,26.1,1652.1,2,4,2,0,0,0,0,14420,6.6,17385,215,56,-2101,-1400,21.5,1442,blue,3.5,1,17,22,blue
4526251944,6,10,6,1,1,0,0,16972,7,18035,210,52,-1079,-2292,21,1697.2,10,6,6,0,0,0,0,18051,7.4,20327,209,68,1079,2292,20.9,1805.1,red,1.2,2.67,25,18,red
4525382011,5,11,5,0,0,0,0,16375,7,18609,231,60,-1189,-1074,23.1,1637.5,11,5,7,1,1,0,0,17564,7.4,19683,217,38,1189,1074,21.7,1756.4,red,0.91,3.6,12,18,red
4526486021,8,9,11,0,0,0,0,17149,7,18495,218,39,-1258,-725,21.8,1714.9,9,8,8,1,1,0,0,18407,7.4,19220,214,68,1258,725,21.4,1840.7,red,2.11,2.12,19,37,red
4525539493,6,8,8,0,0,0,0,15319,6.6,16582,158,68,-2416,-2808,15.8,1531.9,8,6,9,1,1,0,0,17735,7.2,19390,209,68,2416,2808,20.9,1773.5,red,1.75,2.83,19,19,blue
4522478777,13,5,15,0,0,0,0,19475,7,18495,218,37,4519,2852,21.8,1947.5,5,13,3,0,0,0,0,14956,6.4,15643,189,32,-4519,-2852,18.9,1495.6,blue,5.6,0.62,26,12,blue
4508648783,11,5,7,2,1,1,0,18576,7.2,20102,227,59,2276,1971,22.7,1857.6,5,11,6,0,0,0,0,16300,7,18131,213,67,-2276,-1971,21.3,1630,blue,3.6,1,14,16,blue
4495446798,16,5,16,2,1,1,0,20218,7,18749,207,58,4266,2910,20.7,2021.8,5,16,6,0,0,0,0,15952,6.4,15839,226,35,-4266,-2910,22.6,1595.2,blue,6.4,0.69,15,21,blue
4487268052,4,3,5,1,1,0,0,15398,7.2,17861,200,54,378,321,20,1539.8,3,4,2,1,0,1,0,15020,7,17540,227,48,-378,-321,22.7,1502,red,3,1.25,50,61,red
4522881704,15,13,15,1,1,0,0,19683,7.2,19202,195,52,879,1795,19.5,1968.3,13,15,18,0,0,0,0,18804,6.6,17407,179,53,-879,-1795,17.9,1880.4,blue,2.31,2.07,22,52,red
4516853831,9,9,18,0,0,0,0,17284,6.2,15506,182,42,550,-371,18.2,1728.4,9,9,15,0,0,0,0,16734,6.6,15877,192,44,-550,371,19.2,1673.4,blue,3,2.67,51,19,blue
4511740529,10,7,13,0,0,0,0,18281,6.8,17603,224,36,2064,2124,22.4,1828.1,7,10,9,0,0,0,0,16217,6.4,15479,191,43,-2064,-2124,19.1,1621.7,blue,3.29,1.6,19,16,red
4526099071,7,5,8,0,0,0,0,16905,6.8,17224,214,40,831,8,21.4,1690.5,5,7,8,1,1,0,0,16074,6.8,17216,218,61,-831,-8,21.8,1607.4,blue,3,1.86,19,16,red
4496735855,7,2,9,0,0,0,0,16875,6.6,17964,222,49,2590,682,22.2,1687.5,2,7,1,1,1,0,0,14285,6.8,17282,225,54,-2590,-682,22.5,1428.5,blue,8,0.43,19,16,blue
4510431880,6,3,8,0,0,0,0,16277,6.8,17277,210,36,1434,1040,21,1627.7,3,6,4,0,0,0,0,14843,6.6,16237,215,35,-1434,-1040,21.5,1484.3,blue,4.67,1.17,30,40,red
4472795984,10,8,7,0,0,0,0,18380,7.2,18318,220,42,1938,1013,22,1838,8,10,9,0,0,0,0,16442,6.8,17305,189,48,-1938,-1013,18.9,1644.2,blue,2.12,1.7,19,14,blue
4445812835,8,10,8,0,0,0,0,16622,6.6,16799,170,32,-1129,-1742,17,1662.2,10,8,10,1,1,0,0,17751,7.2,18541,211,45,1129,1742,21.1,1775.1,blue,1.6,2.5,15,41,red
4527434998,7,5,9,0,0,0,0,16388,6.8,16720,212,24,-1182,-2730,21.2,1638.8,5,7,5,1,1,0,0,17570,7,19450,229,74,1182,2730,22.9,1757,red,3.2,1.43,19,35,red
4523414749,7,4,6,0,0,0,0,17441,7.4,19668,214,55,2947,2247,21.4,1744.1,4,7,1,1,0,1,0,14494,7,17421,190,60,-2947,-2247,19,1449.4,blue,3.25,0.71,13,14,blue
4526734113,8,5,12,0,0,0,0,17469,7,18265,242,44,1625,121,24.2,1746.9,5,8,4,0,0,0,0,15844,6.8,18144,236,51,-1625,-121,23.6,1584.4,blue,4,1.12,20,16,blue
4464530205,5,8,5,0,0,0,0,15649,7,17079,201,51,-934,-732,20.1,1564.9,8,5,11,1,1,0,0,16583,6.8,17811,216,48,934,732,21.6,1658.3,red,1.25,3.8,21,21,red
4500454645,9,4,5,1,1,0,0,18130,7.2,19017,206,75,3154,1720,20.6,1813,4,9,1,1,0,1,0,14976,6.6,17297,194,52,-3154,-1720,19.4,1497.6,blue,3.5,0.56,19,14,blue
4518349357,8,8,10,0,0,0,0,17850,7.4,19495,256,54,30,-249,25.6,1785,8,8,7,1,1,0,0,17820,7.2,19744,234,68,-30,249,23.4,1782,red,2.25,1.88,15,14,blue
4454238812,7,7,8,0,0,0,0,16164,6.8,18803,239,40,-1050,88,23.9,1616.4,7,7,8,1,1,0,0,17214,7.2,18715,237,47,1050,-88,23.7,1721.4,red,2.14,2.14,16,16,red
4468676047,6,9,7,2,1,1,0,15928,6.4,16033,173,67,-1885,-1025,17.3,1592.8,9,6,10,0,0,0,0,17813,6.8,17058,233,17,1885,1025,23.3,1781.3,red,1.44,3.17,15,12,blue
4527324458,4,2,5,0,0,0,0,15356,6.4,16499,233,45,925,-400,23.3,1535.6,2,4,3,0,0,0,0,14431,6.8,16899,206,56,-925,400,20.6,1443.1,blue,4.5,1.25,26,20,blue
4527261284,6,6,9,0,0,0,0,16135,6.6,16582,181,67,-1370,-1220,18.1,1613.5,6,6,8,0,0,0,0,17505,6.8,17802,235,44,1370,1220,23.5,1750.5,red,2.5,2.33,22,17,blue
4527181514,3,1,2,0,0,0,0,16019,7.4,20401,262,76,1577,2582,26.2,1601.9,1,3,1,1,1,0,0,14442,7,17819,232,56,-1577,-2582,23.2,1444.2,blue,5,0.67,43,33,blue
4527505866,6,3,7,1,1,0,0,16079,6.6,17138,225,40,1769,1175,22.5,1607.9,3,6,5,0,0,0,0,14310,6.2,15963,185,53,-1769,-1175,18.5,1431,blue,4.33,1.33,19,19,red
4457514410,10,3,10,1,1,0,0,18272,7.4,20304,219,48,3619,3192,21.9,1827.2,3,10,2,0,0,0,0,14653,6.6,17112,222,46,-3619,-3192,22.2,1465.3,blue,6.67,0.5,24,14,blue
4523049172,3,4,1,0,0,0,0,15595,6.8,17779,241,64,65,-273,24.1,1559.5,4,3,4,1,1,0,0,15530,6.8,18052,228,57,-65,273,22.8,1553,blue,1,2.67,24,14,blue
4447488924,12,6,17,1,1,0,0,20010,7.2,20053,208,56,4311,2572,20.8,2001,6,12,5,0,0,0,0,15699,6.8,17481,214,33,-4311,-2572,21.4,1569.9,blue,4.83,0.92,19,21,blue
4419866013,8,6,12,1,1,0,0,16879,7,18288,199,44,45,-351,19.9,1687.9,6,8,5,0,0,0,0,16834,7,18639,254,49,-45,351,25.4,1683.4,red,3.33,1.38,19,31,red
4460600037,3,3,5,1,0,1,0,15578,7,18183,243,56,-313,-701,24.3,1557.8,3,3,3,1,1,0,0,15891,7.2,18884,253,62,313,701,25.3,1589.1,red,2.67,2,21,17,blue
4460518084,9,7,7,0,0,0,0,18877,7.6,20418,244,67,3094,1999,24.4,1887.7,7,9,6,0,0,0,0,15783,7.2,18419,205,39,-3094,-1999,20.5,1578.3,blue,2.29,1.44,14,22,blue
4526474246,10,3,12,0,0,0,0,18904,7.4,18979,236,52,4879,3774,23.6,1890.4,3,10,7,0,0,0,0,14025,6.2,15205,162,55,-4879,-3774,16.2,1402.5,blue,7.33,1,17,17,red
4505627084,9,8,12,1,1,0,0,17394,6.6,16652,175,56,182,-159,17.5,1739.4,8,9,7,0,0,0,0,17212,6.4,16811,192,48,-182,159,19.2,1721.2,red,2.62,1.67,22,22,blue
4513642822,5,7,13,2,1,1,0,16829,7,19002,251,64,-1212,972,25.1,1682.9,7,5,10,0,0,0,0,18041,7,18030,236,48,1212,-972,23.6,1804.1,red,2.57,3.4,21,17,red
4512257962,7,6,8,2,1,1,0,17002,7.2,18865,209,64,-365,-267,20.9,1700.2,6,7,5,0,0,0,0,17367,7.4,19132,229,50,365,267,22.9,1736.7,red,2.5,1.57,42,15,blue
4496156643,6,3,7,0,0,0,0,15721,6.8,17191,180,47,-24,-1070,18,1572.1,3,6,4,0,0,0,0,15745,7,18261,238,45,24,1070,23.8,1574.5,red,4.33,1.17,16,28,blue
4468831873,4,9,4,1,1,0,0,16263,6.6,16904,220,44,-1190,-1443,22,1626.3,9,4,9,0,0,0,0,17453,7,18347,208,46,1190,1443,20.8,1745.3,blue,0.89,4.5,16,15,red
4472015135,7,6,8,0,0,0,0,15833,6.8,16967,208,36,-1800,-2200,20.8,1583.3,6,7,8,1,1,0,0,17633,7,19167,245,60,1800,2200,24.5,1763.3,blue,2.5,2,19,18,blue
4511927788,2,7,1,0,0,0,0,14918,6.8,17605,221,53,-2442,-1427,22.1,1491.8,7,2,10,1,1,0,0,17360,7.2,19032,262,48,2442,1427,26.2,1736,red,0.43,8.5,28,19,red
4447490163,4,8,3,0,0,0,0,15043,6.6,16533,207,34,-2816,-2760,20.7,1504.3,8,4,10,1,1,0,0,17859,7.2,19293,232,57,2816,2760,23.2,1785.9,red,0.88,4.5,21,21,blue
4527448907,9,5,6,1,1,0,0,17775,6.8,18094,222,54,3629,5111,22.2,1777.5,5,9,5,0,0,0,0,14146,5.6,12983,123,55,-3629,-5111,12.3,1414.6,blue,3,1.11,10,6,blue
4489712719,11,6,12,0,0,0,0,20012,7.2,19043,231,50,4093,1925,23.1,2001.2,6,11,6,1,1,0,0,15919,6.6,17118,215,42,-4093,-1925,21.5,1591.9,blue,3.83,1.09,19,20,blue
4524055982,5,6,4,1,1,0,0,15954,7,18014,228,52,26,693,22.8,1595.4,6,5,4,0,0,0,0,15928,6.8,17321,190,44,-26,-693,19,1592.8,red,1.5,2,40,17,red
4493892937,2,8,1,2,1,1,0,14194,6.8,17765,192,62,-1949,-18,19.2,1419.4,8,2,9,0,0,0,0,16143,7,17783,190,53,1949,18,19,1614.3,blue,0.38,8.5,49,22,red
4508006237,4,8,5,0,0,0,0,14689,6.6,16546,174,55,-3860,-1719,17.4,1468.9,8,4,4,2,1,1,1,18549,7.2,18265,253,42,3860,1719,25.3,1854.9,blue,1.12,3,13,19,red
4391232237,10,13,6,0,0,0,0,18152,7,18229,245,41,-921,-1198,24.5,1815.2,13,10,16,1,1,0,0,19073,7.2,19427,206,44,921,1198,20.6,1907.3,red,1.23,2.9,18,22,blue
4417615828,6,6,7,1,1,0,0,16642,7,18251,218,52,-348,-611,21.8,1664.2,6,6,4,1,0,1,0,16990,7,18862,237,40,348,611,23.7,1699,red,2.17,1.67,15,15,red
4526114014,1,5,2,0,0,0,0,13383,6.4,15553,193,46,-4079,-2994,19.3,1338.3,5,1,5,1,1,0,0,17462,7,18547,245,53,4079,2994,24.5,1746.2,red,0.6,10,16,18,red
4513209170,6,5,7,0,0,0,0,16818,7.4,18786,232,57,936,704,23.2,1681.8,5,6,2,2,1,1,0,15882,7.2,18082,221,54,-936,-704,22.1,1588.2,red,2.6,1.17,25,19,red
4481500252,3,8,6,0,0,0,0,16621,6.6,17456,244,48,-2115,-456,24.4,1662.1,8,3,15,2,1,1,0,18736,6.8,17912,222,64,2115,456,22.2,1873.6,red,1.12,7.67,19,12,red
4465904473,8,5,9,1,1,0,0,16729,6.8,17848,220,43,1204,349,22,1672.9,5,8,5,0,0,0,0,15525,7,17499,214,48,-1204,-349,21.4,1552.5,blue,3.4,1.25,32,21,blue
4525980245,3,6,6,0,0,0,0,14630,6.6,16137,181,71,-1309,-1408,18.1,1463,6,3,6,1,1,0,0,15939,6.6,17545,212,45,1309,1408,21.2,1593.9,red,1.5,4,18,15,blue
4458849950,6,5,5,0,0,0,0,16489,6.6,17669,237,59,1212,1107,23.7,1648.9,5,6,6,1,1,0,0,15277,6.6,16562,196,60,-1212,-1107,19.6,1527.7,red,2.2,1.83,20,18,blue
4442575242,2,11,4,0,0,0,0,13608,6.6,15291,178,45,-5040,-6118,17.8,1360.8,11,2,9,0,0,0,0,18648,7.6,21409,202,80,5040,6118,20.2,1864.8,red,0.55,10,16,51,red
4512250515,6,0,8,1,1,0,0,16583,7,18572,244,64,2532,1722,24.4,1658.3,0,6,0,0,0,0,0,14051,6.6,16850,223,56,-2532,-1722,22.3,1405.1,blue,12.03,0,22,18,blue
4525839083,10,5,9,2,1,1,1,19439,7.4,19736,244,50,3863,2639,24.4,1943.9,5,10,5,0,0,0,0,15576,6.6,17097,197,49,-3863,-2639,19.7,1557.6,blue,3.8,1,38,19,blue
4464386796,5,10,2,1,0,1,0,15974,6.8,18618,226,60,-2545,-1541,22.6,1597.4,10,5,9,1,1,0,0,18519,7.6,20159,247,56,2545,1541,24.7,1851.9,red,0.7,3.8,15,17,red
4517738815,4,6,3,0,0,0,0,15865,7,18037,225,50,-517,-425,22.5,1586.5,6,4,8,1,1,0,0,16382,6.8,18462,244,45,517,425,24.4,1638.2,blue,1.17,3.5,18,18,blue
4465355260,6,7,4,0,0,0,0,15919,6.6,16708,205,51,-3288,-2511,20.5,1591.9,7,6,10,2,1,1,1,19207,7.2,19219,229,52,3288,2511,22.9,1920.7,red,1.43,2.83,24,49,red
4526459511,5,2,5,1,0,1,0,15360,7.2,18594,207,47,818,1913,20.7,1536,2,5,3,1,1,0,0,14542,6.6,16681,224,57,-818,-1913,22.4,1454.2,blue,5,1,25,21,blue
4457833160,9,6,10,1,1,0,0,16836,6.6,17688,186,48,312,-613,18.6,1683.6,6,9,4,0,0,0,0,16524,6.8,18301,215,54,-312,613,21.5,1652.4,red,3.17,1.11,22,21,blue
4471240919,7,2,5,0,0,0,0,16284,7.2,18617,216,49,1496,1758,21.6,1628.4,2,7,3,0,0,0,0,14788,6.8,16859,225,44,-1496,-1758,22.5,1478.8,blue,6,0.71,25,23,blue
4476715890,11,4,7,1,1,0,0,18303,7.2,19093,214,54,3586,2697,21.4,1830.3,4,11,2,0,0,0,0,14717,6.4,16396,180,46,-3586,-2697,18,1471.7,blue,4.5,0.55,19,17,blue
4463393094,5,7,3,0,0,0,0,16206,7,17906,229,53,-33,1233,22.9,1620.6,7,5,8,1,1,0,0,16239,6.6,16673,200,40,33,-1233,20,1623.9,red,1.14,3,14,17,red
4526802557,8,9,9,0,0,0,0,17310,7,18101,202,45,390,-300,20.2,1731,9,8,8,1,1,0,0,16920,7,18401,193,46,-390,300,19.3,1692,blue,1.89,2.12,19,25,blue
4482288525,4,6,4,0,0,0,0,14562,6.6,15925,164,44,-1295,-1230,16.4,1456.2,6,4,5,1,1,0,0,15857,6.6,17155,213,56,1295,1230,21.3,1585.7,blue,1.33,2.75,19,20,red
4526253897,6,3,10,0,0,0,0,15954,6.8,17647,203,44,534,89,20.3,1595.4,3,6,4,1,1,0,0,15420,6.8,17558,248,45,-534,-89,24.8,1542,red,5.33,1.17,59,18,blue
4526239268,2,11,4,1,1,0,0,14079,6.6,16131,215,51,-4780,-3425,21.5,1407.9,11,2,13,0,0,0,0,18859,7.4,19556,214,52,4780,3425,21.4,1885.9,red,0.55,12,9,18,red
4473277944,4,6,7,0,0,0,0,16636,7.2,18650,243,52,668,-462,24.3,1663.6,6,4,5,1,1,0,0,15968,7.4,19112,223,48,-668,462,22.3,1596.8,red,1.83,2.75,15,15,blue
4481132902,6,12,4,0,0,0,0,16048,6.6,16740,209,40,-2954,-2865,20.9,1604.8,12,6,15,0,0,0,0,19002,7.2,19605,206,55,2954,2865,20.6,1900.2,red,0.83,4.5,13,17,red
4484374414,3,11,3,0,0,0,0,14953,6.6,17005,221,57,-3903,-2090,22.1,1495.3,11,3,18,1,1,0,0,18856,7.2,19095,239,47,3903,2090,23.9,1885.6,red,0.55,9.67,21,19,blue
4488750744,5,1,4,0,0,0,0,16279,7,18714,255,57,2004,385,25.5,1627.9,1,5,1,1,1,0,0,14275,7,18329,213,66,-2004,-385,21.3,1427.5,blue,9,0.4,21,23,blue
4524479196,1,8,2,0,0,0,0,13841,6.8,16368,216,49,-5048,-4145,21.6,1384.1,8,1,6,1,1,0,0,18889,7.4,20513,268,53,5048,4145,26.8,1888.9,red,0.38,14,13,18,red
4503514914,3,3,1,0,0,0,0,15311,7,17731,187,67,597,1596,18.7,1531.1,3,3,7,1,1,0,0,14714,6.4,16135,212,45,-597,-1596,21.2,1471.4,red,1.33,3.33,40,18,red
4526060339,10,7,12,2,1,1,0,16677,6.6,15835,168,56,-503,-790,16.8,1667.7,7,10,10,0,0,0,0,17180,6.6,16625,191,50,503,790,19.1,1718,red,3.14,1.7,20,19,blue
4527241479,7,6,8,0,0,0,0,16224,7,18263,189,45,-376,1005,18.9,1622.4,6,7,7,1,1,0,0,16600,6.6,17258,220,45,376,-1005,22,1660,red,2.5,1.86,92,16,red
4453181385,7,5,4,2,1,1,0,16372,7.2,19294,208,54,1162,2078,20.8,1637.2,5,7,5,0,0,0,0,15210,7,17216,193,40,-1162,-2078,19.3,1521,blue,2.2,1.43,19,18,red
4494580681,12,2,13,1,1,0,0,19306,7.4,19450,206,72,5831,4588,20.6,1930.6,2,12,0,0,0,0,0,13475,6.4,14862,197,48,-5831,-4588,19.7,1347.5,blue,12.5,0.17,26,23,blue
4484552645,8,8,6,0,0,0,1,18801,7.2,19438,215,74,1917,1322,21.5,1880.1,8,8,6,1,1,0,0,16884,7,18116,202,50,-1917,-1322,20.2,1688.4,blue,1.75,1.75,18,21,blue
4513018966,9,1,10,1,1,0,0,16988,7,18314,209,43,3222,2205,20.9,1698.8,1,9,0,0,0,0,0,13766,6.6,16109,218,47,-3222,-2205,21.8,1376.6,blue,19,0.11,19,18,blue
4486920046,4,9,3,0,0,0,0,15027,6.6,16491,216,44,-3148,-2107,21.6,1502.7,9,4,9,1,1,0,0,18175,7,18598,220,56,3148,2107,22,1817.5,red,0.78,4.5,15,18,red
4468826145,6,9,3,1,1,0,0,15512,6.6,17704,198,50,-2399,-1527,19.8,1551.2,9,6,5,0,0,0,0,17911,7.2,19231,222,48,2399,1527,22.2,1791.1,red,1,2.33,17,16,red
4517889470,4,7,4,1,0,1,0,17147,6.8,17894,213,53,946,-439,21.3,1714.7,7,4,9,1,1,0,0,16201,7,18333,222,44,-946,439,22.2,1620.1,red,1.14,4,16,18,red
4526791420,3,3,3,1,0,1,1,16748,7,17820,221,64,2533,1524,22.1,1674.8,3,3,4,1,1,0,0,14215,6.4,16296,198,44,-2533,-1524,19.8,1421.5,blue,2,2.33,20,39,red
4525152845,4,12,3,0,0,0,0,14456,6.6,17039,212,46,-4680,-3190,21.2,1445.6,12,4,14,2,1,1,0,19136,7.6,20229,220,64,4680,3190,22,1913.6,red,0.58,6.5,15,16,red
4463150629,10,7,16,1,1,0,0,18247,7,18886,225,36,1348,1158,22.5,1824.7,7,10,10,1,0,1,0,16899,6.6,17728,224,68,-1348,-1158,22.4,1689.9,blue,3.71,1.7,25,43,blue
4476078832,9,5,7,0,0,0,0,18196,7.2,19070,230,59,2763,1667,23,1819.6,5,9,6,1,1,0,0,15433,6.8,17403,194,56,-2763,-1667,19.4,1543.3,blue,3.2,1.22,19,14,blue
4527403029,7,7,10,1,1,0,0,16866,6.8,18028,220,48,-808,-1078,22,1686.6,7,7,8,0,0,0,0,17674,7.2,19106,234,60,808,1078,23.4,1767.4,blue,2.43,2.14,19,18,blue
4506509024,4,7,2,1,1,0,0,13960,6.4,16218,184,52,-2791,-2142,18.4,1396,7,4,7,0,0,0,0,16751,7,18360,238,49,2791,2142,23.8,1675.1,red,0.86,3.5,20,20,red
4484067506,3,6,4,0,0,0,0,14545,6.6,16581,190,51,-1199,-752,19,1454.5,6,3,6,1,1,0,0,15744,6.8,17333,203,50,1199,752,20.3,1574.4,red,1.17,4,14,49,red
4477016588,12,5,7,1,1,0,0,18894,7.2,18656,195,67,2712,1181,19.5,1889.4,5,12,5,0,0,0,0,16182,6.6,17475,195,58,-2712,-1181,19.5,1618.2,blue,3.8,0.83,13,14,blue
4526048930,4,10,7,0,0,0,0,14595,6.4,15889,181,44,-4266,-4094,18.1,1459.5,10,4,7,1,1,0,0,18861,7.6,19983,245,52,4266,4094,24.5,1886.1,red,1.1,4.25,21,19,red
4507914365,11,6,15,1,0,1,0,19670,7.4,19683,239,52,3380,1666,23.9,1967,6,11,10,0,0,0,0,16290,7,18017,197,52,-3380,-1666,19.7,1629,blue,4.33,1.45,24,22,blue
4484159432,11,3,15,1,1,0,0,19116,7.6,19542,223,36,3648,1867,22.3,1911.6,3,11,2,0,0,0,0,15468,7,17675,209,68,-3648,-1867,20.9,1546.8,blue,8.67,0.45,44,17,blue
4480526985,6,3,6,0,0,0,0,17186,7,18505,234,68,2320,2234,23.4,1718.6,3,6,6,0,0,0,0,14866,6.6,16271,207,44,-2320,-2234,20.7,1486.6,blue,4,1.5,19,19,blue
4463010085,2,6,2,0,0,0,0,14498,7,17488,223,57,-1754,-1471,22.3,1449.8,6,2,4,0,0,0,0,16252,7.2,18959,228,66,1754,1471,22.8,1625.2,red,0.67,5,16,19,red
4519068942,6,6,2,2,1,1,0,17085,7.2,18329,229,80,411,-493,22.9,1708.5,6,6,9,0,0,0,0,16674,7.2,18822,213,47,-411,493,21.3,1667.4,blue,1.33,2.5,37,9,blue
4509889611,12,3,14,1,1,0,0,19032,7.2,19015,191,63,3965,3505,19.1,1903.2,3,12,3,0,0,0,0,15067,6.4,15510,182,52,-3965,-3505,18.2,1506.7,blue,8.67,0.5,84,15,blue
4456427042,1,10,0,0,0,0,0,14401,6.8,17502,212,75,-3441,-1825,21.2,1440.1,10,1,10,1,1,0,0,17842,7.2,19327,229,54,3441,1825,22.9,1784.2,red,0.1,20,15,17,red
4525855407,6,10,5,1,1,0,0,15741,6.8,17468,198,43,-1864,-1069,19.8,1574.1,10,6,7,0,0,0,0,17605,7.2,18537,205,48,1864,1069,20.5,1760.5,blue,1.1,2.83,16,20,red
4500029436,9,3,12,0,0,0,1,19138,6.8,18317,239,40,3653,1553,23.9,1913.8,3,9,4,1,0,1,1,15485,6.6,16764,193,50,-3653,-1553,19.3,1548.5,blue,7,0.78,16,18,blue
4452155671,7,6,10,1,0,1,0,17363,7,18387,233,39,1449,521,23.3,1736.3,6,7,6,1,1,0,0,15914,7,17866,206,42,-1449,-521,20.6,1591.4,blue,2.83,1.71,19,52,blue
4497782255,2,5,2,0,0,0,0,15190,7,18432,241,60,-1782,-754,24.1,1519,5,2,3,1,1,0,0,16972,7.2,19186,251,72,1782,754,25.1,1697.2,red,0.8,4,21,21,red
4438156005,5,7,3,2,1,1,0,15592,7,18837,205,64,-1711,-303,20.5,1559.2,7,5,8,0,0,0,0,17303,7.2,19140,241,56,1711,303,24.1,1730.3,red,1.14,3,15,21,blue
4461233221,5,6,5,0,0,0,0,15951,6.8,17680,221,43,322,1046,22.1,1595.1,6,5,8,0,0,0,0,15629,6.8,16634,203,37,-322,-1046,20.3,1562.9,blue,1.67,2.8,21,21,red
4499645547,5,8,9,0,0,0,0,15934,6.4,16140,199,45,-2277,-2919,19.9,1593.4,8,5,8,1,1,0,0,18211,7,19059,257,64,2277,2919,25.7,1821.1,red,1.75,3.2,15,18,blue
4478456612,4,4,5,0,0,0,0,15894,7,18853,223,60,310,536,22.3,1589.4,4,4,4,1,1,0,0,15584,7,18317,223,54,-310,-536,22.3,1558.4,blue,2.25,2,46,24,red
4524262225,5,7,3,0,0,0,0,16148,6.8,18119,237,46,-404,-1058,23.7,1614.8,7,5,6,2,1,1,0,16552,7,19177,215,53,404,1058,21.5,1655.2,red,1.14,2.6,18,17,red
4491873583,7,8,5,0,0,0,0,16456,6.8,16502,209,55,-706,-1460,20.9,1645.6,8,7,8,1,1,0,0,17162,6.8,17962,200,55,706,1460,20,1716.2,red,1.5,2.29,19,22,red
4448379921,7,8,10,2,1,1,0,17903,7,18746,239,63,651,748,23.9,1790.3,8,7,12,0,0,0,0,17252,7,17998,217,48,-651,-748,21.7,1725.2,red,2.12,2.86,25,23,blue
4505990555,6,3,12,0,0,0,0,16925,6.6,17065,212,40,784,-2929,21.2,1692.5,3,6,2,0,0,0,0,16141,7.2,19994,224,91,-784,2929,22.4,1614.1,blue,6,0.83,18,17,blue
4518732690,3,5,7,1,1,0,0,14966,7,17656,227,44,-1966,-1549,22.7,1496.6,5,3,4,1,0,1,0,16932,7.2,19205,247,48,1966,1549,24.7,1693.2,red,2,3,21,16,blue
4525292315,6,10,7,1,0,1,0,16014,7.2,18062,211,56,-2651,-1289,21.1,1601.4,10,6,13,1,1,0,0,18665,7.2,19351,240,51,2651,1289,24,1866.5,blue,1.3,3.83,40,18,red
4526057851,3,7,1,0,0,0,0,15311,6.8,18263,229,60,-1731,-1553,22.9,1531.1,7,3,4,1,1,0,0,17042,7.4,19816,238,63,1731,1553,23.8,1704.2,red,0.57,3.67,17,83,red
4526633001,4,2,3,0,0,0,0,16177,7,18367,226,56,1255,277,22.6,1617.7,2,4,1,0,0,0,0,14922,6.8,18090,253,45,-1255,-277,25.3,1492.2,red,3.5,0.75,18,18,blue
4526103377,5,6,7,0,0,0,0,16123,6.8,17612,203,60,569,304,20.3,1612.3,6,5,4,1,1,0,0,15554,6.8,17308,181,60,-569,-304,18.1,1555.4,blue,2,2,88,17,red
4527270675,10,6,9,0,0,0,0,18344,7.2,18470,222,55,2326,987,22.2,1834.4,6,10,5,0,0,0,0,16018,7,17483,188,56,-2326,-987,18.8,1601.8,red,3.17,1.1,24,20,blue
4417362254,5,4,5,1,0,1,0,17564,7.4,20203,257,73,1369,1440,25.7,1756.4,4,5,5,1,1,0,0,16195,7.2,18763,233,43,-1369,-1440,23.3,1619.5,red,2.5,1.8,15,23,blue
4459463690,4,4,5,1,1,0,0,15676,7,19069,231,61,-261,443,23.1,1567.6,4,4,8,1,0,1,0,15937,6.8,18626,231,56,261,-443,23.1,1593.7,blue,2.25,3,21,60,red
4500854346,1,4,0,0,0,0,0,15652,7,18830,258,64,11,-139,25.8,1565.2,4,1,4,2,1,1,0,15641,7,18969,227,52,-11,139,22.7,1564.1,red,0.25,8,35,27,red
4467862482,10,6,11,1,1,0,0,18079,7.2,18997,215,48,1120,10,21.5,1807.9,6,10,3,0,0,0,0,16959,7,18987,226,64,-1120,-10,22.6,1695.9,blue,3.5,0.9,23,16,red
4483650027,1,6,1,0,0,0,0,14325,6.8,17432,235,57,-1887,-587,23.5,1432.5,6,1,10,1,1,0,0,16212,7.2,18019,228,52,1887,587,22.8,1621.2,red,0.33,16,20,21,red
4526478943,5,7,6,0,0,0,0,16132,6.8,17519,210,50,-155,-51,21,1613.2,7,5,11,0,0,0,0,16287,7,17570,191,54,155,51,19.1,1628.7,red,1.57,3.6,17,24,red
4458122797,7,2,10,0,0,0,0,17130,7,18124,226,47,1931,1567,22.6,1713,2,7,4,0,0,0,0,15199,6.8,16557,219,52,-1931,-1567,21.9,1519.9,blue,8.5,0.86,16,18,blue
4455496628,9,7,16,1,1,0,1,19459,7,17657,206,61,1896,-423,20.6,1945.9,7,9,6,0,0,0,1,17563,7,18080,215,48,-1896,423,21.5,1756.3,blue,3.57,1.44,97,16,blue
4505237084,5,4,4,0,0,0,0,15742,6.8,17504,219,55,501,642,21.9,1574.2,4,5,5,1,1,0,0,15241,6.6,16862,196,52,-501,-642,19.6,1524.1,red,2.25,1.8,17,14,blue
4524627425,4,7,6,1,0,1,0,15412,6.8,17498,192,63,-1271,101,19.2,1541.2,7,4,8,0,0,0,0,16683,7,17397,233,37,1271,-101,23.3,1668.3,red,1.43,3.75,22,25,red
4468926711,4,8,4,0,0,0,0,15337,6.6,16778,217,40,-2811,-2298,21.7,1533.7,8,4,7,1,1,0,0,18148,7.2,19076,224,56,2811,2298,22.4,1814.8,blue,1,3.75,16,19,red
4483393050,6,6,4,1,1,0,0,15969,7,17823,217,36,-1070,-893,21.7,1596.9,6,6,4,0,0,0,0,17039,7,18716,254,58,1070,893,25.4,1703.9,red,1.67,1.67,14,15,blue
4527479839,8,7,10,0,0,0,0,16347,6.8,16992,185,40,-559,-794,18.5,1634.7,7,8,4,1,0,1,0,16906,7,17786,215,49,559,794,21.5,1690.6,blue,2.57,1.38,46,19,red
4447657197,13,8,11,0,0,0,1,20341,7.4,19192,235,40,3202,2467,23.5,2034.1,8,13,10,1,1,0,0,17139,6.6,16725,189,48,-3202,-2467,18.9,1713.9,blue,3,1.38,39,30,blue
4446037103,5,6,3,0,0,0,0,16507,7.2,18410,228,58,731,44,22.8,1650.7,6,5,8,1,0,1,0,15776,7.2,18366,203,47,-731,-44,20.3,1577.6,red,1.33,2.8,25,24,blue
4500263311,2,5,0,1,1,0,0,13649,6.8,17258,199,52,-2497,-1239,19.9,1364.9,5,2,4,0,0,0,0,16146,7,18497,211,60,2497,1239,21.1,1614.6,red,0.4,4.5,104,16,red
4508345813,6,11,9,0,0,0,0,15377,6.4,15779,191,32,-4853,-3538,19.1,1537.7,11,6,7,0,0,0,1,20230,7,19317,230,59,4853,3538,23,2023,red,1.36,3,14,17,blue
4448127170,2,3,3,1,0,1,0,15345,7.2,18848,230,64,-164,1358,23,1534.5,3,2,7,1,1,0,0,15509,6.6,17490,236,55,164,-1358,23.6,1550.9,red,1.67,5,41,22,blue
4508433875,3,9,3,0,0,0,0,14426,6.6,16666,205,42,-3954,-1940,20.5,1442.6,9,3,7,1,1,0,1,18380,7.2,18606,254,56,3954,1940,25.4,1838,red,0.67,5.33,23,25,blue
4472597794,7,7,4,1,1,0,0,16518,7,18036,229,43,176,943,22.9,1651.8,7,7,9,0,0,0,0,16342,6.6,17093,200,38,-176,-943,20,1634.2,red,1.57,2.29,17,11,red
4521031841,1,6,0,1,1,0,0,14112,6.8,17265,232,48,-2720,-2419,23.2,1411.2,6,1,4,1,0,1,0,16832,7.4,19684,247,57,2720,2419,24.7,1683.2,red,0.17,10,12,54,red
4504366745,6,5,8,0,0,0,0,16809,7.4,19023,225,68,226,557,22.5,1680.9,5,6,7,2,1,1,0,16583,7.2,18466,239,64,-226,-557,23.9,1658.3,red,2.8,2,27,56,red
4489524700,7,8,6,1,1,0,0,17011,7.2,18754,231,48,-2215,-138,23.1,1701.1,8,7,13,1,0,1,2,19226,7,18892,206,62,2215,138,20.6,1922.6,red,1.62,3,12,13,blue
4505180812,6,3,6,1,1,0,0,16928,7.2,18438,236,52,1071,-35,23.6,1692.8,3,6,0,0,0,0,0,15857,7.2,18473,254,71,-1071,35,25.4,1585.7,red,4,0.5,21,21,blue
4519488029,3,11,2,0,0,0,0,14016,6.6,16299,190,52,-4534,-2709,19,1401.6,11,3,13,1,1,0,0,18550,7.2,19008,228,47,4534,2709,22.8,1855,red,0.45,8,17,16,red
4520674839,7,4,10,0,0,0,0,16082,6.8,17134,199,49,287,289,19.9,1608.2,4,7,4,0,0,0,0,15795,6.6,16845,209,52,-287,-289,20.9,1579.5,blue,4.25,1.14,27,35,red
4445105963,10,3,12,2,1,1,0,18851,7.4,19537,230,52,4064,2564,23,1885.1,3,10,5,0,0,0,0,14787,6.8,16973,195,40,-4064,-2564,19.5,1478.7,blue,7.33,0.8,15,14,blue
4477246818,10,3,6,2,1,1,1,19994,7.6,20865,248,56,5475,3713,24.8,1999.4,3,10,2,0,0,0,0,14519,7,17152,217,48,-5475,-3713,21.7,1451.9,blue,5.33,0.5,46,21,blue
4517494677,8,5,9,0,0,0,0,17935,7,18860,226,55,2070,1331,22.6,1793.5,5,8,5,0,0,0,0,15865,6.8,17529,214,55,-2070,-1331,21.4,1586.5,red,3.4,1.25,24,22,red
4464979859,3,10,4,0,0,0,0,13539,6.6,15736,163,48,-5293,-3777,16.3,1353.9,10,3,13,0,0,0,0,18832,7.4,19513,236,63,5293,3777,23.6,1883.2,red,0.7,7.67,63,33,red
4522467789,2,8,1,0,0,0,0,13874,6.6,17105,203,52,-4231,-3158,20.3,1387.4,8,2,7,1,1,0,0,18105,7.6,20263,248,69,4231,3158,24.8,1810.5,red,0.38,7.5,17,22,red
4492353523,7,6,7,0,0,0,0,16920,7,17906,204,60,1563,901,20.4,1692,6,7,8,0,0,0,0,15357,6.8,17005,178,56,-1563,-901,17.8,1535.7,blue,2.33,2,15,19,blue
4467058840,9,12,5,0,0,0,0,17484,7.2,18682,222,52,-978,-535,22.2,1748.4,12,9,13,1,1,0,0,18462,7,19217,213,49,978,535,21.3,1846.2,blue,1.17,2.78,23,21,red
4466017126,9,10,9,0,0,0,0,16731,7,17994,191,52,-1625,-442,19.1,1673.1,10,9,12,0,0,0,0,18356,7,18436,229,34,1625,442,22.9,1835.6,red,1.8,2.44,17,18,red
4505097297,7,7,5,0,0,0,0,16374,6.6,17432,194,54,-255,1128,19.4,1637.4,7,7,7,1,1,0,0,16629,6.8,16304,194,50,255,-1128,19.4,1662.9,red,1.71,2,21,24,red
4511522189,5,5,4,1,1,0,0,15706,6.8,18183,219,48,-578,-1149,21.9,1570.6,5,5,2,0,0,0,0,16284,7.2,19332,240,60,578,1149,24,1628.4,red,1.8,1.4,23,23,blue
4447981243,2,13,2,1,1,0,0,14368,6.8,16711,201,52,-5683,-5256,20.1,1436.8,13,2,13,0,0,0,0,20051,8,21967,270,49,5683,5256,27,2005.1,red,0.31,13,21,24,blue
4495691730,5,9,5,0,0,0,0,15081,6.2,15753,195,41,-1492,-1219,19.5,1508.1,9,5,14,0,0,0,0,16573,6.6,16972,218,22,1492,1219,21.8,1657.3,red,1.11,4.6,11,21,blue
4510888904,8,13,5,0,0,0,0,16077,6.8,16712,180,48,-3056,-2462,18,1607.7,13,8,12,0,0,0,0,19133,7.2,19174,223,38,3056,2462,22.3,1913.3,red,1,3.12,20,21,red
4489607487,3,6,3,0,0,0,0,15092,7,18501,204,70,-1857,-699,20.4,1509.2,6,3,6,2,1,1,0,16949,7.2,19200,252,53,1857,699,25.2,1694.9,red,1,4,18,21,red
4525362922,3,5,2,1,1,0,0,14986,6.8,17946,220,72,-2042,-436,22,1498.6,5,3,6,1,0,1,1,17028,7,18382,232,24,2042,436,23.2,1702.8,blue,1,3.67,18,17,red
4448275896,6,1,7,1,1,0,0,16894,7.2,19048,234,47,2647,1140,23.4,1689.4,1,6,1,0,0,0,0,14247,6.8,17908,217,64,-2647,-1140,21.7,1424.7,blue,13,0.33,22,16,blue
4502673310,3,7,3,0,0,0,0,14525,6.6,16786,201,56,-5011,-2444,20.1,1452.5,7,3,5,0,0,0,1,19536,7.2,19230,244,52,5011,2444,24.4,1953.6,red,0.86,4,30,23,red
4527171182,8,1,6,1,0,1,2,18618,7.2,19304,223,39,4343,2636,22.3,1861.8,1,8,1,0,0,0,0,14275,6.8,16668,190,75,-4343,-2636,19,1427.5,blue,14,0.25,17,33,blue
4458318348,3,6,3,0,0,0,0,15345,6.6,17067,226,44,-192,-287,22.6,1534.5,6,3,8,2,1,1,0,15537,6.8,17354,191,39,192,287,19.1,1553.7,red,1,4.67,39,62,red
4519130933,9,5,10,1,1,0,0,17967,7,18521,209,52,3066,2798,20.9,1796.7,5,9,4,0,0,0,0,14901,6.4,15723,177,31,-3066,-2798,17.7,1490.1,blue,3.8,1,21,19,red
4499791451,13,3,15,0,0,0,0,19484,7.2,19688,235,50,4694,2781,23.5,1948.4,3,13,3,2,1,1,0,14790,6.6,16907,196,59,-4694,-2781,19.6,1479,blue,9.33,0.46,25,15,blue
4505792941,3,6,3,0,0,0,0,14508,6.8,17217,200,48,-3968,-2461,20,1450.8,6,3,7,2,1,1,1,18476,7.2,19678,243,76,3968,2461,24.3,1847.6,red,1,4.33,15,16,red
4298181346,8,6,8,1,1,0,0,17505,7.2,19310,223,59,786,1888,22.3,1750.5,6,8,7,0,0,0,0,16719,6.6,17422,220,44,-786,-1888,22,1671.9,blue,2.67,1.62,25,19,blue
4479829925,7,2,9,0,0,0,0,17428,7.4,18741,219,56,2444,561,21.9,1742.8,2,7,1,1,1,0,0,14984,6.8,18180,242,52,-2444,-561,24.2,1498.4,blue,8,0.43,20,18,blue
4522252175,8,9,7,0,0,0,0,17336,7.2,19025,218,60,691,696,21.8,1733.6,9,8,7,0,0,0,0,16645,7,18329,192,40,-691,-696,19.2,1664.5,blue,1.67,2,22,24,blue
4525826341,4,9,3,1,1,0,0,15386,7,17872,209,40,-2820,-1143,20.9,1538.6,9,4,11,0,0,0,0,18206,7.4,19015,229,40,2820,1143,22.9,1820.6,blue,0.78,5,12,137,red
4456611080,4,5,6,1,1,0,0,16353,6.8,18091,240,68,246,217,24,1635.3,5,4,7,0,0,0,0,16107,6.8,17874,227,43,-246,-217,22.7,1610.7,blue,2,3,18,20,red
4498002913,7,8,7,0,0,0,0,16697,7,18511,211,43,-864,-865,21.1,1669.7,8,7,8,0,0,0,0,17561,7.2,19376,226,52,864,865,22.6,1756.1,blue,1.75,2.29,12,16,red
4479460532,3,4,3,1,1,0,0,14850,6.8,17967,226,57,-858,847,22.6,1485,4,3,5,0,0,0,0,15708,6.8,17120,239,44,858,-847,23.9,1570.8,blue,1.5,3,24,24,red
4524440792,3,6,4,0,0,0,0,14879,6.6,16931,217,35,-1775,-722,21.7,1487.9,6,3,4,0,0,0,0,16654,6.8,17653,215,56,1775,722,21.5,1665.4,red,1.17,3.33,19,38,red
4513777315,10,7,11,1,1,0,0,18454,7.2,19370,230,53,1455,602,23,1845.4,7,10,5,0,0,0,0,16999,7,18768,247,48,-1455,-602,24.7,1699.9,red,3,1.2,20,23,blue
4525367812,1,4,0,0,0,0,0,14334,7,18293,242,52,-1878,-178,24.2,1433.4,4,1,6,1,1,0,0,16212,7,18471,262,56,1878,178,26.2,1621.2,blue,0.25,10,22,24,red
4447554215,4,3,4,1,1,0,1,17490,7,18903,233,56,2755,1492,23.3,1749,3,4,3,1,0,1,0,14735,7,17411,197,52,-2755,-1492,19.7,1473.5,blue,2.67,1.5,22,41,red
4495129038,13,7,14,1,1,0,0,19526,7.4,19551,225,53,3003,3063,22.5,1952.6,7,13,9,0,0,0,0,16523,6.6,16488,200,57,-3003,-3063,20,1652.3,blue,3.86,1.23,33,14,blue
4479804307,10,6,12,1,1,0,0,18439,7.2,18689,223,39,1894,99,22.3,1843.9,6,10,5,0,0,0,0,16545,7,18590,203,48,-1894,-99,20.3,1654.5,blue,3.67,1.1,18,16,blue
4527378192,9,8,9,1,1,0,0,17375,7.2,18906,210,46,-522,269,21,1737.5,8,9,7,1,0,1,1,17897,7,18637,190,46,522,-269,19,1789.7,red,2.25,1.67,49,16,blue
4437747585,8,5,9,1,1,0,0,17367,7,19496,215,67,1992,2096,21.5,1736.7,5,8,4,0,0,0,0,15375,6.6,17400,211,44,-1992,-2096,21.1,1537.5,blue,3.4,1.12,16,15,red
4527394584,7,7,5,0,0,0,0,16354,6.8,18198,213,41,-1256,-559,21.3,1635.4,7,7,5,2,1,1,0,17610,7,18757,226,62,1256,559,22.6,1761,blue,1.71,1.71,17,19,red
4515270451,5,7,5,0,0,0,0,15708,6.8,17420,220,41,-1127,-2006,22,1570.8,7,5,4,0,0,0,0,16835,7,19426,226,52,1127,2006,22.6,1683.5,red,1.43,2.2,40,15,red
4462117148,3,6,5,2,1,1,0,15427,6.8,16873,209,48,-1186,-1760,20.9,1542.7,6,3,2,0,0,0,0,16613,7.2,18633,230,54,1186,1760,23,1661.3,red,1.33,2.67,43,24,blue
4492809818,9,6,10,2,1,1,0,16851,6.6,17153,190,41,-1328,-1142,19,1685.1,6,9,6,0,0,0,1,18179,7,18295,227,41,1328,1142,22.7,1817.9,red,3.17,1.33,18,41,blue
4526244595,6,7,6,0,0,0,0,15786,6.8,16824,193,34,-1818,-2061,19.3,1578.6,7,6,4,1,1,0,0,17604,7.2,18885,246,61,1818,2061,24.6,1760.4,red,1.71,1.83,21,21,blue
4497981317,8,9,5,0,0,0,0,16319,6.8,17715,217,32,-1228,11,21.7,1631.9,9,8,9,0,0,0,0,17547,6.8,17704,191,47,1228,-11,19.1,1754.7,red,1.44,2.25,15,12,blue
4525829956,2,7,1,1,1,0,0,14324,6.6,16757,211,49,-2638,-1671,21.1,1432.4,7,2,6,0,0,0,0,16962,6.8,18428,244,42,2638,1671,24.4,1696.2,red,0.43,6.5,19,17,blue
4510205356,7,6,7,0,0,0,0,16064,7,17943,181,48,41,178,18.1,1606.4,6,7,5,2,1,1,0,16023,6.8,17765,206,52,-41,-178,20.6,1602.3,blue,2.33,1.57,14,13,red
4523048704,10,6,10,1,1,0,0,18013,7.2,18223,228,51,1446,-143,22.8,1801.3,6,10,5,0,0,0,0,16567,7,18366,216,63,-1446,143,21.6,1656.7,blue,3.33,1.1,23,23,blue
4475427845,4,9,4,0,0,0,0,15890,7,17797,229,49,-2782,-1742,22.9,1589,9,4,10,1,1,0,0,18672,7,19539,235,62,2782,1742,23.5,1867.2,red,0.89,4.75,16,16,red
4505173550,4,6,3,0,0,0,0,15492,6.6,17869,218,44,-310,-392,21.8,1549.2,6,4,7,1,1,0,0,15802,7.2,18261,192,67,310,392,19.2,1580.2,red,1.17,3.25,60,21,red
4504897086,4,5,3,0,0,0,0,16281,7.2,18349,219,64,699,-254,21.9,1628.1,5,4,7,1,1,0,0,15582,7.2,18603,200,66,-699,254,20,1558.2,red,1.4,3,20,18,blue
4525369835,2,7,4,1,1,0,0,15032,7,18462,232,68,-2785,-453,23.2,1503.2,7,2,7,1,0,1,0,17817,7.2,18915,228,55,2785,453,22.8,1781.7,red,0.86,7,43,25,red
4449347058,6,9,7,0,0,0,0,16777,7.2,19056,219,48,-1681,41,21.9,1677.7,9,6,9,0,0,0,0,18458,7.4,19015,241,41,1681,-41,24.1,1845.8,red,1.44,3,39,23,red
4521292011,6,4,8,0,0,0,0,15708,6.8,16783,197,36,-189,-211,19.7,1570.8,4,6,3,1,0,1,0,15897,6.8,16994,244,28,189,211,24.4,1589.7,red,3.5,1.17,51,14,blue
4483094981,6,4,8,1,1,0,0,17505,7.2,18661,240,66,791,1138,24,1750.5,4,6,5,0,0,0,0,16714,6.6,17523,234,49,-791,-1138,23.4,1671.4,blue,3.5,1.5,19,18,red
4472023153,6,7,5,1,1,0,0,15889,6.8,16752,220,33,-1248,503,22,1588.9,7,6,12,0,0,0,1,17137,6.4,16249,191,34,1248,-503,19.1,1713.7,red,1.57,3.17,18,20,red
4296354535,12,3,14,1,1,0,0,19031,7.4,18999,234,40,4188,2399,23.4,1903.1,3,12,2,1,0,1,0,14843,6.6,16600,207,52,-4188,-2399,20.7,1484.3,red,8.67,0.42,21,20,blue
4526340314,10,4,4,0,0,0,0,18581,7.6,19769,249,55,3301,3347,24.9,1858.1,4,10,4,1,1,0,0,15280,6.6,16422,213,40,-3301,-3347,21.3,1528,blue,3.5,0.8,21,20,red
4524902053,2,6,4,0,0,0,0,14796,6.4,16514,225,50,-2944,-2835,22.5,1479.6,6,2,7,1,1,0,0,17740,7.2,19349,231,49,2944,2835,23.1,1774,red,1,6.5,14,16,blue
4476300428,8,3,8,1,1,0,0,17429,7.4,19044,239,48,2800,2474,23.9,1742.9,3,8,1,0,0,0,0,14629,6.6,16570,197,66,-2800,-2474,19.7,1462.9,red,5.33,0.5,23,20,red
4477500359,9,7,7,1,1,0,0,17686,7,19734,236,48,1178,2223,23.6,1768.6,7,9,5,1,0,1,0,16508,6.8,17511,187,44,-1178,-2223,18.7,1650.8,red,2.29,1.33,26,46,red
4523981551,6,9,5,0,0,0,0,16158,7.2,18018,213,48,-900,267,21.3,1615.8,9,6,12,2,1,1,0,17058,6.8,17751,177,48,900,-267,17.7,1705.8,red,1.22,3.5,19,21,red
4525388286,4,10,2,0,0,0,0,14471,6.6,16470,169,48,-4204,-2138,16.9,1447.1,10,4,11,2,1,1,0,18675,7.2,18608,227,33,4204,2138,22.7,1867.5,red,0.6,5.25,19,19,red
4450596988,9,6,10,1,1,0,0,17419,7,18137,209,45,2196,1245,20.9,1741.9,6,9,5,0,0,0,0,15223,6.6,16892,192,34,-2196,-1245,19.2,1522.3,blue,3.17,1.22,159,17,blue
4470122147,10,6,17,1,0,1,0,17859,7,17682,221,32,1711,264,22.1,1785.9,6,10,6,0,0,0,0,16148,6.8,17418,209,44,-1711,-264,20.9,1614.8,blue,4.5,1.2,22,33,red
4526833069,3,7,3,0,0,0,0,14546,6.6,16662,200,32,-2560,-1275,20,1454.6,7,3,6,1,1,0,0,17106,7,17937,203,67,2560,1275,20.3,1710.6,blue,0.86,4.33,19,46,red
4478251083,11,11,8,1,1,0,0,17373,6.6,16452,178,41,-1768,-2230,17.8,1737.3,11,11,8,0,0,0,0,19141,7.2,18682,198,41,1768,2230,19.8,1914.1,red,1.73,1.73,19,14,red
4467133575,8,4,9,0,0,0,0,17239,7.2,18395,209,46,1436,1824,20.9,1723.9,4,8,2,0,0,0,0,15803,6.6,16571,225,53,-1436,-1824,22.5,1580.3,blue,4.25,0.75,21,49,red
4512340309,10,9,14,0,0,0,0,18178,7,17725,213,34,342,-646,21.3,1817.8,9,10,8,1,1,0,0,17836,7,18371,222,54,-342,646,22.2,1783.6,red,2.67,1.7,14,16,blue
4467826784,9,10,8,1,1,0,0,16690,6.6,17356,215,44,170,1174,21.5,1669,10,9,8,0,0,0,0,16520,6.4,16182,189,36,-170,-1174,18.9,1652,red,1.7,2,17,12,red
4503692429,1,9,1,0,0,0,0,13508,6.6,15474,186,50,-5373,-4474,18.6,1350.8,9,1,11,2,1,1,0,18881,7.2,19948,241,49,5373,4474,24.1,1888.1,red,0.22,20,15,19,red
4460998770,7,7,7,0,0,0,0,17122,7,19090,236,44,360,1102,23.6,1712.2,7,7,7,1,1,0,0,16762,7,17988,187,55,-360,-1102,18.7,1676.2,red,2,2,21,40,red
4464256009,5,6,11,0,0,0,0,16429,6.6,17419,226,51,-448,-1140,22.6,1642.9,6,5,7,1,1,0,0,16877,7.2,18559,233,56,448,1140,23.3,1687.7,red,2.67,2.6,15,15,blue
4453137700,8,17,7,0,0,0,0,17556,6.6,17097,192,44,-2089,-835,19.2,1755.6,17,8,16,0,0,0,0,19645,6.8,17932,186,36,2089,835,18.6,1964.5,blue,0.88,4.12,17,19,red
4497572230,3,10,3,0,0,0,0,14635,6.6,16718,202,41,-3709,-1017,20.2,1463.5,10,3,10,1,1,0,0,18344,6.8,17735,231,39,3709,1017,23.1,1834.4,red,0.6,6.67,22,19,red
4526360313,10,4,6,0,0,0,0,17890,7.2,18682,226,45,2961,2627,22.6,1789,4,10,6,0,0,0,0,14929,6.6,16055,207,26,-2961,-2627,20.7,1492.9,blue,4,1,16,35,blue
4499276253,1,2,2,0,0,0,0,12884,6.4,15586,174,40,-2825,-3105,17.4,1288.4,2,1,4,1,1,0,0,15709,7,18691,239,63,2825,3105,23.9,1570.9,red,1.5,6,15,18,red
4426118717,8,3,14,1,1,0,0,17160,7,17725,191,66,2841,1484,19.1,1716,3,8,1,0,0,0,0,14319,6.6,16241,208,57,-2841,-1484,20.8,1431.9,red,7.33,0.5,23,21,blue
4468685425,3,8,3,0,0,0,0,14416,6.8,16951,185,38,-3253,-3049,18.5,1441.6,8,3,9,1,1,0,0,17669,7.6,20000,229,60,3253,3049,22.9,1766.9,red,0.75,5.67,41,30,red
4516284402,10,6,8,0,0,0,0,18165,7,18510,219,57,2746,999,21.9,1816.5,6,10,3,0,0,0,0,15419,6.8,17511,206,49,-2746,-999,20.6,1541.9,blue,3,0.9,37,33,red
4435041315,3,8,3,0,0,0,0,14438,6.6,17107,199,39,-2502,-1811,19.9,1443.8,8,3,6,1,1,0,0,16940,7,18918,232,50,2502,1811,23.2,1694,red,0.75,4.67,55,22,red
4514563057,7,9,6,0,0,0,0,16784,7.4,19211,196,64,-1270,1023,19.6,1678.4,9,7,10,0,0,0,0,18054,7.2,18188,210,47,1270,-1023,21,1805.4,red,1.44,2.71,17,18,red
4503236758,6,6,5,0,0,0,0,15384,6.6,17040,189,44,-1495,-801,18.9,1538.4,6,6,7,2,1,1,0,16879,6.8,17841,211,73,1495,801,21.1,1687.9,red,1.83,2.17,20,21,red
4470756095,2,9,1,0,0,0,0,14980,6.4,16246,232,51,-2432,-1788,23.2,1498,9,2,17,1,1,0,0,17412,7,18034,219,59,2432,1788,21.9,1741.2,red,0.33,13,16,19,blue
4487454478,10,4,11,0,0,0,0,18314,7,17903,219,31,3884,2224,21.9,1831.4,4,10,6,1,1,0,0,14430,6.6,15679,167,48,-3884,-2224,16.7,1443,blue,5.25,1,16,11,blue
4519643155,7,11,6,0,0,0,0,16548,6.8,17735,224,51,-2133,-256,22.4,1654.8,11,7,19,1,1,0,0,18681,7,17991,215,63,2133,256,21.5,1868.1,red,1.18,4.29,15,17,red
4504653278,9,1,12,1,1,0,0,18329,7.6,20471,225,63,4973,3174,22.5,1832.9,1,9,0,0,0,0,0,13356,6.8,17297,199,36,-4973,-3174,19.9,1335.6,blue,21,0.11,30,40,blue
4524352640,7,6,8,0,0,0,0,16877,6.8,17631,216,37,338,-272,21.6,1687.7,6,7,9,1,1,0,0,16539,7,17903,230,38,-338,272,23,1653.9,blue,2.5,2.14,19,33,blue
4521713895,4,9,5,0,0,0,0,14899,6.8,17420,232,32,-3099,-1695,23.2,1489.9,9,4,10,1,1,0,0,17998,7.2,19115,227,56,3099,1695,22.7,1799.8,red,1,4.75,14,22,red
4527179448,3,5,2,1,1,0,0,15630,7.2,18026,236,57,-1655,-881,23.6,1563,5,3,6,0,0,0,0,17285,7,18907,257,56,1655,881,25.7,1728.5,red,1,3.67,58,18,red
4475233251,9,8,8,1,0,1,0,18321,6.8,18428,230,46,2788,558,23,1832.1,8,9,5,0,0,0,0,15533,6.6,17870,183,47,-2788,-558,18.3,1553.3,blue,2.12,1.44,29,18,blue
4475613752,10,9,7,2,1,1,0,17793,7.2,19322,215,59,508,1164,21.5,1779.3,9,10,10,0,0,0,0,17285,7,18158,193,56,-508,-1164,19.3,1728.5,blue,1.89,1.9,18,16,red
4507561885,1,5,2,0,0,0,0,14297,6.6,16721,235,54,-2955,-3054,23.5,1429.7,5,1,4,1,1,0,0,17252,7.2,19775,257,68,2955,3054,25.7,1725.2,red,0.6,9,22,61,red
4503433606,4,11,2,0,0,0,0,15602,6.6,17116,216,38,-2082,-527,21.6,1560.2,11,4,13,1,1,0,0,17684,6.8,17643,199,44,2082,527,19.9,1768.4,blue,0.55,6,12,47,red
4407710029,8,4,10,1,0,1,0,17938,7,18626,239,51,3117,1580,23.9,1793.8,4,8,1,1,1,0,0,14821,6.8,17046,196,44,-3117,-1580,19.6,1482.1,red,4.5,0.62,13,13,blue
4521806939,10,5,11,1,1,0,0,17556,6.8,17943,206,40,2153,799,20.6,1755.6,5,10,7,0,0,0,0,15403,6.8,17144,202,51,-2153,-799,20.2,1540.3,blue,4.2,1.2,20,18,blue
4525357856,4,5,4,0,0,0,0,15232,7,17793,209,51,-625,-945,20.9,1523.2,5,4,6,0,0,0,0,15857,7.2,18738,215,50,625,945,21.5,1585.7,blue,1.6,2.75,55,12,blue
4492780458,4,8,5,1,0,1,0,15768,6.8,17528,233,48,-1657,-1200,23.3,1576.8,8,4,7,0,0,0,0,17425,7,18728,253,44,1657,1200,25.3,1742.5,red,1.12,3.75,22,18,red
4503163360,3,4,6,0,0,0,0,14663,6.4,16086,206,38,-893,-670,20.6,1466.3,4,3,4,0,0,0,0,15556,6.8,16756,212,56,893,670,21.2,1555.6,red,2.25,2.67,16,20,red
4465992813,7,4,9,0,0,0,0,17180,7,17511,219,46,1618,934,21.9,1718,4,7,5,1,1,0,0,15562,6.8,16577,195,60,-1618,-934,19.5,1556.2,blue,4,1.29,18,19,blue
4521413190,7,3,4,1,1,0,0,16616,7.2,19895,246,43,958,2603,24.6,1661.6,3,7,5,0,0,0,0,15658,6.8,17292,229,48,-958,-2603,22.9,1565.8,blue,3.67,1.14,20,20,red
4500655120,2,6,1,1,1,0,0,14555,6.6,16722,232,44,-2459,-2110,23.2,1455.5,6,2,10,0,0,0,0,17014,7.2,18832,243,60,2459,2110,24.3,1701.4,red,0.5,8,18,67,red
4478851692,4,7,5,0,0,0,0,15614,7,17578,241,53,-816,172,24.1,1561.4,7,4,9,1,1,0,0,16430,6.8,17406,234,38,816,-172,23.4,1643,red,1.29,4,16,35,red
4523021460,3,1,3,0,0,0,0,16956,7,18863,270,55,3560,2311,27,1695.6,1,3,0,0,0,0,0,13396,6.6,16552,198,51,-3560,-2311,19.8,1339.6,blue,6,0.33,18,47,blue
4500982447,7,2,8,0,0,0,0,17102,7.2,19068,219,56,2763,2232,21.9,1710.2,2,7,1,0,0,0,0,14339,6.8,16836,229,42,-2763,-2232,22.9,1433.9,blue,7.5,0.43,16,17,red
4498506216,4,10,4,0,0,0,0,14869,6.6,16447,188,52,-4659,-3884,18.8,1486.9,10,4,14,2,1,1,0,19528,7.4,20331,255,64,4659,3884,25.5,1952.8,red,0.8,6,16,20,blue
4490200078,3,5,3,1,1,0,0,15295,6.8,17054,210,48,98,976,21,1529.5,5,3,6,0,0,0,0,15197,6.4,16078,213,42,-98,-976,21.3,1519.7,blue,1.2,3.67,21,18,blue
4493674293,5,3,2,0,0,0,0,16506,6.8,17581,233,56,1922,1355,23.3,1650.6,3,5,4,0,0,0,0,14584,6.2,16226,218,20,-1922,-1355,21.8,1458.4,blue,2.33,1.4,16,13,blue
4462178191,7,0,9,1,1,0,1,18745,7,18917,259,48,4783,2851,25.9,1874.5,0,7,0,1,0,1,0,13962,6.4,16066,217,64,-4783,-2851,21.7,1396.2,blue,12.03,0,21,13,blue
4468469648,14,7,13,1,0,1,0,18802,6.8,18463,213,35,2393,675,21.3,1880.2,7,14,6,1,1,0,0,16409,6.8,17788,206,59,-2393,-675,20.6,1640.9,blue,3.86,0.93,19,12,blue
4493434645,9,8,11,1,0,1,0,18677,7,18208,220,44,1334,-236,22,1867.7,8,9,10,1,1,0,0,17343,6.8,18444,206,60,-1334,236,20.6,1734.3,blue,2.5,2,16,109,blue
4444878201,14,9,18,1,1,0,0,20909,7.4,19188,210,52,3193,1212,21,2090.9,9,14,9,0,0,0,0,17716,7,17976,183,53,-3193,-1212,18.3,1771.6,blue,3.56,1.29,26,17,blue
4519322442,8,7,8,0,0,0,0,17012,6.8,17394,204,55,-992,-490,20.4,1701.2,7,8,8,1,1,0,0,18004,6.8,17884,240,46,992,490,24,1800.4,blue,2.29,1.88,21,19,blue
4525559533,7,4,7,0,0,0,0,16559,7,18604,205,45,715,545,20.5,1655.9,4,7,4,1,1,0,0,15844,6.8,18059,235,54,-715,-545,23.5,1584.4,red,3.5,1.14,34,18,red
4491903600,12,10,13,0,0,0,0,19884,7.4,19673,226,63,1136,2782,22.6,1988.4,10,12,12,0,0,0,0,18748,6.8,16891,211,39,-1136,-2782,21.1,1874.8,blue,2.5,1.83,19,17,blue
4460913296,5,8,8,0,0,0,0,14642,6.4,15759,189,35,-3133,-3803,18.9,1464.2,8,5,8,0,0,0,0,17775,7.4,19562,213,59,3133,3803,21.3,1777.5,red,1.62,3.2,18,18,red
4526672320,2,4,3,1,1,0,0,14120,6.4,16943,217,51,-1443,-36,21.7,1412,4,2,5,1,0,1,0,15563,6.8,16979,214,51,1443,36,21.4,1556.3,red,1.25,4.5,14,14,red
4492655929,6,14,4,0,0,0,0,15484,7,17528,188,46,-5634,-3787,18.8,1548.4,14,6,9,1,1,0,0,21118,7.8,21315,243,52,5634,3787,24.3,2111.8,red,0.71,3.83,15,20,red
4526528415,3,1,3,0,0,0,0,15392,7,17891,232,51,1232,114,23.2,1539.2,1,3,2,1,1,0,0,14160,6.8,17777,223,52,-1232,-114,22.3,1416,red,6,1,21,26,blue
4524012656,5,8,4,0,0,0,0,16568,7,18504,239,51,-1163,-1130,23.9,1656.8,8,5,11,1,1,0,0,17731,7.4,19634,223,72,1163,1130,22.3,1773.1,red,1.12,3.8,19,35,blue
4502665532,9,11,12,0,0,0,0,17140,6.6,16531,167,30,-791,-961,16.7,1714,11,9,11,0,0,0,0,17931,7,17492,214,40,791,961,21.4,1793.1,blue,1.91,2.44,16,18,blue
4525815564,7,9,8,1,1,0,0,16695,7.2,19057,189,66,-771,483,18.9,1669.5,9,7,6,0,0,0,0,17466,7,18574,244,40,771,-483,24.4,1746.6,red,1.67,2.14,17,19,red
4525793792,12,10,13,0,0,0,0,17513,6.8,17486,193,48,-773,-734,19.3,1751.3,10,12,11,1,1,0,0,18286,6.8,18220,208,54,773,734,20.8,1828.6,red,2.5,1.75,26,19,red
4471530570,8,9,7,2,1,1,0,17299,7,18331,218,48,-1143,-1447,21.8,1729.9,9,8,6,0,0,0,0,18442,7.2,19778,233,60,1143,1447,23.3,1844.2,red,1.67,1.88,23,23,red
4494647100,4,5,3,0,0,0,0,16581,7,19116,254,51,1103,1356,25.4,1658.1,5,4,3,0,0,0,0,15478,6.8,17760,205,52,-1103,-1356,20.5,1547.8,blue,1.4,2,20,24,red
4470217349,4,3,4,0,0,0,0,17137,7.4,19582,261,64,1482,41,26.1,1713.7,3,4,2,2,1,1,0,15655,7.4,19541,230,72,-1482,-41,23,1565.5,blue,2.67,1.25,16,15,blue
4489431595,6,5,6,0,0,0,0,16262,7.2,18196,207,68,591,192,20.7,1626.2,5,6,5,1,1,0,0,15671,7,18004,217,55,-591,-192,21.7,1567.1,red,2.4,1.67,18,19,red
4519917547,4,14,2,0,0,0,0,15719,6.8,17678,211,62,-3558,-2346,21.1,1571.9,14,4,9,2,1,1,0,19277,7.4,20024,212,60,3558,2346,21.2,1927.7,red,0.43,5.75,38,12,red
4525569864,5,3,5,1,0,1,0,15824,7.2,19141,221,52,225,1404,22.1,1582.4,3,5,6,1,1,0,0,15599,6.8,17737,248,60,-225,-1404,24.8,1559.9,red,3.33,1.8,42,131,red
4470512125,8,2,5,1,0,1,0,17235,7.4,19304,227,53,3613,3509,22.7,1723.5,2,8,1,0,0,0,0,13622,6.4,15795,182,50,-3613,-3509,18.2,1362.2,blue,6.5,0.38,21,108,red
4526866944,7,4,12,1,1,0,0,17199,7,19299,229,59,1545,1417,22.9,1719.9,4,7,5,0,0,0,0,15654,7.2,17882,226,53,-1545,-1417,22.6,1565.4,red,4.75,1.29,20,18,blue
4474919614,3,3,4,0,0,0,0,15716,7,17405,241,56,-411,-2213,24.1,1571.6,3,3,1,1,1,0,0,16127,7.2,19618,246,72,411,2213,24.6,1612.7,red,2.33,1.33,14,17,blue
4493057531,9,6,9,1,1,0,0,17835,7.4,19830,246,39,2177,1584,24.6,1783.5,6,9,4,0,0,0,0,15658,6.8,18246,213,46,-2177,-1584,21.3,1565.8,blue,3,1.11,19,17,red
4465308301,1,12,0,0,0,0,0,10730,4.8,10826,140,0,-10830,-9333,14,1073,12,1,14,0,0,0,2,21560,7.4,20159,241,72,10830,9333,24.1,2156,red,0.08,26,14,25,red
4498697994,10,6,13,1,1,0,0,18436,6.8,18190,250,51,2312,1079,25,1843.6,6,10,8,0,0,0,0,16124,6.8,17111,181,48,-2312,-1079,18.1,1612.4,blue,3.83,1.4,17,17,blue
4511547876,3,4,4,1,1,0,0,14017,6.2,15335,185,48,-2309,-2673,18.5,1401.7,4,3,5,0,0,0,0,16326,7.2,18008,214,63,2309,2673,21.4,1632.6,red,1.75,3,22,36,red
4492897739,7,9,9,0,0,0,0,15888,6.6,15944,195,36,-1696,-2535,19.5,1588.8,9,7,7,0,0,0,0,17584,7.2,18479,186,52,1696,2535,18.6,1758.4,red,1.78,2.29,15,14,blue
4494255603,8,8,11,1,0,1,0,17185,6.8,16790,193,35,-246,-870,19.3,1718.5,8,8,8,0,0,0,0,17431,6.8,17660,208,75,246,870,20.8,1743.1,blue,2.38,2,14,15,blue
4525542584,5,3,2,1,0,1,0,15358,6.6,17220,223,40,543,-624,22.3,1535.8,3,5,3,1,1,0,0,14815,7,17844,199,67,-543,624,19.9,1481.5,red,2.33,1.2,15,13,blue
4410382729,6,5,9,0,0,0,0,15448,6.8,16856,180,47,58,203,18,1544.8,5,6,6,1,1,0,0,15390,6.6,16653,201,48,-58,-203,20.1,1539,blue,3,1.83,16,43,blue
4491563778,9,3,9,1,1,0,0,17913,7,19123,249,56,2185,1440,24.9,1791.3,3,9,5,0,0,0,0,15728,6.6,17683,231,48,-2185,-1440,23.1,1572.8,blue,6,0.89,87,38,blue
4500814768,6,4,9,1,1,0,0,16231,6.8,17392,222,50,124,-2259,22.2,1623.1,4,6,2,0,0,0,0,16107,7.4,19651,239,68,-124,2259,23.9,1610.7,blue,3.75,1,24,16,blue
4523437781,3,10,4,1,1,0,0,14878,6.4,16786,213,47,-4657,-4000,21.3,1487.8,10,3,11,0,0,0,1,19535,7.6,20786,244,56,4657,4000,24.4,1953.5,red,0.7,7,20,43,red
4470469734,3,3,1,1,0,1,0,15229,7,18526,242,44,511,-29,24.2,1522.9,3,3,0,1,1,0,0,14718,7,18555,209,74,-511,29,20.9,1471.8,red,1.33,1,22,22,red
4514495731,12,5,19,0,0,0,0,19933,7.2,19756,248,36,4171,3497,24.8,1993.3,5,12,7,1,1,0,0,15762,6.4,16259,202,56,-4171,-3497,20.2,1576.2,blue,6.2,1,13,15,red
4514470040,3,10,1,0,0,0,0,14637,6.6,17059,210,55,-3368,-2587,21,1463.7,10,3,10,1,1,0,0,18005,7.4,19646,236,41,3368,2587,23.6,1800.5,red,0.4,6.67,12,37,red
4469375094,5,10,3,0,0,0,0,16637,6.8,17846,219,40,-2368,618,21.9,1663.7,10,5,14,1,1,0,1,19005,7,17228,224,48,2368,-618,22.4,1900.5,blue,0.8,4.8,85,62,red
4514409289,8,7,7,1,1,0,0,16840,7.2,19004,193,51,-144,-157,19.3,1684,7,8,7,0,0,0,0,16984,7.2,19161,218,56,144,157,21.8,1698.4,blue,2.14,1.75,20,45,blue
4447281221,4,6,1,1,1,0,0,14358,6.8,18106,190,70,-2128,264,19,1435.8,6,4,5,0,0,0,0,16486,7,17842,227,50,2128,-264,22.7,1648.6,red,0.83,2.75,28,20,red
4477182015,4,10,5,1,1,0,0,15403,6.6,17392,242,48,-2613,-1974,24.2,1540.3,10,4,15,1,0,1,0,18016,7,19366,230,48,2613,1974,23,1801.6,red,0.9,6.25,18,43,blue
4518248873,6,9,8,0,0,0,0,16328,6.8,17459,221,40,-1325,-959,22.1,1632.8,9,6,8,1,1,0,0,17653,7.2,18418,234,60,1325,959,23.4,1765.3,red,1.56,2.83,13,15,red
4526407759,8,6,6,1,1,0,0,16166,6.8,17100,188,49,-209,-353,18.8,1616.6,6,8,9,0,0,0,0,16375,7,17453,215,59,209,353,21.5,1637.5,blue,2.33,1.88,22,19,blue
4505359839,1,9,0,0,0,0,0,13458,6.6,16195,221,36,-4232,-2456,22.1,1345.8,9,1,8,0,0,0,0,17690,7.2,18651,225,35,4232,2456,22.5,1769,red,0.11,17,20,27,red
4463038794,4,6,4,1,1,0,0,15613,7,17643,229,56,-716,637,22.9,1561.3,6,4,3,0,0,0,0,16329,6.8,17006,213,45,716,-637,21.3,1632.9,blue,1.33,2.25,17,18,red
4526586173,6,4,5,0,0,0,0,16819,7,18039,244,54,1621,128,24.4,1681.9,4,6,2,1,1,0,0,15198,6.8,17911,219,55,-1621,-128,21.9,1519.8,red,2.75,1,18,20,red
4508656599,3,5,4,0,0,0,0,14815,6.4,16969,221,42,-2541,-1921,22.1,1481.5,5,3,3,2,1,1,1,17356,7,18890,237,61,2541,1921,23.7,1735.6,red,1.4,2.67,14,10,red
4492694457,6,10,7,0,0,0,0,16186,6.6,17103,207,35,-2072,-1355,20.7,1618.6,10,6,10,2,1,1,0,18258,7,18458,211,51,2072,1355,21.1,1825.8,red,1.3,3.33,13,16,red
4510961298,4,4,7,0,0,0,0,16538,6.8,18285,253,64,239,-305,25.3,1653.8,4,4,6,2,1,1,0,16299,7.2,18590,243,59,-239,305,24.3,1629.9,red,2.75,2.5,17,53,red
4516489308,4,8,6,0,0,0,0,14291,6.8,16706,178,44,-3378,-2082,17.8,1429.1,8,4,10,1,1,0,0,17669,7.2,18788,233,45,3378,2082,23.3,1766.9,red,1.25,4.5,16,15,red
4518248972,4,6,7,0,0,0,0,15399,7,17209,217,47,-1589,-575,21.7,1539.9,6,4,11,1,1,0,0,16988,7,17784,210,48,1589,575,21,1698.8,red,1.83,4.25,19,21,blue
4451628627,2,10,1,1,0,1,0,13726,6.2,16098,184,52,-4474,-5216,18.4,1372.6,10,2,8,1,1,0,0,18200,7.6,21314,236,68,4474,5216,23.6,1820,red,0.3,9,16,19,red
4503336333,9,10,9,0,0,0,0,17776,6.8,17464,211,33,90,-540,21.1,1777.6,10,9,10,0,0,0,0,17686,6.8,18004,203,44,-90,540,20.3,1768.6,blue,1.8,2.22,18,17,red
4455725708,12,10,10,1,1,0,0,18913,7.2,19076,183,55,1051,12,18.3,1891.3,10,12,7,0,0,0,0,17862,7.2,19064,209,40,-1051,-12,20.9,1786.2,blue,2.2,1.42,15,13,blue
4505863838,11,3,12,1,1,0,0,17317,7,18842,226,40,2022,970,22.6,1731.7,3,11,2,0,0,0,0,15295,6.8,17872,242,50,-2022,-970,24.2,1529.5,blue,7.67,0.45,18,124,blue
4513917134,8,6,7,0,0,0,0,17809,7,18479,238,48,2278,2211,23.8,1780.9,6,8,8,0,0,0,0,15531,6.4,16268,189,44,-2278,-2211,18.9,1553.1,red,2.5,1.75,83,18,blue
4526740074,7,1,6,1,1,0,0,16474,7,18843,225,52,2402,2440,22.5,1647.4,1,7,1,0,0,0,0,14072,6.4,16403,206,54,-2402,-2440,20.6,1407.2,blue,13,0.29,16,10,blue
4477391796,10,11,7,0,0,0,0,16915,7,19035,214,38,-1716,-1094,21.4,1691.5,11,10,11,2,1,1,0,18631,7.6,20129,238,60,1716,1094,23.8,1863.1,blue,1.55,2.2,17,12,red
4526496557,3,3,2,1,1,0,0,14964,7,17928,235,52,-973,-1732,23.5,1496.4,3,3,1,0,0,0,0,15937,7.2,19660,251,76,973,1732,25.1,1593.7,red,1.67,1.33,34,51,red
4472715891,13,7,11,0,0,0,0,19253,7.2,19378,212,48,3044,1261,21.2,1925.3,7,13,5,1,1,0,0,16209,7.2,18117,212,55,-3044,-1261,21.2,1620.9,blue,3.43,0.92,15,11,red
4477556217,2,9,3,0,0,0,0,14797,6.8,16690,213,52,-4265,-3190,21.3,1479.7,9,2,7,2,1,1,1,19062,7.2,19880,244,60,4265,3190,24.4,1906.2,red,0.56,8,18,16,red
4479699152,9,8,8,0,0,0,0,17642,7.2,18820,227,53,1794,2548,22.7,1764.2,8,9,3,0,0,0,0,15848,6.4,16272,179,48,-1794,-2548,17.9,1584.8,blue,2.12,1.22,16,18,red
4523806896,3,8,4,0,0,0,0,14462,6.4,16255,210,43,-2247,-1501,21,1446.2,8,3,7,1,1,0,0,16709,6.8,17756,213,64,2247,1501,21.3,1670.9,red,0.88,5,19,93,red
4465840053,10,10,3,0,0,0,0,16993,7.2,19167,195,61,-1019,699,19.5,1699.3,10,10,10,0,0,0,0,18012,7.2,18468,202,38,1019,-699,20.2,1801.2,blue,1.3,2,18,34,red
4522629457,3,9,0,0,0,0,0,14149,6.6,17085,189,49,-3960,-2533,18.9,1414.9,9,3,9,0,0,0,0,18109,7.2,19618,220,52,3960,2533,22,1810.9,red,0.33,6,36,13,red
4442569713,10,5,8,1,1,0,0,18633,6.8,18488,231,44,4235,3554,23.1,1863.3,5,10,4,0,0,0,0,14398,6.2,14934,164,48,-4235,-3554,16.4,1439.8,blue,3.6,0.9,20,18,blue
4522528585,8,8,5,1,1,0,0,17421,7.4,19535,244,49,-108,1254,24.4,1742.1,8,8,9,0,0,0,0,17529,7,18281,212,58,108,-1254,21.2,1752.9,blue,1.62,2.12,17,16,red
4449138530,1,4,0,1,0,1,0,14112,6.8,17417,202,52,-1309,351,20.2,1411.2,4,1,7,1,1,0,0,15421,6.6,17066,205,53,1309,-351,20.5,1542.1,red,0.25,11,18,21,red
4525551314,10,4,10,0,0,0,1,19095,7.2,19444,219,44,2999,2184,21.9,1909.5,4,10,2,0,0,0,0,16096,6.6,17260,204,48,-2999,-2184,20.4,1609.6,red,5,0.6,13,13,blue
4526865025,8,5,7,1,1,0,0,16770,7.4,19515,212,52,402,1641,21.2,1677,5,8,6,0,0,0,0,16368,6.8,17874,222,52,-402,-1641,22.2,1636.8,blue,3,1.38,21,23,red
4465444294,8,7,9,0,0,0,0,17430,6.8,17345,210,33,421,-755,21,1743,7,8,7,1,1,0,0,17009,7,18100,216,42,-421,755,21.6,1700.9,red,2.43,1.75,41,18,red
4438257769,5,6,9,1,1,0,0,15011,6.4,15341,173,50,-1071,-1810,17.3,1501.1,6,5,3,0,0,0,0,16082,6.6,17151,226,44,1071,1810,22.6,1608.2,red,2.33,1.8,14,20,red
4491793322,0,11,0,1,0,1,0,13475,6.2,15686,206,71,-5840,-2412,20.6,1347.5,11,0,16,1,1,0,0,19315,7,18098,262,49,5840,2412,26.2,1931.5,red,0,12.65,16,22,red
4462552916,2,3,1,0,0,0,0,13581,7,17687,201,46,-1885,-366,20.1,1358.1,3,2,5,1,1,0,0,15466,7.2,18053,246,54,1885,366,24.6,1546.6,red,1,4,18,29,red
4412978193,10,7,11,2,1,1,0,16743,6.6,17531,189,44,52,221,18.9,1674.3,7,10,5,0,0,0,0,16691,6.8,17310,208,38,-52,-221,20.8,1669.1,blue,3,1.2,15,16,blue
4521984246,5,6,5,1,1,0,0,16331,7,17720,231,44,-377,-1234,23.1,1633.1,6,5,7,0,0,0,0,16708,7.2,18954,229,56,377,1234,22.9,1670.8,blue,1.67,2.6,17,26,blue
4467978443,7,6,10,1,0,1,0,15948,6.6,16134,185,39,-361,-1022,18.5,1594.8,6,7,7,0,0,0,0,16309,6.8,17156,196,44,361,1022,19.6,1630.9,red,2.83,1.86,21,21,red
4459832099,9,3,6,2,1,1,0,19155,7.6,20750,251,88,4526,2759,25.1,1915.5,3,9,3,0,0,0,0,14629,7,17991,192,48,-4526,-2759,19.2,1462.9,blue,5,0.67,19,18,blue
4525993420,6,6,7,1,0,1,1,17312,6.6,16818,209,50,1139,-885,20.9,1731.2,6,6,8,1,1,0,0,16173,6.8,17703,208,52,-1139,885,20.8,1617.3,blue,2.17,2.33,27,19,blue
4495070442,7,3,8,0,0,0,0,16990,6.8,17608,187,60,2565,1235,18.7,1699,3,7,2,0,0,0,0,14425,6.4,16373,212,41,-2565,-1235,21.2,1442.5,blue,5,0.71,19,18,blue
4526731999,12,7,14,1,1,0,0,17785,7,17490,183,28,376,-470,18.3,1778.5,7,12,7,0,0,0,0,17409,6.8,17960,207,48,-376,470,20.7,1740.9,blue,3.71,1.17,31,140,red
4449195620,4,8,0,0,0,0,0,15704,6.6,16968,210,52,-322,-716,21,1570.4,8,4,14,0,0,0,0,16026,7,17684,179,32,322,716,17.9,1602.6,red,0.5,5.5,16,14,blue
4508411289,4,4,4,1,1,0,0,17055,7.2,19132,228,80,1400,488,22.8,1705.5,4,4,3,0,0,0,0,15655,7.2,18644,235,47,-1400,-488,23.5,1565.5,blue,2,1.75,17,17,red
4437082520,10,6,11,1,1,0,0,17538,7,19111,219,48,34,145,21.9,1753.8,6,10,6,0,0,0,0,17504,7.2,18966,225,68,-34,-145,22.5,1750.4,red,3.5,1.2,20,18,blue
4488944562,4,5,7,0,0,0,0,15340,6.6,16902,213,43,-885,-1554,21.3,1534,5,4,5,2,1,1,0,16225,7.2,18456,240,60,885,1554,24,1622.5,blue,2.2,2.5,23,25,blue
4473484316,6,10,4,0,0,0,0,15679,6.4,16997,188,53,-3209,-2726,18.8,1567.9,10,6,8,0,0,0,0,18888,7.2,19723,233,48,3209,2726,23.3,1888.8,red,1,3,16,18,red
4484788416,7,7,9,0,0,0,0,16391,7,17955,209,39,129,230,20.9,1639.1,7,7,5,1,1,0,0,16262,6.6,17725,199,63,-129,-230,19.9,1626.2,blue,2.29,1.71,41,37,red
4504901140,12,8,15,1,1,0,0,19362,7.2,18101,221,36,870,130,22.1,1936.2,8,12,8,1,0,1,1,18492,7,17971,216,36,-870,-130,21.6,1849.2,blue,3.38,1.33,18,40,red
4477594109,1,4,1,0,0,0,0,14049,6.6,16350,194,47,-2798,-3625,19.4,1404.9,4,1,5,2,1,1,0,16847,7.4,19975,248,68,2798,3625,24.8,1684.7,red,0.5,9,20,51,red
4483434284,12,9,9,1,1,0,0,17905,7.2,18292,195,39,482,466,19.5,1790.5,9,12,10,0,0,0,0,17423,7,17826,159,68,-482,-466,15.9,1742.3,blue,2.33,1.58,14,93,red
4519166800,7,4,6,1,1,0,0,17329,7.4,19569,239,54,1257,1123,23.9,1732.9,4,7,3,0,0,0,0,16072,7.2,18446,242,57,-1257,-1123,24.2,1607.2,blue,3.25,1,21,16,red
4477418951,7,10,11,0,0,0,0,16699,7,17566,195,51,-967,-263,19.5,1669.9,10,7,8,0,0,0,0,17666,7.2,17829,208,54,967,263,20.8,1766.6,red,1.8,2.57,23,25,red
4514011142,7,10,7,1,0,1,1,16859,7,17173,198,47,-2416,-2252,19.8,1685.9,10,7,12,1,1,0,1,19275,7.4,19425,221,39,2416,2252,22.1,1927.5,red,1.4,3.14,8,14,blue
4517831692,4,6,7,0,0,0,0,14800,7,18190,207,52,-1808,-259,20.7,1480,6,4,9,1,1,0,0,16608,7.2,18449,231,60,1808,259,23.1,1660.8,red,1.83,3.75,35,19,red
4527040336,5,4,5,0,0,0,0,15452,6.6,16236,195,35,926,-849,19.5,1545.2,4,5,4,1,1,0,0,14526,6.8,17085,186,44,-926,849,18.6,1452.6,blue,2.5,1.6,22,19,blue
4526158709,7,3,6,1,1,0,0,16981,7.2,19169,232,50,1621,1793,23.2,1698.1,3,7,4,0,0,0,0,15360,6.8,17376,236,47,-1621,-1793,23.6,1536,red,4.33,1,17,14,red
4468624067,5,1,5,0,0,0,0,15735,7,17967,219,48,1558,1567,21.9,1573.5,1,5,1,1,0,1,0,14177,6.6,16400,202,63,-1558,-1567,20.2,1417.7,blue,10,0.4,21,22,blue
4511150138,3,4,3,1,1,0,0,15458,7.2,19132,219,64,98,984,21.9,1545.8,4,3,2,0,0,0,0,15360,7,18148,240,48,-98,-984,24,1536,blue,1.5,2,45,19,red
4525811703,9,5,10,0,0,0,0,16515,6.6,16954,198,42,1547,1218,19.8,1651.5,5,9,4,1,1,0,0,14968,6.4,15736,193,44,-1547,-1218,19.3,1496.8,red,3.8,1,20,19,blue
4505405578,5,11,4,0,0,0,0,16275,6.8,16965,221,40,-2001,-2536,22.1,1627.5,11,5,13,1,1,0,0,18276,7.2,19501,193,68,2001,2536,19.3,1827.6,red,0.82,4.8,23,39,blue
4489981636,5,7,6,0,0,0,0,16150,6.8,16981,207,55,-1166,-988,20.7,1615,7,5,12,1,1,0,0,17316,7,17969,218,60,1166,988,21.8,1731.6,blue,1.57,3.8,21,22,red
4527427825,9,9,6,2,1,1,0,17913,6.8,18248,217,37,785,1373,21.7,1791.3,9,9,15,0,0,0,0,17128,6.8,16875,191,40,-785,-1373,19.1,1712.8,blue,1.67,2.67,19,43,red
4508822340,3,7,3,0,0,0,0,15623,7,17536,224,44,-1160,-592,22.4,1562.3,7,3,13,1,1,0,0,16783,7.2,18128,194,53,1160,592,19.4,1678.3,red,0.86,6.67,80,17,red
4495903813,6,2,9,1,1,0,0,16405,7.2,18231,233,47,1410,1243,23.3,1640.5,2,6,3,0,0,0,0,14995,6.6,16988,235,52,-1410,-1243,23.5,1499.5,blue,7.5,0.83,14,14,red
4463067805,6,5,3,1,1,0,0,16912,7,19261,253,60,750,1293,25.3,1691.2,5,6,3,0,0,0,0,16162,7,17968,233,40,-750,-1293,23.3,1616.2,blue,1.8,1.33,18,20,red
4462000850,5,2,5,1,1,0,0,17092,7.2,19011,242,63,2788,1325,24.2,1709.2,2,5,2,0,0,0,0,14304,6.8,17686,215,44,-2788,-1325,21.5,1430.4,blue,5,0.8,24,19,blue
4492832056,6,5,5,1,1,0,0,17056,7.2,18811,234,48,739,711,23.4,1705.6,5,6,6,0,0,0,0,16317,6.8,18100,231,53,-739,-711,23.1,1631.7,blue,2.2,1.83,17,14,blue
4513844046,4,5,2,0,0,0,0,15039,6.8,17278,221,52,-960,-1743,22.1,1503.9,5,4,2,1,1,0,0,15999,7,19021,232,60,960,1743,23.2,1599.9,blue,1.2,1.75,138,18,red
4477407120,10,5,8,0,0,0,0,17465,6.8,17968,218,51,1428,463,21.8,1746.5,5,10,9,1,1,0,0,16037,6.8,17505,222,40,-1428,-463,22.2,1603.7,blue,3.6,1.4,11,45,blue
4484045621,10,7,16,2,1,1,0,18989,7.2,19584,201,67,2545,1695,20.1,1898.9,7,10,11,0,0,0,0,16444,7,17889,212,38,-2545,-1695,21.2,1644.4,blue,3.71,1.8,41,43,blue
4517823981,4,7,4,0,0,0,0,14663,6.6,16512,242,16,-2405,-2654,24.2,1466.3,7,4,5,1,1,0,0,17068,7.2,19166,235,64,2405,2654,23.5,1706.8,red,1.14,3,16,17,blue
4525779442,3,6,4,1,1,0,0,15208,6.8,17411,224,47,-1318,406,22.4,1520.8,6,3,12,1,0,1,0,16526,7,17005,211,47,1318,-406,21.1,1652.6,blue,1.17,6,19,19,red
4519798886,9,9,11,1,1,0,0,18036,6.8,17340,213,34,-1501,-3119,21.3,1803.6,9,9,10,1,0,1,0,19537,7.6,20459,221,74,1501,3119,22.1,1953.7,red,2.22,2.11,38,41,blue
4527216897,8,8,10,2,1,1,0,17875,7.2,18665,205,53,984,1142,20.5,1787.5,8,8,8,0,0,0,0,16891,7,17523,227,27,-984,-1142,22.7,1689.1,red,2.25,2,29,22,blue
4455245413,5,10,4,0,0,0,0,15985,6.8,17576,223,47,-974,-1978,22.3,1598.5,10,5,11,1,1,0,0,16959,7.2,19554,188,37,974,1978,18.8,1695.9,red,0.9,4.2,15,16,blue
4419877547,6,7,10,1,1,0,1,17035,6.6,16379,187,40,1385,-827,18.7,1703.5,7,6,6,1,0,1,0,15650,6.6,17206,179,59,-1385,827,17.9,1565,red,2.29,2.17,53,195,blue
4497704200,7,3,8,0,0,0,0,17602,6.8,18119,254,52,2956,2140,25.4,1760.2,3,7,4,0,0,0,0,14646,6.4,15979,205,50,-2956,-2140,20.5,1464.6,blue,5,1,19,22,blue
4522569909,5,8,10,0,0,0,0,15979,6.8,17379,195,52,-583,360,19.5,1597.9,8,5,9,1,1,0,0,16562,6.6,17019,200,36,583,-360,20,1656.2,red,1.88,3.4,20,16,red
4524369918,9,5,9,0,0,0,0,18287,7.2,18535,242,52,2845,2164,24.2,1828.7,5,9,6,0,0,0,0,15442,6.6,16371,233,26,-2845,-2164,23.3,1544.2,red,3.6,1.22,46,19,blue
4480327869,5,12,8,0,0,0,0,14888,6.4,15213,153,48,-5010,-4509,15.3,1488.8,12,5,10,1,1,0,0,19898,7.6,19722,218,56,5010,4509,21.8,1989.8,red,1.08,4.4,16,23,red
4508863080,3,5,3,1,1,0,0,16040,7,18690,248,72,-877,-813,24.8,1604,5,3,6,0,0,0,0,16917,7.2,19503,264,52,877,813,26.4,1691.7,blue,1.2,3.67,22,16,red
4526872283,4,0,6,1,1,0,0,15388,6.8,17788,220,52,365,-719,22,1538.8,0,4,0,0,0,0,0,15023,6.8,18507,252,76,-365,719,25.2,1502.3,blue,12.03,0,41,19,blue
4462392955,7,6,7,0,0,0,0,16726,7,18339,217,44,278,-343,21.7,1672.6,6,7,5,1,1,0,0,16448,7,18682,206,64,-278,343,20.6,1644.8,red,2.33,1.57,16,42,red
4494877366,6,7,6,1,1,0,0,17242,7,18478,230,75,1291,2116,23,1724.2,7,6,8,0,0,0,0,15951,6.6,16362,171,27,-1291,-2116,17.1,1595.1,blue,1.71,2.5,91,21,red
4503020882,7,5,11,1,1,0,0,17650,7,18670,243,67,2518,2382,24.3,1765,5,7,8,0,0,0,0,15132,6.6,16288,196,32,-2518,-2382,19.6,1513.2,blue,3.6,1.86,18,16,blue
4522166127,10,6,8,0,0,0,0,17335,7.4,19512,208,56,364,1705,20.8,1733.5,6,10,6,0,0,0,0,16971,7,17807,218,48,-364,-1705,21.8,1697.1,red,3,1.2,35,17,red
4489951140,7,8,7,1,1,0,0,16938,7,17857,222,49,206,-460,22.2,1693.8,8,7,6,0,0,0,0,16732,7,18317,215,43,-206,460,21.5,1673.2,red,1.75,2,16,15,blue
4526486328,3,10,2,0,0,0,0,13655,6.4,15392,179,36,-5221,-4220,17.9,1365.5,10,3,12,1,1,0,0,18876,7.6,19612,239,60,5221,4220,23.9,1887.6,red,0.5,7.33,19,17,blue
4508974549,6,7,4,1,0,1,0,16823,7,18727,213,52,151,806,21.3,1682.3,7,6,8,1,1,0,0,16672,6.8,17921,226,48,-151,-806,22.6,1667.2,blue,1.43,2.5,23,25,red
4522675513,4,3,2,1,1,0,0,15834,7,19029,258,48,782,1642,25.8,1583.4,3,4,3,0,0,0,0,15052,6.6,17387,238,40,-782,-1642,23.8,1505.2,blue,2,1.5,25,24,blue
4525772082,2,8,2,1,0,1,0,14970,6.8,17809,235,59,-2366,-340,23.5,1497,8,2,14,0,0,0,0,17336,6.8,18149,226,34,2366,340,22.6,1733.6,red,0.5,11,25,25,red
4450648028,6,6,10,1,1,0,0,17173,7.2,18789,232,54,386,-200,23.2,1717.3,6,6,8,0,0,0,0,16787,7.2,18989,202,55,-386,200,20.2,1678.7,red,2.67,2.33,13,20,red
4526272276,1,6,1,0,0,0,0,13409,6.6,15601,203,45,-3559,-3320,20.3,1340.9,6,1,4,2,1,1,0,16968,7,18921,236,69,3559,3320,23.6,1696.8,red,0.33,10,17,13,red
4523322738,8,8,8,1,0,1,0,17022,7,19318,237,50,-900,1475,23.7,1702.2,8,8,12,1,1,0,0,17922,7,17843,203,45,900,-1475,20.3,1792.2,blue,2,2.5,20,18,blue
4502224154,4,3,5,1,0,1,0,15804,7.2,18509,228,68,606,820,22.8,1580.4,3,4,5,1,1,0,0,15198,6.8,17689,210,60,-606,-820,21,1519.8,red,3,2,17,11,red
4508492240,8,3,9,1,1,0,0,17073,6.8,16988,195,60,2939,993,19.5,1707.3,3,8,3,0,0,0,0,14134,6.6,15995,197,44,-2939,-993,19.7,1413.4,red,5.67,0.75,23,18,blue
4526649785,7,6,7,1,1,0,0,16553,7.2,19304,205,56,1216,2889,20.5,1655.3,6,7,7,0,0,0,0,15337,6.6,16415,173,44,-1216,-2889,17.3,1533.7,blue,2.33,1.86,15,13,red
4486816853,9,3,10,1,1,0,0,17679,7.4,19757,237,54,2488,2453,23.7,1767.9,3,9,5,0,0,0,0,15191,7,17304,222,49,-2488,-2453,22.2,1519.1,red,6.33,0.89,21,20,blue
4513065219,4,13,7,1,1,0,0,14007,6.2,14101,197,27,-6259,-5376,19.7,1400.7,13,4,14,0,0,0,0,20266,7.2,19477,247,45,6259,5376,24.7,2026.6,red,0.85,6.75,17,17,red
4508590240,2,9,3,1,1,0,0,13986,6.4,16124,189,44,-3246,-1980,18.9,1398.6,9,2,10,0,0,0,0,17232,7,18104,209,52,3246,1980,20.9,1723.2,red,0.56,9.5,17,46,red
4527591942,7,5,8,0,0,0,0,16481,7,18136,190,46,572,-233,19,1648.1,5,7,7,1,1,0,0,15909,7,18369,224,48,-572,233,22.4,1590.9,red,3,1.71,42,20,blue
4524654219,10,5,12,1,1,0,0,17834,7.2,19107,208,38,1260,1141,20.8,1783.4,5,10,4,0,0,0,0,16574,7,17966,226,50,-1260,-1141,22.6,1657.4,blue,4.4,0.9,21,16,red
4478422383,8,7,8,1,1,0,0,17200,6.6,17501,226,36,528,-805,22.6,1720,7,8,7,0,0,0,0,16672,7.2,18306,199,69,-528,805,19.9,1667.2,blue,2.29,1.75,17,14,blue
4463251548,9,9,13,2,1,1,0,17125,6.8,16776,191,52,-206,-363,19.1,1712.5,9,9,7,0,0,0,0,17331,6.6,17139,204,48,206,363,20.4,1733.1,blue,2.44,1.78,21,18,blue
4493965558,7,7,9,1,1,0,0,16937,7,18017,214,49,375,-566,21.4,1693.7,7,7,7,0,0,0,0,16562,7,18583,194,49,-375,566,19.4,1656.2,blue,2.29,2,81,19,red
4508204342,4,4,4,2,1,1,0,15802,7,17365,237,48,306,-936,23.7,1580.2,4,4,5,0,0,0,0,15496,7,18301,209,69,-306,936,20.9,1549.6,blue,2,2.25,16,19,blue
4473029808,12,2,18,0,0,0,0,19336,7.4,19593,221,59,4680,2780,22.1,1933.6,2,12,2,0,0,0,0,14656,6.8,16813,214,60,-4680,-2780,21.4,1465.6,blue,15,0.33,51,16,red
4513993269,8,3,11,1,1,0,1,18524,7,18193,241,44,2702,1047,24.1,1852.4,3,8,5,0,0,0,0,15822,6.8,17146,228,54,-2702,-1047,22.8,1582.2,blue,6.33,1,24,21,blue
4477860376,4,7,5,0,0,0,0,15346,6.6,17250,212,47,-1938,-1173,21.2,1534.6,7,4,7,1,1,0,0,17284,7,18423,225,64,1938,1173,22.5,1728.4,red,1.29,3.5,40,21,blue
4526047825,8,6,10,1,1,0,0,16912,6.8,17195,205,52,1051,797,20.5,1691.2,6,8,8,0,0,0,0,15861,6.6,16398,212,36,-1051,-797,21.2,1586.1,blue,3,1.75,72,17,blue
4494953738,2,4,2,0,0,0,0,14843,7,18146,236,43,-620,-147,23.6,1484.3,4,2,5,0,0,0,0,15463,7,18293,236,50,620,147,23.6,1546.3,blue,1,4.5,27,25,red
4510135143,7,5,10,0,0,0,0,17037,7,17825,237,40,987,-377,23.7,1703.7,5,7,5,2,1,1,0,16050,7,18202,219,60,-987,377,21.9,1605,red,3.4,1.43,50,20,blue
4521862362,9,11,4,0,0,0,0,17525,7,16972,202,48,-437,-1284,20.2,1752.5,11,9,12,1,1,0,0,17962,6.8,18256,190,44,437,1284,19,1796.2,blue,1.18,2.56,19,32,red
4526604474,1,5,1,1,0,1,0,14102,6.8,16463,211,56,-2031,-2540,21.1,1410.2,5,1,6,0,0,0,0,16133,7,19003,221,60,2031,2540,22.1,1613.3,red,0.4,11,20,18,red
4476455937,6,10,7,0,0,0,0,15530,7,18389,222,40,-1932,-930,22.2,1553,10,6,6,1,1,0,0,17462,7.4,19319,232,39,1932,930,23.2,1746.2,red,1.3,2.67,20,23,red
4504287610,4,8,5,0,0,0,0,15168,6.8,17149,201,48,-2626,-1992,20.1,1516.8,8,4,7,0,0,0,0,17794,7.2,19141,254,52,2626,1992,25.4,1779.4,red,1.12,3.75,38,12,blue
4494170863,3,5,1,1,1,0,0,14900,6.8,18274,211,68,-2631,-1358,21.1,1490,5,3,11,0,0,0,0,17531,7.4,19632,221,78,2631,1358,22.1,1753.1,blue,0.8,5.33,18,19,red
4474350630,8,5,5,2,1,1,0,17639,7.2,19606,228,60,1899,2690,22.8,1763.9,5,8,9,0,0,0,0,15740,6.8,16916,208,48,-1899,-2690,20.8,1574,blue,2.6,1.75,17,14,blue
4464507584,3,7,3,1,1,0,0,14958,6.6,16560,239,56,-2607,-2125,23.9,1495.8,7,3,8,0,0,0,0,17565,7,18685,253,56,2607,2125,25.3,1756.5,blue,0.86,5,14,21,blue
4494830005,2,2,1,1,1,0,0,14569,6.6,16559,227,38,-676,-864,22.7,1456.9,2,2,3,0,0,0,0,15245,6.8,17423,236,46,676,864,23.6,1524.5,red,1.5,2.5,27,25,red
4505441890,7,3,5,2,1,1,0,16820,7.2,18804,222,50,1968,1923,22.2,1682,3,7,4,0,0,0,0,14852,6.8,16881,205,56,-1968,-1923,20.5,1485.2,red,4,1,46,18,blue
4478351147,4,11,0,0,0,0,0,14891,6.8,17683,218,59,-4035,-2639,21.8,1489.1,11,4,11,1,1,0,0,18926,7.4,20322,246,51,4035,2639,24.6,1892.6,red,0.36,5.5,16,21,red
4490184459,5,9,7,0,0,0,0,15089,6.4,16002,182,32,-2349,-2678,18.2,1508.9,9,5,7,1,1,0,0,17438,7,18680,201,54,2349,2678,20.1,1743.8,red,1.33,3.2,20,21,red
4518851187,1,6,1,0,0,0,0,13427,6.8,16472,211,44,-3175,-1845,21.1,1342.7,6,1,5,1,1,0,0,16602,7,18317,217,64,3175,1845,21.7,1660.2,red,0.33,11,17,20,red
4518754842,8,3,6,2,1,1,0,17848,7.4,19823,253,56,2450,2233,25.3,1784.8,3,8,3,0,0,0,0,15398,7,17590,227,52,-2450,-2233,22.7,1539.8,blue,4.67,0.75,42,15,blue
4494990363,12,6,16,2,1,1,0,18021,7.2,18556,202,37,1373,1766,20.2,1802.1,6,12,10,0,0,0,0,16648,6.4,16790,200,43,-1373,-1766,20,1664.8,blue,4.67,1.33,22,21,blue
4524003545,4,4,5,2,1,1,0,16370,7,18289,257,48,1504,2057,25.7,1637,4,4,6,0,0,0,0,14866,6.8,16232,191,52,-1504,-2057,19.1,1486.6,blue,2.25,2.5,15,9,blue
4458488872,8,6,11,1,1,0,0,16091,6.8,16748,200,44,-765,-492,20,1609.1,6,8,11,0,0,0,0,16856,7,17240,185,44,765,492,18.5,1685.6,blue,3.17,2.12,15,37,blue
4502783648,5,10,5,0,0,0,0,15129,6.4,15915,176,56,-2921,-3196,17.6,1512.9,10,5,12,0,0,0,0,18050,7,19111,203,60,2921,3196,20.3,1805,red,1,4.4,15,15,red
4526343162,7,3,9,0,0,0,0,16817,6.8,17790,228,54,2283,830,22.8,1681.7,3,7,6,1,1,0,0,14534,6.8,16960,202,53,-2283,-830,20.2,1453.4,blue,5.33,1.29,17,17,blue
4477278221,8,6,7,1,0,1,1,18203,6.8,17893,248,32,2297,392,24.8,1820.3,6,8,6,1,1,0,0,15906,6.8,17501,193,52,-2297,-392,19.3,1590.6,blue,2.5,1.5,24,20,blue
4486544471,10,9,10,0,0,0,0,17706,6.8,17870,212,48,578,144,21.2,1770.6,9,10,6,0,0,0,0,17128,7,17726,204,38,-578,-144,20.4,1712.8,blue,2.22,1.5,14,12,red
4520749944,10,4,6,1,1,0,0,16668,7,18055,192,43,1794,2647,19.2,1666.8,4,10,3,0,0,0,0,14874,6.4,15408,203,40,-1794,-2647,20.3,1487.4,blue,4,0.7,15,25,red
4520855860,5,6,10,0,0,0,0,15862,6.6,16175,229,39,-971,-1588,22.9,1586.2,6,5,6,1,0,1,0,16833,6.8,17763,195,59,971,1588,19.5,1683.3,red,2.5,2.4,19,21,blue
4455569547,9,7,10,0,0,0,0,17479,6.8,17898,209,52,1269,-422,20.9,1747.9,7,9,8,1,1,0,0,16210,6.8,18320,207,56,-1269,422,20.7,1621,blue,2.71,1.67,12,15,blue
4519775605,9,5,6,1,0,1,0,16782,7,18450,218,44,-34,-122,21.8,1678.2,5,9,3,1,1,0,0,16816,7,18572,234,56,34,122,23.4,1681.6,red,3,0.89,28,23,blue
4525637660,8,8,7,1,1,0,0,17942,7.2,18724,213,52,1171,918,21.3,1794.2,8,8,12,0,0,0,0,16771,7,17806,189,44,-1171,-918,18.9,1677.1,red,1.88,2.5,37,18,red
4448447768,10,15,8,0,0,0,0,17418,7,18495,202,38,-2298,-1255,20.2,1741.8,15,10,10,1,1,0,0,19716,7.2,19750,171,46,2298,1255,17.1,1971.6,red,1.2,2.5,11,15,red
4484154962,8,10,7,0,0,0,0,16180,6.6,16639,185,36,-2807,-2956,18.5,1618,10,8,17,0,0,0,0,18987,7.4,19595,236,61,2807,2956,23.6,1898.7,red,1.5,3.38,21,19,blue
4477722184,2,4,2,0,0,0,0,14124,6.4,15978,229,32,-1155,-638,22.9,1412.4,4,2,7,0,0,0,0,15279,6.6,16616,215,42,1155,638,21.5,1527.9,blue,1,5.5,24,20,blue
4510857801,8,11,10,0,0,0,0,18452,7,17864,241,42,-69,-634,24.1,1845.2,11,8,10,2,1,1,0,18521,7,18498,180,60,69,634,18,1852.1,red,1.64,2.62,18,20,red
4505644986,6,4,8,1,1,0,0,17142,7.2,18300,227,56,576,-1839,22.7,1714.2,4,6,7,1,0,1,0,16566,7.4,20139,222,79,-576,1839,22.2,1656.6,red,3.5,1.83,16,16,blue
4476110397,7,10,9,1,0,1,0,16143,6.8,17196,181,55,-1694,-468,18.1,1614.3,10,7,16,1,1,0,0,17837,6.8,17664,200,56,1694,468,20,1783.7,red,1.6,3.71,19,16,blue
4521401653,4,9,4,0,0,0,0,15944,7,17805,201,71,-2600,-1587,20.1,1594.4,9,4,13,1,1,0,0,18544,7.2,19392,251,53,2600,1587,25.1,1854.4,red,0.89,5.5,15,13,red
4478653874,1,6,0,1,0,1,0,14059,6.8,17446,213,48,-2160,-88,21.3,1405.9,6,1,10,1,1,0,0,16219,6.8,17534,204,43,2160,88,20.4,1621.9,red,0.17,16,12,19,red
4459773045,11,7,14,1,1,0,1,19465,7,17819,214,52,4013,2137,21.4,1946.5,7,11,8,0,0,0,0,15452,6.4,15682,182,29,-4013,-2137,18.2,1545.2,blue,3.57,1.36,27,15,blue
4465807712,8,6,14,1,1,0,0,17151,7,18082,227,43,1338,46,22.7,1715.1,6,8,5,0,0,0,0,15813,7,18036,204,52,-1338,-46,20.4,1581.3,red,3.67,1.38,17,19,blue
4449152051,14,3,16,1,0,1,0,19483,7.2,19290,227,34,5019,3765,22.7,1948.3,3,14,1,0,0,0,0,14464,6.4,15525,203,52,-5019,-3765,20.3,1446.4,blue,10,0.29,22,18,red
4523373945,8,6,9,0,0,0,0,15716,6.4,16324,190,36,258,762,19,1571.6,6,8,8,1,1,0,0,15458,6.2,15562,183,40,-258,-762,18.3,1545.8,red,2.83,1.75,14,19,red
4500426573,3,8,3,0,0,0,0,15015,6.8,17386,216,60,-2327,-2301,21.6,1501.5,8,3,8,1,0,1,0,17342,7.2,19687,230,52,2327,2301,23,1734.2,red,0.75,5.33,20,78,red
4526752854,9,4,7,0,0,0,0,16847,7,19212,211,45,1843,3584,21.1,1684.7,4,9,4,0,0,0,0,15004,6.2,15628,194,50,-1843,-3584,19.4,1500.4,red,4,0.89,20,19,red
4490700723,3,3,3,0,0,0,0,14907,6.6,16847,205,50,-1021,-2152,20.5,1490.7,3,3,5,1,1,0,0,15928,7.2,18999,238,71,1021,2152,23.8,1592.8,red,2,2.67,23,21,blue
4524940006,5,6,6,0,0,0,0,15768,6.8,17401,200,55,-450,-1721,20,1576.8,6,5,5,1,1,0,0,16218,7.4,19122,225,58,450,1721,22.5,1621.8,red,1.83,2.2,23,23,blue
4525344847,10,10,10,1,1,0,0,16722,6.8,17229,163,47,-790,-1172,16.3,1672.2,10,10,8,1,0,1,0,17512,7,18401,207,44,790,1172,20.7,1751.2,red,2,1.8,162,18,blue
4483910758,3,5,2,1,0,1,0,15385,7,17822,227,56,-989,-1102,22.7,1538.5,5,3,3,1,1,0,0,16374,7.4,18924,224,63,989,1102,22.4,1637.4,red,1,2.67,15,19,red
4522801781,6,8,8,0,0,0,0,16102,6.6,17077,200,45,-1412,-768,20,1610.2,8,6,9,0,0,0,0,17514,6.8,17845,227,40,1412,768,22.7,1751.4,red,1.75,2.83,122,22,blue
4459294938,7,2,6,0,0,0,0,16977,7.2,19637,209,64,1926,3774,20.9,1697.7,2,7,3,1,1,0,0,15051,6.4,15863,235,56,-1926,-3774,23.5,1505.1,blue,6.5,0.71,18,15,red
4493037422,8,8,12,0,0,0,0,16033,6.8,17402,188,52,-3022,-613,18.8,1603.3,8,8,6,1,0,1,1,19055,7.2,18015,221,54,3022,613,22.1,1905.5,red,2.5,1.75,11,15,blue
4508177030,4,6,2,1,1,0,0,15272,7,18442,205,47,-716,573,20.5,1527.2,6,4,5,0,0,0,0,15988,6.8,17869,207,50,716,-573,20.7,1598.8,blue,1,2.75,44,148,red
4477114963,10,4,13,0,0,0,0,18959,7,19305,220,48,3522,1996,22,1895.9,4,10,5,1,1,0,0,15437,6.6,17309,206,69,-3522,-1996,20.6,1543.7,red,5.75,0.9,17,19,red
4526548398,5,4,9,0,0,0,0,15633,6.8,17562,222,44,148,-543,22.2,1563.3,4,5,4,0,0,0,0,15485,7,18105,210,56,-148,543,21,1548.5,red,3.5,1.6,18,20,blue
4518870146,1,7,2,0,0,0,0,14490,7,17638,222,60,-2987,-2017,22.2,1449,7,1,10,1,1,0,0,17477,7.4,19655,235,56,2987,2017,23.5,1747.7,red,0.43,17,15,18,red
4486503067,6,5,9,0,0,0,0,17812,7.2,19411,263,69,2303,2950,26.3,1781.2,5,6,9,1,1,0,0,15509,6.6,16461,191,46,-2303,-2950,19.1,1550.9,blue,3,2.33,19,18,blue
4418034282,3,3,3,0,0,0,0,15603,6.8,18354,239,72,288,-339,23.9,1560.3,3,3,2,0,0,0,0,15315,7,18693,232,52,-288,339,23.2,1531.5,red,2,1.67,20,26,red
4477843877,4,4,8,1,1,0,0,16667,7.2,18290,239,60,1692,373,23.9,1666.7,4,4,3,1,0,1,0,14975,6.8,17917,209,44,-1692,-373,20.9,1497.5,blue,3,1.75,21,20,blue
4460653436,5,11,8,0,0,0,0,16177,7,18425,224,45,-1546,-710,22.4,1617.7,11,5,12,1,1,0,0,17723,7.4,19135,183,58,1546,710,18.3,1772.3,red,1.18,4.6,41,21,red
4479126740,8,10,8,0,0,0,0,16780,6.8,17484,209,39,-1226,48,20.9,1678,10,8,12,1,1,0,0,18006,6.8,17436,225,36,1226,-48,22.5,1800.6,red,1.6,2.75,64,22,red
4521611009,7,12,9,0,0,0,0,15938,6.2,14724,194,36,-1985,-3666,19.4,1593.8,12,7,13,1,1,0,0,17923,7.2,18390,187,44,1985,3666,18.7,1792.3,red,1.33,3.57,15,42,blue
4486105297,7,10,9,0,0,0,0,16154,6.6,16080,199,41,-2005,-1736,19.9,1615.4,10,7,10,0,0,0,0,18159,6.8,17816,229,46,2005,1736,22.9,1815.9,blue,1.6,2.86,20,23,blue
4521787222,4,6,2,2,1,1,0,14975,7,18139,201,58,-1530,-146,20.1,1497.5,6,4,8,0,0,0,0,16505,7.2,18285,220,63,1530,146,22,1650.5,red,1,3.5,19,45,red
4492271178,3,12,2,1,0,1,0,14683,6.6,16048,215,39,-4600,-3906,21.5,1468.3,12,3,11,0,0,0,0,19283,7.4,19954,209,67,4600,3906,20.9,1928.3,red,0.42,7.67,23,20,blue
4525977517,6,4,6,1,1,0,0,15836,6.8,18034,216,43,75,-123,21.6,1583.6,4,6,1,0,0,0,0,15761,6.8,18157,254,38,-75,123,25.4,1576.1,blue,3,0.83,21,17,red
4457601167,8,5,7,0,0,0,0,16463,6.8,16852,207,37,-185,-1442,20.7,1646.3,5,8,3,2,1,1,0,16648,7,18294,228,55,185,1442,22.8,1664.8,blue,3,1,91,16,blue
4500144079,4,7,4,1,1,0,0,15712,6.8,17100,213,51,-418,15,21.3,1571.2,7,4,11,0,0,0,0,16130,6.8,17085,166,53,418,-15,16.6,1613,blue,1.14,4.5,27,24,blue
4503460732,9,2,9,1,0,1,0,17665,7.4,19246,232,45,3642,2198,23.2,1766.5,2,9,1,1,1,0,0,14023,7,17048,199,46,-3642,-2198,19.9,1402.3,blue,9,0.33,17,84,blue
4527166498,13,5,21,1,1,0,0,19680,7.2,18528,204,44,5397,2928,20.4,1968,5,13,5,0,0,0,0,14283,6.4,15600,175,38,-5397,-2928,17.5,1428.3,blue,6.8,0.77,19,21,blue
4472131666,5,3,3,0,0,0,0,16400,7.4,18900,255,62,2247,1439,25.5,1640,3,5,1,1,1,0,0,14153,7,17461,202,54,-2247,-1439,20.2,1415.3,blue,2.67,0.8,21,45,blue
4460036381,3,7,3,1,1,0,0,14659,6.2,15944,193,48,-944,-2050,19.3,1465.9,7,3,6,0,0,0,0,15603,6.8,17994,213,48,944,2050,21.3,1560.3,blue,0.86,4.33,14,14,red
4527378571,9,10,14,0,0,0,0,18742,7,18884,232,47,46,99,23.2,1874.2,10,9,16,0,0,0,0,18696,7,18785,236,49,-46,-99,23.6,1869.6,red,2.3,2.89,15,15,red
4508101367,6,4,5,0,0,0,0,16637,7,19339,245,49,1530,2305,24.5,1663.7,4,6,5,1,1,0,0,15107,6.6,17034,216,48,-1530,-2305,21.6,1510.7,blue,2.75,1.5,16,28,red
4485702742,9,2,5,1,1,0,0,18079,7.2,19818,272,52,3854,2379,27.2,1807.9,2,9,1,0,0,0,0,14225,6.8,17439,230,41,-3854,-2379,23,1422.5,blue,7,0.33,15,16,blue
4523826810,5,7,6,1,0,1,0,16407,6.8,18597,217,61,-450,127,21.7,1640.7,7,5,7,1,1,0,0,16857,7,18470,223,48,450,-127,22.3,1685.7,blue,1.57,2.8,21,23,blue
4481184386,6,8,9,0,0,0,0,16145,6.8,17448,215,44,-1962,-684,21.5,1614.5,8,6,12,0,0,0,0,18107,7,18132,223,54,1962,684,22.3,1810.7,red,1.88,3.33,51,20,red
4496807204,11,5,14,1,0,1,1,19557,6.8,18126,193,44,4238,1418,19.3,1955.7,5,11,4,1,1,0,0,15319,6.8,16708,206,36,-4238,-1418,20.6,1531.9,blue,5,0.82,70,85,blue
4476131958,6,3,5,0,0,0,0,16495,7.2,18530,232,59,1037,922,23.2,1649.5,3,6,2,0,0,0,0,15458,6.6,17608,238,48,-1037,-922,23.8,1545.8,blue,3.67,0.83,41,35,red
4525939655,11,9,10,1,1,0,0,17480,6.6,17096,203,39,-366,-923,20.3,1748,9,11,10,0,0,0,0,17846,6.6,18019,217,60,366,923,21.7,1784.6,red,2.33,1.73,16,18,red
4526014315,2,9,4,0,0,0,0,15074,6.8,16329,225,52,-1673,-1730,22.5,1507.4,9,2,10,1,1,0,0,16747,7,18059,215,52,1673,1730,21.5,1674.7,blue,0.67,9.5,17,17,red
4526640104,4,14,2,0,0,0,0,14963,6.2,15662,170,48,-6047,-3060,17,1496.3,14,4,20,2,1,1,1,21010,7,18722,203,41,6047,3060,20.3,2101,red,0.43,8.5,38,23,blue
4517647905,6,8,7,1,1,0,0,16058,7,17515,217,51,-677,-1382,21.7,1605.8,8,6,6,1,0,1,0,16735,7.2,18897,214,56,677,1382,21.4,1673.5,blue,1.62,2.33,17,64,blue
4451681116,2,6,1,0,0,0,0,14824,7,17975,214,59,-2465,-911,21.4,1482.4,6,2,6,1,0,1,0,17289,7.2,18886,243,60,2465,911,24.3,1728.9,red,0.5,6,14,16,blue
4472405035,7,6,9,1,1,0,0,17079,7,17964,212,44,-365,855,21.2,1707.9,6,7,10,0,0,0,0,17444,6.8,17109,238,44,365,-855,23.8,1744.4,blue,2.67,2.29,41,20,blue
4305726781,14,4,11,1,1,0,0,20351,7.4,19996,225,72,5057,3423,22.5,2035.1,4,14,3,0,0,0,0,15294,6.6,16573,197,43,-5057,-3423,19.7,1529.4,blue,6.25,0.5,23,24,blue
4477883317,12,5,11,1,0,1,0,18732,7.2,18910,222,44,2292,1022,22.2,1873.2,5,12,8,0,0,0,0,16440,7,17888,213,59,-2292,-1022,21.3,1644,blue,4.6,1.08,20,18,blue
4510942047,10,4,12,1,1,0,0,19017,7.2,19432,240,54,5117,4126,24,1901.7,4,10,4,0,0,0,0,13900,6.4,15306,193,34,-5117,-4126,19.3,1390,blue,5.5,0.8,17,20,blue
4504943058,6,6,7,0,0,0,0,17078,7,17751,224,46,-304,-1023,22.4,1707.8,6,6,6,1,1,0,0,17382,7,18774,240,45,304,1023,24,1738.2,blue,2.17,2,25,90,blue
4518992670,2,3,2,0,0,0,0,15351,7,18539,245,55,390,-828,24.5,1535.1,3,2,1,2,1,1,0,14961,7.2,19367,235,56,-390,828,23.5,1496.1,red,1.33,2,14,41,red
4413130871,3,3,2,1,0,1,0,15885,7,18531,243,52,-257,-883,24.3,1588.5,3,3,6,0,0,0,0,16142,7.2,19414,232,76,257,883,23.2,1614.2,red,1.67,3,17,17,red
4490264226,10,4,11,0,0,0,0,18851,7.4,19227,252,52,3737,1796,25.2,1885.1,4,10,4,0,0,0,0,15114,7,17431,203,45,-3737,-1796,20.3,1511.4,blue,5.25,0.8,20,17,blue
4526817312,4,3,5,0,0,0,0,16425,7,17611,227,44,2167,538,22.7,1642.5,3,4,4,1,1,0,0,14258,6.8,17073,208,46,-2167,-538,20.8,1425.8,blue,3,1.75,17,17,blue
4498316696,5,10,4,0,0,0,0,15649,7,17686,199,52,-2870,-2023,19.9,1564.9,10,5,14,1,1,0,0,18519,7.2,19709,229,60,2870,2023,22.9,1851.9,red,0.9,4.8,57,15,red
4470558521,4,6,3,0,0,0,0,14659,6.6,16241,192,48,-1962,-2464,19.2,1465.9,6,4,6,0,0,0,0,16621,7,18705,244,39,1962,2464,24.4,1662.1,blue,1.17,3,41,18,blue
4505265174,5,7,7,1,1,0,0,15983,7.2,18335,229,43,-704,-531,22.9,1598.3,7,5,10,0,0,0,0,16687,7.2,18866,205,48,704,531,20.5,1668.7,red,1.71,3.4,25,21,red
4499297783,4,4,3,1,0,1,0,15868,6.8,18299,222,47,946,594,22.2,1586.8,4,4,4,1,1,0,0,14922,6.8,17705,213,44,-946,-594,21.3,1492.2,blue,1.75,2,49,24,blue
4519370242,9,8,8,1,1,0,0,16732,6.8,16963,208,32,-496,-1184,20.8,1673.2,8,9,9,0,0,0,0,17228,7,18147,186,51,496,1184,18.6,1722.8,red,2.12,1.89,11,14,red
4512604685,4,16,5,0,0,0,0,14366,6,14866,171,30,-5395,-5287,17.1,1436.6,16,4,18,2,1,1,0,19761,7.4,20153,217,42,5395,5287,21.7,1976.1,red,0.56,8.5,18,54,blue
4523854789,6,6,5,0,0,0,0,16037,7.2,18383,207,51,59,-107,20.7,1603.7,6,6,7,1,1,0,0,15978,7,18490,229,48,-59,107,22.9,1597.8,blue,1.83,2.17,19,19,red
4525860232,9,6,9,0,0,0,0,17643,6.8,17908,218,36,1550,1042,21.8,1764.3,6,9,8,2,1,1,0,16093,6.6,16866,183,52,-1550,-1042,18.3,1609.3,blue,3,1.56,19,37,red
4527210467,1,6,3,1,1,0,0,14261,7,17724,198,67,-2160,85,19.8,1426.1,6,1,11,0,0,0,0,16421,6.8,17639,207,39,2160,-85,20.7,1642.1,red,0.67,17,46,71,red
4464924793,4,11,3,0,0,0,0,15939,6.8,17619,253,40,-1874,-1182,25.3,1593.9,11,4,7,1,0,1,0,17813,7,18801,221,36,1874,1182,22.1,1781.3,red,0.64,4.5,42,83,red
4490168381,3,6,3,0,0,0,0,15487,7,18816,238,68,-1854,-817,23.8,1548.7,6,3,6,2,1,1,0,17341,7.2,19633,232,64,1854,817,23.2,1734.1,red,1,4,22,14,red
4474862370,8,8,8,1,1,0,0,16601,6.2,16246,196,44,103,63,19.6,1660.1,8,8,6,0,0,0,0,16498,6.4,16183,194,46,-103,-63,19.4,1649.8,red,2,1.75,34,84,red
4477297316,4,3,3,1,0,1,2,17048,6.6,17678,206,48,2575,997,20.6,1704.8,3,4,4,1,1,0,0,14473,6.8,16681,214,43,-2575,-997,21.4,1447.3,blue,2.33,1.75,18,17,blue
4484057160,7,5,12,2,1,1,0,18328,7,18180,223,57,3048,2219,22.3,1832.8,5,7,5,0,0,0,0,15280,6.6,15961,195,49,-3048,-2219,19.5,1528,blue,3.8,1.43,21,18,red
4526146492,7,11,7,0,0,0,0,17375,6.8,18610,222,48,-2049,-1230,22.2,1737.5,11,7,10,2,1,1,0,19424,7.4,19840,236,58,2049,1230,23.6,1942.4,red,1.27,3,18,17,blue
4479476013,7,4,9,0,0,0,0,16556,6.6,16868,215,36,2139,850,21.5,1655.6,4,7,4,1,1,0,0,14417,6.4,16018,176,47,-2139,-850,17.6,1441.7,blue,4,1.14,17,15,red
4508388395,15,2,17,1,1,0,1,21883,7.8,20941,252,55,7980,4916,25.2,2188.3,2,15,0,0,0,0,0,13903,6.4,16025,193,44,-7980,-4916,19.3,1390.3,blue,16,0.13,18,13,blue
4449354276,9,7,11,0,0,0,0,17382,7.2,19283,220,55,1103,1117,22,1738.2,7,9,10,0,0,0,0,16279,7.2,18166,209,36,-1103,-1117,20.9,1627.9,red,2.86,1.89,17,44,blue
4500526206,13,3,15,2,1,1,0,20795,7.2,18944,249,48,6547,2553,24.9,2079.5,3,13,1,0,0,0,0,14248,6.6,16391,179,52,-6547,-2553,17.9,1424.8,blue,9.33,0.31,31,46,red
4480172739,4,9,3,0,0,0,0,15469,6.6,17314,234,45,-2472,-554,23.4,1546.9,9,4,8,2,1,1,0,17941,6.8,17868,227,68,2472,554,22.7,1794.1,red,0.78,4.25,46,25,red
4526245865,9,6,10,1,1,0,0,17951,7.2,18755,228,48,1464,179,22.8,1795.1,6,9,7,1,0,1,0,16487,6.8,18576,233,44,-1464,-179,23.3,1648.7,blue,3.17,1.44,128,19,blue
4436714385,6,15,6,0,0,0,0,15205,6.4,15267,166,28,-4683,-3444,16.6,1520.5,15,6,15,1,1,0,0,19888,7.2,18711,220,62,4683,3444,22,1988.8,red,0.8,5,21,36,red
4514035476,9,0,9,1,1,0,0,17835,7.2,18812,231,52,4277,3340,23.1,1783.5,0,9,0,1,0,1,0,13558,6.2,15472,207,47,-4277,-3340,20.7,1355.8,blue,12.03,0,23,86,blue
4525761133,7,4,8,0,0,0,0,17329,7.4,19681,224,55,1870,1791,22.4,1732.9,4,7,3,1,1,0,0,15459,6.8,17890,243,32,-1870,-1791,24.3,1545.9,blue,3.75,1,15,20,blue
4474911318,3,2,3,2,1,1,0,14992,6.8,17212,217,48,499,-2,21.7,1499.2,2,3,3,0,0,0,0,14493,7,17214,230,31,-499,2,23,1449.3,blue,3,1.67,23,19,blue
4522109455,8,5,7,0,0,0,0,17033,7,17938,232,44,832,903,23.2,1703.3,5,8,8,2,1,1,0,16201,6.8,17035,228,58,-832,-903,22.8,1620.1,blue,3,1.62,20,19,blue
4475415564,9,5,4,1,0,1,0,17535,7.2,19338,236,60,1782,2856,23.6,1753.5,5,9,6,1,1,0,0,15753,6.8,16482,207,40,-1782,-2856,20.7,1575.3,red,2.6,1.22,25,15,red
4495400346,9,11,10,0,0,0,0,17645,7,18506,201,44,-177,-308,20.1,1764.5,11,9,11,1,1,0,0,17822,7.4,18814,206,51,177,308,20.6,1782.2,red,1.73,2.44,36,16,blue
4520601060,7,15,6,0,0,0,0,16523,7,17836,219,38,-2692,-2753,21.9,1652.3,15,7,12,1,1,0,0,19215,7.6,20589,176,61,2692,2753,17.6,1921.5,red,0.87,3.86,79,17,red
4460980858,4,7,4,0,0,0,0,14630,6.4,16426,188,59,-1976,-2992,18.8,1463,7,4,7,1,1,0,0,16606,7.4,19418,230,49,1976,2992,23,1660.6,red,1.14,3.5,18,20,red
4526553053,9,8,9,1,1,0,0,17617,7,18621,245,42,-642,311,24.5,1761.7,8,9,11,0,0,0,0,18259,6.8,18310,236,44,642,-311,23.6,1825.9,red,2.25,2.11,35,36,red
4526299418,7,11,10,1,0,1,1,18142,6.8,16864,209,43,1051,-1411,20.9,1814.2,11,7,8,1,1,0,0,17091,7.2,18275,183,48,-1051,1411,18.3,1709.1,red,1.55,2.71,17,23,blue
4518341446,4,2,6,0,0,0,0,16068,6.6,17607,235,52,932,-534,23.5,1606.8,2,4,2,0,0,0,0,15136,7,18141,241,58,-932,534,24.1,1513.6,blue,5,1,23,22,blue
4526126466,5,6,5,1,0,1,1,18041,7,17904,229,52,1197,-947,22.9,1804.1,6,5,7,1,1,0,0,16844,7.4,18851,224,58,-1197,947,22.4,1684.4,red,1.67,2.6,15,24,blue
4470078931,11,4,11,1,0,1,0,17583,7.2,18536,223,47,2858,2734,22.3,1758.3,4,11,2,0,0,0,0,14725,6.4,15802,190,44,-2858,-2734,19,1472.5,blue,5.5,0.55,16,13,blue
4498832228,4,4,4,1,0,1,0,15381,6.8,17303,198,56,202,686,19.8,1538.1,4,4,6,0,0,0,0,15179,6.6,16617,214,38,-202,-686,21.4,1517.9,blue,2,2.5,19,18,red
4484423915,3,4,4,1,1,0,0,15929,7,17996,236,62,-688,-1113,23.6,1592.9,4,3,4,0,0,0,0,16617,7.2,19109,269,57,688,1113,26.9,1661.7,red,1.75,2.67,19,23,blue
4486550579,13,5,13,1,1,0,1,21132,7.6,19941,217,56,6289,3996,21.7,2113.2,5,13,6,0,0,0,0,14843,6.4,15945,179,32,-6289,-3996,17.9,1484.3,blue,5.2,0.85,20,18,blue
4486714617,1,8,1,0,0,0,0,14022,6.8,16586,223,59,-4075,-3154,22.3,1402.2,8,1,7,2,1,1,1,18097,7.2,19740,211,60,4075,3154,21.1,1809.7,red,0.25,15,23,17,red
4514848856,8,3,7,1,1,0,0,16786,7,18389,250,32,651,2427,25,1678.6,3,8,3,1,0,1,1,16135,6.4,15962,201,69,-651,-2427,20.1,1613.5,red,5,0.75,17,20,red
4459961160,6,11,8,0,0,0,0,17171,6.8,18333,254,32,-1882,-1917,25.4,1717.1,11,6,6,2,1,1,0,19053,7.6,20250,218,60,1882,1917,21.8,1905.3,red,1.27,2.83,27,34,red
4475087620,6,6,6,1,1,0,0,16004,7,18381,216,38,-695,-683,21.6,1600.4,6,6,6,0,0,0,0,16699,7,19064,240,52,695,683,24,1669.9,blue,2,2,21,18,blue
4520814737,4,3,4,1,0,1,0,16043,7,18432,237,48,711,1614,23.7,1604.3,3,4,5,1,1,0,0,15332,6.8,16818,209,48,-711,-1614,20.9,1533.2,red,2.67,2,18,15,red
4468841659,7,7,5,1,1,0,0,15720,6.8,17797,185,44,-325,-231,18.5,1572,7,7,4,0,0,0,0,16045,7,18028,200,44,325,231,20,1604.5,red,1.71,1.57,15,89,red
4452056525,3,4,2,1,1,0,0,14451,6.6,16951,213,42,-341,-1582,21.3,1445.1,4,3,3,0,0,0,0,14792,7.2,18533,231,38,341,1582,23.1,1479.2,red,1.25,2.33,15,15,blue
4448615908,5,4,2,2,1,1,0,15551,6.6,17239,209,52,-284,-260,20.9,1555.1,4,5,5,0,0,0,0,15835,6.8,17499,228,51,284,260,22.8,1583.5,blue,1.75,1.8,154,19,red
4470453534,5,8,5,0,0,0,0,16574,6.8,18040,231,48,-37,-382,23.1,1657.4,8,5,10,0,0,0,0,16611,7,18422,209,50,37,382,20.9,1661.1,red,1.25,3.6,17,14,blue
4526431738,3,8,3,0,0,0,0,14264,6.2,15870,201,28,-2234,-2021,20.1,1426.4,8,3,6,1,1,0,0,16498,6.8,17891,204,56,2234,2021,20.4,1649.8,red,0.75,4.67,16,18,red
4483729967,3,4,6,0,0,0,0,15223,6.8,17157,217,56,-299,-238,21.7,1522.3,4,3,7,1,1,0,0,15522,6.8,17395,203,72,299,238,20.3,1552.2,blue,2.25,3.67,14,28,blue
4454688114,2,9,2,0,0,0,0,14366,6.6,16510,221,55,-3046,-1990,22.1,1436.6,9,2,15,1,1,0,0,17412,7.2,18500,222,44,3046,1990,22.2,1741.2,red,0.44,12,21,25,red
4489934544,6,8,4,1,0,1,0,16860,7.2,19037,239,51,-259,357,23.9,1686,8,6,6,0,0,0,0,17119,7.2,18680,238,49,259,-357,23.8,1711.9,red,1.25,2.33,19,17,red
4524898336,9,4,10,1,0,1,0,17791,7.2,19229,219,48,2095,1876,21.9,1779.1,4,9,8,1,1,0,0,15696,7,17353,214,62,-2095,-1876,21.4,1569.6,blue,4.75,1.33,12,13,blue
4491022192,8,1,8,1,0,1,0,18066,7,18920,242,56,4597,3583,24.2,1806.6,1,8,1,1,1,0,0,13469,6.4,15337,189,52,-4597,-3583,18.9,1346.9,blue,16,0.25,14,16,blue
4467974505,11,6,13,0,0,0,0,20245,7.6,21086,240,49,4151,3492,24,2024.5,6,11,9,0,0,0,0,16094,7,17594,171,55,-4151,-3492,17.1,1609.4,blue,4,1.36,16,35,blue
4502961112,5,5,6,0,0,0,0,15413,6.4,16314,210,36,-3,-765,21,1541.3,5,5,4,0,0,0,0,15416,6.6,17079,221,47,3,765,22.1,1541.6,blue,2.2,1.8,19,18,red
4477353285,5,2,1,0,0,0,0,15510,7,17649,203,48,1215,1170,20.3,1551,2,5,2,1,1,0,0,14295,6.6,16479,244,48,-1215,-1170,24.4,1429.5,blue,3,0.8,15,13,blue
4465323789,5,11,8,1,1,0,0,15838,7,17892,236,33,-2279,-2155,23.6,1583.8,11,5,7,0,0,0,0,18117,7.4,20047,235,52,2279,2155,23.5,1811.7,red,1.18,3.6,20,22,red
4478467708,4,3,2,1,1,0,0,16029,7.4,19239,236,71,771,1255,23.6,1602.9,3,4,3,1,0,1,0,15258,7,17984,208,64,-771,-1255,20.8,1525.8,blue,2,1.5,22,18,blue
4444956835,2,3,2,1,1,0,0,14506,7.2,17908,230,63,-1288,-685,23,1450.6,3,2,5,0,0,0,0,15794,7,18593,217,57,1288,685,21.7,1579.4,red,1.33,4,42,19,red
4446060203,5,7,7,0,0,0,0,15293,6.4,15389,202,44,-4408,-4522,20.2,1529.3,7,5,2,2,1,1,2,19701,7.4,19911,250,72,4408,4522,25,1970.1,red,1.71,1.8,17,14,red
4524545264,3,10,2,0,0,0,0,14796,6.4,16448,204,53,-3385,-2980,20.4,1479.6,10,3,10,2,1,1,0,18181,7.4,19428,223,56,3385,2980,22.3,1818.1,red,0.5,6.67,27,18,red
4477261749,1,4,1,2,1,1,0,14142,6.8,16922,229,52,-1691,-1608,22.9,1414.2,4,1,4,0,0,0,0,15833,7,18530,234,59,1691,1608,23.4,1583.3,red,0.5,8,19,26,red
4504379351,5,2,2,0,0,0,0,15890,7,18495,232,51,995,707,23.2,1589,2,5,4,1,1,0,0,14895,6.8,17788,219,60,-995,-707,21.9,1489.5,red,3.5,1.2,21,19,blue
4526438582,8,1,15,1,1,0,0,17040,6.8,18270,191,60,2402,2023,19.1,1704,1,8,1,0,0,0,0,14638,6.6,16247,228,40,-2402,-2023,22.8,1463.8,blue,23,0.25,14,17,red
4458991310,6,6,5,1,1,0,0,16196,7.2,18801,214,52,-25,954,21.4,1619.6,6,6,8,0,0,0,0,16221,6.8,17847,217,32,25,-954,21.7,1622.1,red,1.83,2.33,19,15,blue
4524151765,8,5,5,1,1,0,0,16373,7,18169,188,47,1221,494,18.8,1637.3,5,8,4,0,0,0,0,15152,7,17675,209,40,-1221,-494,20.9,1515.2,red,2.6,1.12,15,13,blue
4477228841,10,5,11,0,0,0,0,17505,6.8,17635,224,43,1841,-591,22.4,1750.5,5,10,2,1,1,0,0,15664,6.8,18226,197,88,-1841,591,19.7,1566.4,red,4.2,0.7,19,51,red
4521908299,11,1,8,2,1,1,0,18635,7.2,19958,230,64,4368,3523,23,1863.5,1,11,0,0,0,0,0,14267,6.6,16435,208,64,-4368,-3523,20.8,1426.7,blue,19,0.09,16,16,blue
4527355531,6,3,5,2,1,1,0,16807,7.2,19662,232,60,2052,2845,23.2,1680.7,3,6,1,0,0,0,0,14755,6.8,16817,216,48,-2052,-2845,21.6,1475.5,red,3.67,0.67,14,76,red
4489963680,8,11,12,1,0,1,0,16842,6.4,16280,210,28,-1725,-2264,21,1684.2,11,8,13,1,1,0,0,18567,7,18544,192,56,1725,2264,19.2,1856.7,red,1.82,3,80,40,blue
4497469413,8,6,8,0,0,0,0,16963,6.8,17360,203,56,1479,1002,20.3,1696.3,6,8,10,1,1,0,0,15484,6.6,16358,173,56,-1479,-1002,17.3,1548.4,blue,2.67,2,17,17,red
4468744263,7,6,11,0,0,0,0,16587,6.8,17801,216,44,-674,909,21.6,1658.7,6,7,8,0,0,0,0,17261,6.6,16892,219,34,674,-909,21.9,1726.1,red,3,2,26,26,red
4521659923,8,3,8,1,1,0,0,18404,7.4,19768,245,60,3993,2165,24.5,1840.4,3,8,6,0,0,0,0,14411,7.2,17603,188,44,-3993,-2165,18.8,1441.1,blue,5.33,1.12,14,64,blue
4525946644,4,8,5,1,1,0,0,15901,7,18666,245,60,-2522,-1763,24.5,1590.1,8,4,7,0,0,0,0,18423,7.6,20429,250,68,2522,1763,25,1842.3,red,1.12,3.75,19,14,red
4456030501,9,4,11,1,0,1,0,17495,7,19239,235,44,1858,1429,23.5,1749.5,4,9,3,1,1,0,0,15637,6.8,17810,215,52,-1858,-1429,21.5,1563.7,blue,5,0.78,16,39,blue
4498606360,4,3,7,1,1,0,0,14891,6.6,17103,210,44,-996,-1894,21,1489.1,3,4,3,0,0,0,0,15887,7,18997,261,60,996,1894,26.1,1588.7,red,3.67,1.5,23,18,red
4486227010,6,6,3,0,0,0,0,16072,7,18312,229,40,-346,316,22.9,1607.2,6,6,6,1,1,0,0,16418,6.8,17996,241,43,346,-316,24.1,1641.8,blue,1.5,2,15,16,red
4467692885,5,7,4,0,0,0,0,15460,6.6,16868,184,56,-1946,-1148,18.4,1546,7,5,8,0,0,0,0,17406,7,18016,250,59,1946,1148,25,1740.6,red,1.29,3,18,17,red
4499693409,8,11,9,0,0,0,0,16708,7,17428,193,38,-775,-412,19.3,1670.8,11,8,8,0,0,0,0,17483,7,17840,178,44,775,412,17.8,1748.3,red,1.55,2.38,58,19,blue
4473252626,12,13,15,1,0,1,0,18275,6.6,17102,173,39,-1963,-1936,17.3,1827.5,13,12,20,1,1,0,0,20238,7.2,19038,214,49,1963,1936,21.4,2023.8,blue,2.08,2.75,22,24,blue
4447674252,2,9,2,0,0,0,0,13785,6.4,15847,195,44,-6199,-4997,19.5,1378.5,9,2,6,1,0,1,2,19984,7.6,20844,249,57,6199,4997,24.9,1998.4,red,0.44,7.5,13,33,red
4456481303,11,13,11,0,0,0,0,18596,7.6,20017,198,68,520,941,19.8,1859.6,13,11,9,0,0,0,0,18076,7.2,19076,207,40,-520,-941,20.7,1807.6,blue,1.69,2,33,19,red
4446053181,5,6,8,0,0,0,0,15964,6.8,17988,206,65,-243,860,20.6,1596.4,6,5,8,2,1,1,0,16207,6.6,17128,205,43,243,-860,20.5,1620.7,blue,2.17,2.8,17,19,red
4506258913,8,4,11,0,0,0,0,18343,6.8,18609,246,56,3314,2262,24.6,1834.3,4,8,4,0,0,0,0,15029,6.6,16347,204,36,-3314,-2262,20.4,1502.9,blue,4.75,1,15,16,blue
4484391297,4,4,0,1,0,1,1,17079,7.4,19361,250,66,1680,2384,25,1707.9,4,4,3,0,0,0,0,15399,6.6,16977,200,62,-1680,-2384,20,1539.9,blue,1,1.75,15,52,red
4469933897,13,5,11,2,1,1,0,19639,7.2,19564,239,56,5025,3609,23.9,1963.9,5,13,8,0,0,0,0,14614,6.4,15955,147,52,-5025,-3609,14.7,1461.4,blue,4.8,1,21,16,blue
4446121207,12,6,19,0,0,0,1,20560,7.4,19784,216,52,4426,2385,21.6,2056,6,12,6,0,0,0,0,16134,6.6,17399,206,60,-4426,-2385,20.6,1613.4,blue,5.17,1,43,18,blue
4495044073,4,7,5,0,0,0,0,15013,6.6,16013,210,41,-1937,-1459,21,1501.3,7,4,10,1,0,1,0,16950,6.8,17472,197,52,1937,1459,19.7,1695,blue,1.29,4.25,17,14,red
4510437554,6,3,5,0,0,0,0,15846,6.8,18039,201,62,1481,996,20.1,1584.6,3,6,2,0,0,0,0,14365,7,17043,208,39,-1481,-996,20.8,1436.5,red,3.67,0.83,104,18,red
4521020562,3,10,6,0,0,0,0,15018,6.4,15571,192,36,-3643,-3628,19.2,1501.8,10,3,18,1,1,0,0,18661,7,19199,220,55,3643,3628,22,1866.1,red,0.9,9.33,51,44,red
4479756200,6,10,4,0,0,0,0,16123,6.6,16738,194,49,-2240,-1945,19.4,1612.3,10,6,13,0,0,0,0,18363,6.8,18683,223,52,2240,1945,22.3,1836.3,red,1,3.83,18,19,blue
4456261396,8,3,8,1,1,0,0,17166,7.4,20100,208,63,2027,2259,20.8,1716.6,3,8,1,0,0,0,0,15139,6.8,17841,218,48,-2027,-2259,21.8,1513.9,blue,5.33,0.5,72,17,blue
4526718003,3,9,3,1,1,0,0,15431,6.8,17257,237,48,-2844,-2533,23.7,1543.1,9,3,11,0,0,0,0,18275,7.2,19790,221,44,2844,2533,22.1,1827.5,blue,0.67,6.67,14,38,red
4476906757,2,2,1,0,0,0,0,14814,7,18414,233,60,500,1220,23.3,1481.4,2,2,5,1,0,1,0,14314,6.8,17194,213,48,-500,-1220,21.3,1431.4,blue,1.5,3.5,28,25,blue
4509016746,9,12,9,0,0,0,0,17554,7.4,19237,243,46,-315,-293,24.3,1755.4,12,9,7,0,0,0,0,17869,7.4,19530,179,50,315,293,17.9,1786.9,red,1.5,2.11,20,16,red
4467390349,4,10,4,0,0,0,0,14450,6.4,16178,191,44,-4625,-3193,19.1,1445,10,4,11,0,0,0,0,19075,7.2,19371,236,53,4625,3193,23.6,1907.5,red,0.8,5.25,20,19,blue
4527418646,6,8,8,0,0,0,0,15193,6.4,16021,199,45,-2162,-1230,19.9,1519.3,8,6,11,1,1,0,0,17355,6.6,17251,205,45,2162,1230,20.5,1735.5,red,1.75,3.17,15,15,red
4470434724,10,5,6,0,0,0,0,19140,7.4,20293,257,72,4170,4481,25.7,1914,5,10,3,0,0,0,0,14970,6.4,15812,171,60,-4170,-4481,17.1,1497,blue,3.2,0.8,15,12,red
4483754983,6,6,8,1,1,0,0,16388,6.8,17884,236,40,-473,-1354,23.6,1638.8,6,6,9,0,0,0,0,16861,7.4,19238,235,69,473,1354,23.5,1686.1,blue,2.33,2.5,17,21,blue
4453231890,11,5,9,2,1,1,0,18532,7.6,19666,202,68,3248,2592,20.2,1853.2,5,11,6,0,0,0,0,15284,6.6,17074,164,57,-3248,-2592,16.4,1528.4,blue,4,1,20,19,blue
4459925036,2,14,3,0,0,0,0,14332,6.4,15949,219,51,-5624,-4155,21.9,1433.2,14,2,19,1,1,0,0,19956,7.4,20104,226,49,5624,4155,22.6,1995.6,red,0.36,16.5,16,21,red
4484094550,2,6,5,1,1,0,0,14697,6.8,17577,230,56,-1769,-587,23,1469.7,6,2,6,0,0,0,0,16466,7,18164,254,40,1769,587,25.4,1646.6,red,1.17,6,22,23,red
4496346599,6,8,9,1,1,0,0,15731,6.8,17396,236,37,-2238,-1138,23.6,1573.1,8,6,8,0,0,0,0,17969,7.2,18534,235,65,2238,1138,23.5,1796.9,red,1.88,2.67,22,19,red
4527203867,1,10,0,0,0,0,0,13881,6.6,16578,215,55,-3756,-1406,21.5,1388.1,10,1,10,1,1,0,0,17637,7.2,17984,184,40,3756,1406,18.4,1763.7,red,0.1,20,20,43,red
4484049712,7,8,7,0,0,0,0,15857,6.6,16404,177,52,-2314,-1903,17.7,1585.7,8,7,8,2,1,1,0,18171,6.8,18307,203,48,2314,1903,20.3,1817.1,red,1.75,2.29,108,19,blue
4515287778,4,6,4,0,0,0,0,16131,7,17990,242,57,-207,-1282,24.2,1613.1,6,4,3,1,0,1,0,16338,7.2,19272,223,65,207,1282,22.3,1633.8,blue,1.33,2.25,18,19,blue
4447986050,11,8,12,1,1,0,0,19349,7.2,19673,219,51,2445,1807,21.9,1934.9,8,11,10,0,0,0,0,16904,6.8,17866,194,48,-2445,-1807,19.4,1690.4,blue,2.88,1.64,26,17,blue
4492190443,6,4,11,0,0,0,0,16731,7,17558,239,49,2073,2090,23.9,1673.1,4,6,4,0,0,0,0,14658,6.4,15468,203,38,-2073,-2090,20.3,1465.8,blue,4.25,1.33,18,19,blue
4444833318,8,4,10,0,0,0,0,18363,7.6,20591,250,56,2012,2314,25,1836.3,4,8,4,2,1,1,0,16351,7,18277,221,60,-2012,-2314,22.1,1635.1,blue,4.5,1,20,16,red
4480691713,5,7,4,0,0,0,0,15132,6.6,17149,196,44,-1740,-916,19.6,1513.2,7,5,8,1,1,0,0,16872,6.8,18065,230,56,1740,916,23,1687.2,red,1.29,3,18,23,red
4492254219,8,5,7,1,1,0,0,17393,7.2,19257,219,60,1959,2441,21.9,1739.3,5,8,7,0,0,0,0,15434,6.6,16816,212,43,-1959,-2441,21.2,1543.4,blue,3,1.5,21,21,red
4511665743,3,1,4,0,0,0,0,15615,6.8,18309,237,51,1471,187,23.7,1561.5,1,3,1,0,0,0,0,14144,6.8,18122,187,56,-1471,-187,18.7,1414.4,red,7,0.67,19,21,blue
4471439102,4,12,6,0,0,0,0,15358,6.6,16660,213,32,-3859,-2011,21.3,1535.8,12,4,10,1,1,0,0,19217,6.8,18671,216,56,3859,2011,21.6,1921.7,red,0.83,5.5,30,23,red
4494572826,1,5,1,0,0,0,0,13936,6.6,16231,235,45,-2566,-1797,23.5,1393.6,5,1,5,1,1,0,0,16502,7,18028,264,51,2566,1797,26.4,1650.2,red,0.4,10,43,17,red
4434247820,10,10,7,0,0,0,0,17047,7.2,18719,202,40,-1518,-1106,20.2,1704.7,10,10,5,1,1,0,0,18565,7.4,19825,256,47,1518,1106,25.6,1856.5,blue,1.7,1.5,17,20,red
4465614811,6,3,5,1,1,0,0,16350,7.2,18813,233,44,1387,702,23.3,1635,3,6,3,0,0,0,0,14963,6.8,18111,217,56,-1387,-702,21.7,1496.3,blue,3.67,1,19,15,blue
4525637223,6,6,5,1,1,0,0,16444,7,18703,207,60,370,726,20.7,1644.4,6,6,3,0,0,0,0,16074,6.8,17977,226,44,-370,-726,22.6,1607.4,blue,1.83,1.5,19,14,red
4471718204,17,4,20,1,1,0,1,21703,7.2,19827,202,48,7605,3993,20.2,2170.3,4,17,2,1,0,1,0,14098,6.4,15834,177,56,-7605,-3993,17.7,1409.8,blue,9.25,0.35,17,15,blue
4527458962,9,9,8,0,0,0,0,16526,6.6,17292,194,41,-609,-1011,19.4,1652.6,9,9,10,0,0,0,0,17135,7,18303,228,36,609,1011,22.8,1713.5,red,1.89,2.11,20,24,red
4479632045,2,3,2,0,0,0,0,14698,6.8,17544,208,69,-501,-1154,20.8,1469.8,3,2,2,1,1,0,0,15199,7.2,18698,227,59,501,1154,22.7,1519.9,red,1.33,2.5,21,39,blue
4469404175,4,5,5,0,0,0,0,15329,6.8,17425,210,59,-486,180,21,1532.9,5,4,9,1,1,0,0,15815,6.8,17245,218,48,486,-180,21.8,1581.5,blue,1.8,3.5,19,63,red
4527028383,3,6,0,1,1,0,0,14746,6.8,17610,206,56,-1108,-370,20.6,1474.6,6,3,6,0,0,0,0,15854,7,17980,210,52,1108,370,21,1585.4,red,0.5,4,95,17,blue
4516065991,4,4,5,0,0,0,0,15831,7.2,17839,247,55,-152,16,24.7,1583.1,4,4,6,0,0,0,0,15983,7,17823,243,40,152,-16,24.3,1598.3,red,2.25,2.5,24,41,red
4508216792,8,8,8,0,0,0,0,18575,7.2,18686,228,42,1501,274,22.8,1857.5,8,8,7,0,0,0,0,17074,7.2,18412,219,43,-1501,-274,21.9,1707.4,blue,2,1.88,16,17,red
4518346455,6,2,9,0,0,0,0,16803,7.4,19509,242,44,1829,1496,24.2,1680.3,2,6,2,1,1,0,0,14974,7,18013,239,48,-1829,-1496,23.9,1497.4,blue,7.5,0.67,16,16,blue
4525617953,5,7,4,1,1,0,0,16666,7.2,18258,236,64,-790,-741,23.6,1666.6,7,5,7,0,0,0,0,17456,7.2,18999,230,60,790,741,23,1745.6,red,1.29,2.8,17,33,blue
4527312388,10,9,10,1,1,0,0,18616,7.4,19395,213,76,1885,1082,21.3,1861.6,9,10,9,0,0,0,0,16731,7,18313,189,45,-1885,-1082,18.9,1673.1,blue,2.22,1.8,14,10,blue
4502366249,2,5,2,0,0,0,0,14939,6.4,16939,218,40,-1348,-2082,21.8,1493.9,5,2,4,1,0,1,0,16287,7.4,19021,250,52,1348,2082,25,1628.7,blue,0.8,4.5,16,17,blue
4526656386,8,6,8,0,0,0,0,16828,6.8,17628,227,42,-47,-888,22.7,1682.8,6,8,10,1,1,0,0,16875,7,18516,240,68,47,888,24,1687.5,blue,2.67,2,16,17,red
4526981145,4,7,5,0,0,0,0,15398,6.8,17243,213,56,-1091,-617,21.3,1539.8,7,4,5,2,1,1,0,16489,6.8,17860,222,59,1091,617,22.2,1648.9,red,1.29,3,31,15,red
4527002962,2,6,1,1,1,0,0,14087,6.4,16178,217,44,-1808,-1818,21.7,1408.7,6,2,7,0,0,0,0,15895,7.2,17996,183,50,1808,1818,18.3,1589.5,blue,0.5,6.5,24,20,red
4526307631,6,4,8,1,1,0,0,17081,7.2,18350,226,58,2061,924,22.6,1708.1,4,6,3,0,0,0,0,15020,6.8,17426,218,44,-2061,-924,21.8,1502,blue,3.5,1.17,16,20,red
4454458141,4,7,4,0,0,0,0,16216,7,17978,233,40,-872,-432,23.3,1621.6,7,4,8,1,0,1,0,17088,7,18410,213,53,872,432,21.3,1708.8,red,1.14,3.75,18,91,red
4526352878,9,11,16,0,0,0,0,17174,6.8,16698,186,33,-1682,-2102,18.6,1717.4,11,9,15,1,1,0,0,18856,7.2,18800,221,81,1682,2102,22.1,1885.6,blue,2.27,2.89,21,23,red
4526378809,8,8,7,0,0,0,0,17161,6.8,17805,227,28,-262,-1246,22.7,1716.1,8,8,10,1,1,0,0,17423,7,19051,202,72,262,1246,20.2,1742.3,red,1.88,2.25,26,20,blue
4526851644,12,4,13,0,0,0,0,18119,7,18951,198,48,4108,2927,19.8,1811.9,4,12,1,1,1,0,0,14011,6.4,16024,179,51,-4108,-2927,17.9,1401.1,blue,6.25,0.42,57,11,red
4464526673,5,11,4,0,0,0,0,15332,6.6,16368,187,52,-2398,-2326,18.7,1533.2,11,5,8,1,1,0,0,17730,7.2,18694,202,52,2398,2326,20.2,1773,red,0.82,3.8,18,18,blue
4525845524,5,4,10,0,0,0,0,16386,7.2,18530,218,56,-167,309,21.8,1638.6,4,5,3,1,0,1,0,16553,7,18221,230,49,167,-309,23,1655.3,red,3.75,1.4,16,13,red
4481963894,9,4,8,2,1,1,0,18591,7.4,20081,260,62,3105,2085,26,1859.1,4,9,5,0,0,0,0,15486,6.8,17996,208,70,-3105,-2085,20.8,1548.6,blue,4.25,1,43,39,blue
4492947311,6,8,8,1,0,1,0,16138,6.8,17626,178,52,-1208,-1365,17.8,1613.8,8,6,7,1,1,0,0,17346,7.2,18991,215,60,1208,1365,21.5,1734.6,red,1.75,2.5,41,23,blue
4520750598,7,2,3,1,1,0,1,18662,7.4,19321,255,66,4088,2662,25.5,1866.2,2,7,2,0,0,0,0,14574,6.6,16659,209,64,-4088,-2662,20.9,1457.4,blue,5,0.57,15,18,blue
4499919097,7,2,9,0,0,0,0,16454,7,18576,207,45,2042,1127,20.7,1645.4,2,7,1,0,0,0,0,14412,6.8,17449,195,72,-2042,-1127,19.5,1441.2,blue,8,0.43,20,17,red
4478754286,8,15,9,1,1,0,0,15797,6.2,15229,168,34,-4801,-5205,16.8,1579.7,15,8,14,0,0,0,0,20598,7.4,20434,219,50,4801,5205,21.9,2059.8,red,1.13,3.62,18,21,red
4455592163,6,5,7,1,1,0,0,16028,6.8,17147,220,45,192,-1312,22,1602.8,5,6,3,0,0,0,0,15836,7.2,18459,211,56,-192,1312,21.1,1583.6,blue,2.6,1.33,22,16,blue
4467275928,6,4,8,1,1,0,0,15142,6.2,14696,178,46,-566,-3406,17.8,1514.2,4,6,2,0,0,0,0,15708,7,18102,246,48,566,3406,24.6,1570.8,blue,3.5,1,20,20,blue
4458303184,7,4,8,2,1,1,0,16849,6.6,16993,205,38,1651,402,20.5,1684.9,4,7,7,0,0,0,0,15198,6.6,16591,207,42,-1651,-402,20.7,1519.8,blue,3.75,1.57,12,20,blue
4525380642,15,7,13,1,0,1,0,20066,7.2,19018,209,40,4646,3861,20.9,2006.6,7,15,7,0,0,0,0,15420,6,15157,193,33,-4646,-3861,19.3,1542,red,4,0.93,18,20,red
4524796098,2,3,0,0,0,0,0,14312,6.8,17694,216,52,-980,-684,21.6,1431.2,3,2,0,0,0,0,0,15292,7,18378,236,52,980,684,23.6,1529.2,red,0.67,1.5,44,20,blue
4526727773,5,1,7,0,0,0,0,16786,7.4,19003,260,44,2264,1130,26,1678.6,1,5,1,2,1,1,0,14522,6.8,17873,247,61,-2264,-1130,24.7,1452.2,blue,12,0.4,14,17,blue
4512265608,2,5,1,1,1,0,0,14299,6.8,17111,211,47,-1673,-787,21.1,1429.9,5,2,8,0,0,0,0,15972,7,17898,228,40,1673,787,22.8,1597.2,red,0.6,6.5,23,21,red
4526993807,8,6,14,0,0,0,0,15724,6.2,15396,203,28,-866,-2133,20.3,1572.4,6,8,5,1,0,1,0,16590,7,17529,198,51,866,2133,19.8,1659,red,3.67,1.38,17,24,blue
4526227889,2,5,1,0,0,0,0,14828,7.2,18224,234,60,-1402,-90,23.4,1482.8,5,2,10,1,1,0,0,16230,7.2,18314,230,65,1402,90,23,1623,blue,0.6,7.5,19,17,red
4527225150,8,6,8,2,1,1,0,16294,6.6,17550,186,44,-445,-293,18.6,1629.4,6,8,6,0,0,0,0,16739,6.8,17843,193,58,445,293,19.3,1673.9,blue,2.67,1.5,41,91,red
4471157611,4,5,4,0,0,0,0,15761,7,17783,230,59,-802,-1243,23,1576.1,5,4,5,0,0,0,0,16563,7.4,19026,247,54,802,1243,24.7,1656.3,blue,1.6,2.5,17,19,red
4520606838,4,3,7,0,0,0,0,14565,6.4,16719,192,42,179,-417,19.2,1456.5,3,4,2,1,1,0,0,14386,6.6,17136,199,58,-179,417,19.9,1438.6,red,3.67,1.25,58,16,blue
4514076419,4,3,7,0,0,0,0,15711,7,17395,223,59,886,706,22.3,1571.1,3,4,4,1,1,0,0,14825,6.8,16689,225,40,-886,-706,22.5,1482.5,blue,3.67,1.75,21,21,blue
4475316564,7,2,2,1,1,0,0,16116,7.2,19219,246,49,1409,2205,24.6,1611.6,2,7,2,0,0,0,0,14707,6.8,17014,203,51,-1409,-2205,20.3,1470.7,blue,4.5,0.57,17,19,blue
4526554592,4,10,8,0,0,0,0,14629,6.8,16283,183,52,-3259,-1518,18.3,1462.9,10,4,16,2,1,1,0,17888,7,17801,210,40,3259,1518,21,1788.8,blue,1.2,6.5,18,18,red
4521263272,4,3,5,1,1,0,0,15694,6.8,17914,219,52,1074,237,21.9,1569.4,3,4,2,0,0,0,0,14620,6.8,17677,210,48,-1074,-237,21,1462,red,3,1.25,27,59,blue
4468376648,7,6,6,0,0,0,0,17041,7.4,18750,232,52,1016,2078,23.2,1704.1,6,7,7,1,1,0,0,16025,6.6,16672,211,38,-1016,-2078,21.1,1602.5,red,2.17,1.86,24,61,red
4519380029,3,5,3,0,0,0,0,15478,7,18118,214,60,-697,-1133,21.4,1547.8,5,3,4,2,1,1,0,16175,7.2,19251,244,62,697,1133,24.4,1617.5,red,1.2,3,16,17,red
4526974139,7,7,9,0,0,0,0,16956,7,18267,229,28,399,1148,22.9,1695.6,7,7,12,2,1,1,0,16557,6.8,17119,187,55,-399,-1148,18.7,1655.7,red,2.29,2.71,14,16,blue
4511067003,4,10,2,0,0,0,0,16956,7.2,19562,252,81,-387,1466,25.2,1695.6,10,4,11,1,1,0,0,17343,7,18096,236,44,387,-1466,23.6,1734.3,blue,0.6,5.25,16,18,red
4518362407,11,5,5,2,1,1,1,19172,7,18959,242,52,3456,3233,24.2,1917.2,5,11,5,0,0,0,0,15716,6.4,15726,197,52,-3456,-3233,19.7,1571.6,blue,3.2,0.91,18,23,blue
4472113530,8,5,5,0,0,0,0,16979,7.2,18700,213,48,1486,991,21.3,1697.9,5,8,3,0,0,0,0,15493,7,17709,200,46,-1486,-991,20,1549.3,blue,2.6,1,13,14,blue
4505140854,2,6,3,0,0,0,0,14806,6.8,17653,211,66,-2194,-1240,21.1,1480.6,6,2,7,1,1,0,0,17000,7,18893,247,44,2194,1240,24.7,1700,red,0.83,6.5,85,25,red
4454750369,7,10,9,1,1,0,1,18244,7,18223,205,60,-173,-989,20.5,1824.4,10,7,9,0,0,0,0,18417,7,19212,210,52,173,989,21,1841.7,red,1.6,2.71,38,14,red
4523653027,5,4,7,0,0,0,0,16989,7,18031,256,60,2000,1065,25.6,1698.9,4,5,7,1,1,0,0,14989,6.8,16966,206,51,-2000,-1065,20.6,1498.9,blue,3,2.2,22,20,blue
4496865743,3,15,3,0,0,0,0,14281,6.2,13851,183,28,-7666,-5484,18.3,1428.1,15,3,15,1,0,1,1,21947,7.2,19335,231,80,7666,5484,23.1,2194.7,red,0.4,10,19,19,red
4499779252,2,0,2,0,0,0,0,15393,6.8,17028,230,47,1875,1361,23,1539.3,0,2,0,0,0,0,0,13518,6.4,15667,215,60,-1875,-1361,21.5,1351.8,blue,12.03,0,61,19,blue
4450881054,8,3,9,1,1,0,0,17636,7.4,19295,249,51,2578,1160,24.9,1763.6,3,8,1,1,0,1,0,15058,7,18135,232,56,-2578,-1160,23.2,1505.8,blue,5.67,0.5,20,16,blue
4527413086,6,9,10,0,0,0,0,16600,6.8,17594,213,56,-629,-1232,21.3,1660,9,6,10,0,0,0,0,17229,7,18826,203,33,629,1232,20.3,1722.9,blue,1.78,3.17,54,27,red
4510149205,7,6,10,0,0,0,0,15889,7,18326,228,32,-1253,17,22.8,1588.9,6,7,7,0,0,0,0,17142,7,18309,225,44,1253,-17,22.5,1714.2,red,2.83,1.86,16,19,blue
4514173446,13,8,10,0,0,0,0,19657,7,18537,204,44,1675,-423,20.4,1965.7,8,13,9,1,1,0,0,17982,7.2,18960,202,64,-1675,423,20.2,1798.2,red,2.88,1.31,21,16,blue
4522592356,8,3,5,0,0,0,0,16818,7,18454,231,45,3138,2806,23.1,1681.8,3,8,0,2,1,1,0,13680,6.4,15648,196,51,-3138,-2806,19.6,1368,blue,4.33,0.38,23,17,blue
4464807345,8,3,6,2,1,1,0,17415,7.2,19432,246,48,2148,1502,24.6,1741.5,3,8,1,0,0,0,0,15267,6.8,17930,212,64,-2148,-1502,21.2,1526.7,blue,4.67,0.5,19,16,blue
4519189625,6,1,7,0,0,0,0,16602,7.2,19275,246,54,2919,2298,24.6,1660.2,1,6,0,0,0,0,0,13683,6.6,16977,214,41,-2919,-2298,21.4,1368.3,blue,13,0.17,16,13,blue
4508113644,7,15,13,0,0,0,0,17181,7,18481,184,47,-2692,-1609,18.4,1718.1,15,7,20,1,1,0,0,19873,7.4,20090,191,34,2692,1609,19.1,1987.3,red,1.33,5,41,58,blue
4526805303,7,7,6,1,0,1,0,16492,6.6,16905,202,32,-499,-295,20.2,1649.2,7,7,10,1,1,0,0,16991,6.8,17200,220,56,499,295,22,1699.1,blue,1.86,2.43,21,17,blue
4490068433,4,6,6,1,1,0,0,16410,6.8,18121,236,60,75,644,23.6,1641,6,4,7,0,0,0,0,16335,7,17477,201,58,-75,-644,20.1,1633.5,red,1.67,3.25,21,21,blue
4521454203,3,5,5,0,0,0,0,15238,6.8,16831,209,40,-1314,-1498,20.9,1523.8,5,3,6,0,0,0,0,16552,6.8,18329,226,63,1314,1498,22.6,1655.2,red,1.6,3.67,58,18,red
4527314623,16,7,18,1,1,0,0,20271,7.2,19487,200,47,3243,1919,20,2027.1,7,16,8,0,0,0,0,17028,6.8,17568,235,34,-3243,-1919,23.5,1702.8,blue,4.86,0.94,50,20,blue
4525314215,5,4,2,0,0,0,0,15372,7,17632,228,48,-443,-732,22.8,1537.2,4,5,3,0,0,0,0,15815,7.2,18364,237,56,443,732,23.7,1581.5,red,1.75,1.4,18,49,blue
4495034271,3,9,4,0,0,0,0,14930,6.6,16710,222,36,-1844,-1368,22.2,1493,9,3,9,1,1,0,0,16774,6.8,18078,212,36,1844,1368,21.2,1677.4,red,0.78,6,25,41,red
4500216445,8,7,10,0,0,0,0,17450,7.2,18989,236,52,270,638,23.6,1745,7,8,5,1,0,1,0,17180,6.8,18351,220,48,-270,-638,22,1718,blue,2.57,1.5,20,21,blue
4474939096,1,0,1,0,0,0,0,14812,6.6,17296,254,53,1221,-311,25.4,1481.2,0,1,0,1,1,0,0,13591,6.8,17607,214,60,-1221,311,21.4,1359.1,blue,12.03,0,19,40,blue
4525181648,9,5,10,0,0,0,0,17605,7.2,19074,241,40,1132,778,24.1,1760.5,5,9,5,0,0,0,0,16473,7,18296,219,59,-1132,-778,21.9,1647.3,red,3.8,1.11,15,85,red
4495708028,5,9,5,0,0,0,0,16841,6.8,17341,234,46,-1482,-724,23.4,1684.1,9,5,11,1,1,0,0,18323,7,18065,199,52,1482,724,19.9,1832.3,red,1.11,4,14,17,red
4521698665,5,3,8,2,1,1,0,16321,7,18143,249,52,1151,-108,24.9,1632.1,3,5,4,0,0,0,0,15170,7,18251,218,47,-1151,108,21.8,1517,blue,4.33,1.4,24,18,blue
4512994331,5,8,7,1,0,1,0,16270,6.8,17716,230,53,-143,708,23,1627,8,5,8,1,1,0,0,16413,6.6,17008,206,42,143,-708,20.6,1641.3,blue,1.5,3.2,17,17,red
4526026089,7,5,5,1,1,0,0,15954,7,17461,191,54,305,-374,19.1,1595.4,5,7,9,0,0,0,0,15649,6.8,17835,234,41,-305,374,23.4,1564.9,blue,2.4,2,41,15,blue
4484294172,5,6,0,1,1,0,0,15682,7,18027,247,44,-438,-778,24.7,1568.2,6,5,6,0,0,0,0,16120,7,18805,206,51,438,778,20.6,1612,red,0.83,2.4,16,47,red
4518207092,5,11,6,0,0,0,0,16190,7,17466,215,59,-3531,-1781,21.5,1619,11,5,21,1,1,0,0,19721,7.2,19247,236,60,3531,1781,23.6,1972.1,red,1,6.4,23,23,red
4495787574,12,5,16,2,1,1,1,19572,7,18020,213,40,3987,1169,21.3,1957.2,5,12,6,0,0,0,0,15585,6.6,16851,193,40,-3987,-1169,19.3,1558.5,blue,5.6,0.92,17,15,red
4525317439,5,5,5,0,0,0,0,15930,6.8,17859,236,48,179,-962,23.6,1593,5,5,4,2,1,1,0,15751,7.2,18821,225,52,-179,962,22.5,1575.1,red,2,1.8,17,40,red
4473666102,1,10,1,0,0,0,0,13785,6.8,16211,215,43,-4124,-3090,21.5,1378.5,10,1,13,1,1,0,0,17909,7.2,19301,260,54,4124,3090,26,1790.9,red,0.2,23,16,19,red
4462822910,6,2,7,1,0,1,0,16898,7.2,19309,247,57,2927,3135,24.7,1689.8,2,6,2,0,0,0,0,13971,6.6,16174,212,49,-2927,-3135,21.2,1397.1,blue,6.5,0.67,19,19,blue
4484040931,7,7,5,2,1,1,0,18333,6.8,18853,229,64,1665,1578,22.9,1833.3,7,7,15,0,0,0,0,16668,6.8,17275,181,56,-1665,-1578,18.1,1666.8,blue,1.71,3.14,74,14,red
4526149121,1,6,1,1,1,0,0,14289,6.8,16754,220,56,-2946,-2952,22,1428.9,6,1,7,0,0,0,0,17235,7.2,19706,223,67,2946,2952,22.3,1723.5,red,0.33,13,15,18,red
4469941308,7,3,13,0,0,0,0,16501,7,18045,208,63,1440,1148,20.8,1650.1,3,7,2,0,0,0,0,15061,6.8,16897,258,42,-1440,-1148,25.8,1506.1,blue,6.67,0.71,14,20,blue
4459966924,5,1,5,0,0,0,0,16618,7.2,19643,250,52,2263,1451,25,1661.8,1,5,1,0,0,0,0,14355,6.8,18192,243,52,-2263,-1451,24.3,1435.5,blue,10,0.4,18,17,blue
4506726377,6,0,6,2,1,1,0,16557,7.2,18637,261,50,1878,703,26.1,1655.7,0,6,0,0,0,0,0,14679,7,17934,233,56,-1878,-703,23.3,1467.9,red,12.03,0,56,19,blue
4447641028,11,14,10,0,0,0,0,16978,5.6,13699,158,28,-4259,-3503,15.8,1697.8,14,11,21,1,0,1,2,21237,7,17202,203,34,4259,3503,20.3,2123.7,red,1.5,3.18,80,31,blue
4417369885,6,10,6,0,0,0,0,16577,6.6,16338,221,36,-1311,-1472,22.1,1657.7,10,6,12,1,1,0,0,17888,7,17810,169,72,1311,1472,16.9,1788.8,red,1.2,3.67,18,20,red
4495165878,4,9,2,0,0,0,0,14706,6.6,16463,195,44,-3856,-1959,19.5,1470.6,9,4,14,0,0,0,0,18562,7,18422,250,48,3856,1959,25,1856.2,red,0.67,5.75,19,33,blue
4514844404,7,9,8,0,0,0,0,16795,6.8,18170,217,52,-1317,-816,21.7,1679.5,9,7,14,1,1,0,0,18112,7.4,18986,247,51,1317,816,24.7,1811.2,red,1.67,3.29,19,18,red
4465219172,4,5,3,1,1,0,0,15288,7,18195,242,56,-1538,-320,24.2,1528.8,5,4,9,0,0,0,0,16826,7,18515,226,60,1538,320,22.6,1682.6,red,1.4,3.5,58,22,red
4527045215,5,6,5,2,1,1,0,14875,6.8,17019,194,48,-1641,-602,19.4,1487.5,6,5,5,0,0,0,0,16516,6.8,17621,217,44,1641,602,21.7,1651.6,blue,1.67,2.2,63,21,red
4458968842,7,10,6,1,0,1,0,16861,6.8,17932,184,35,-1255,-254,18.4,1686.1,10,7,10,0,0,0,0,18116,7.2,18186,195,48,1255,254,19.5,1811.6,blue,1.3,2.86,16,86,red
4461046174,9,10,8,1,1,0,0,17136,6.8,17077,203,34,-1154,-93,20.3,1713.6,10,9,13,0,0,0,0,18290,6.6,17170,189,64,1154,93,18.9,1829,red,1.7,2.56,16,17,blue
4507620786,8,7,10,1,1,0,0,17765,7.2,19108,242,52,2312,2522,24.2,1776.5,7,8,5,0,0,0,0,15453,6.6,16586,170,40,-2312,-2522,17,1545.3,blue,2.57,1.5,16,17,red
4474784540,3,10,1,0,0,0,0,14555,6.6,16626,200,52,-4431,-4570,20,1455.5,10,3,12,1,1,0,0,18986,7.6,21196,251,68,4431,4570,25.1,1898.6,red,0.4,7.33,51,90,blue
4519753896,2,10,2,1,1,0,0,14020,6.4,15872,203,55,-4215,-1902,20.3,1402,10,2,11,1,0,1,0,18235,6.8,17774,229,48,4215,1902,22.9,1823.5,red,0.4,10.5,20,18,red
4496724887,8,2,13,1,1,0,0,17575,7.2,18579,228,52,2658,1915,22.8,1757.5,2,8,2,0,0,0,0,14917,6.6,16664,211,50,-2658,-1915,21.1,1491.7,blue,10.5,0.5,28,21,blue
4513351199,5,8,3,1,1,0,0,15307,6.8,17610,227,56,-2576,-2182,22.7,1530.7,8,5,5,0,0,0,0,17883,7.4,19792,249,56,2576,2182,24.9,1788.3,red,1,2.6,20,19,red
4494806155,5,1,4,0,0,0,0,16751,7.2,19355,245,53,3029,1278,24.5,1675.1,1,5,1,1,1,0,0,13722,6.8,18077,189,66,-3029,-1278,18.9,1372.2,blue,9,0.4,23,13,blue
4527400010,7,5,10,0,0,0,0,16271,7,17500,218,40,787,846,21.8,1627.1,5,7,4,1,1,0,0,15484,6.8,16654,208,46,-787,-846,20.8,1548.4,blue,3.4,1.29,16,16,red
4519404652,7,6,6,0,0,0,0,16420,6.8,17929,209,55,-514,-1465,20.9,1642,6,7,9,1,1,0,0,16934,7.2,19394,236,68,514,1465,23.6,1693.4,red,2.17,2.14,23,39,blue
4435781298,6,6,4,0,0,0,0,15570,7,17682,180,49,-227,923,18,1557,6,6,5,1,1,0,0,15797,6.6,16759,227,36,227,-923,22.7,1579.7,blue,1.67,1.83,24,18,red
4527150511,3,3,1,0,0,0,0,14948,6.8,17612,218,48,-347,125,21.8,1494.8,3,3,2,0,0,0,0,15295,6.6,17487,204,52,347,-125,20.4,1529.5,red,1.33,1.67,19,19,red
4502743834,4,8,8,1,0,1,0,15167,6.4,15683,220,37,-1645,-1268,22,1516.7,8,4,17,0,0,0,0,16812,6.4,16951,198,44,1645,1268,19.8,1681.2,red,1.5,6.25,29,22,blue
4514249734,3,2,3,0,0,0,0,15484,6.8,18175,250,49,239,-709,25,1548.4,2,3,0,2,1,1,0,15245,7.2,18884,209,88,-239,709,20.9,1524.5,blue,3,0.67,14,14,red
4417621987,8,8,12,0,0,0,0,17856,6.8,18232,221,50,226,-955,22.1,1785.6,8,8,8,1,1,0,0,17630,7.2,19187,221,50,-226,955,22.1,1763,blue,2.5,2,23,13,blue
4498639695,3,7,5,0,0,0,0,14767,7,17485,212,68,-2150,-1486,21.2,1476.7,7,3,9,1,1,0,0,16917,7.2,18971,225,59,2150,1486,22.5,1691.7,red,1.14,5.33,18,14,red
4498399527,11,5,11,1,0,1,0,18474,7,18239,217,43,2680,1517,21.7,1847.4,5,11,4,0,0,0,0,15794,6.4,16722,219,51,-2680,-1517,21.9,1579.4,blue,4.4,0.82,22,18,blue
4470053265,0,3,0,0,0,0,0,14183,6.8,17942,243,64,-975,334,24.3,1418.3,3,0,5,1,1,0,0,15158,7,17608,206,48,975,-334,20.6,1515.8,red,0,12.65,17,17,red
4527122905,4,4,5,1,0,1,0,15971,7.2,18396,242,59,484,-614,24.2,1597.1,4,4,1,1,1,0,0,15487,7.2,19010,242,64,-484,614,24.2,1548.7,blue,2.25,1.25,18,22,blue
4490918171,2,9,0,0,0,0,0,14319,6.4,16192,210,56,-2914,-1623,21,1431.9,9,2,15,0,0,0,0,17233,6.8,17815,193,37,2914,1623,19.3,1723.3,red,0.22,12,19,76,red
4512833184,3,3,4,1,1,0,0,16206,7,18093,260,54,-795,-1185,26,1620.6,3,3,4,1,0,1,0,17001,7.2,19278,242,80,795,1185,24.2,1700.1,red,2.33,2.33,48,59,red
4470330490,5,3,5,1,1,0,0,15704,7.2,18000,213,59,1208,1363,21.3,1570.4,3,5,3,0,0,0,0,14496,6.8,16637,209,52,-1208,-1363,20.9,1449.6,red,3.33,1.2,45,23,blue
4463280330,9,9,6,1,1,0,0,18137,7,19154,218,62,201,1596,21.8,1813.7,9,9,14,0,0,0,0,17936,6.6,17558,197,61,-201,-1596,19.7,1793.6,blue,1.67,2.56,20,20,red
4504190601,2,9,2,0,0,0,0,14944,6.6,17675,239,47,-2695,-1275,23.9,1494.4,9,2,9,1,1,0,0,17639,7,18950,252,46,2695,1275,25.2,1763.9,red,0.44,9,23,17,red
4517670386,1,14,1,0,0,0,0,13172,6,14988,187,28,-7079,-4936,18.7,1317.2,14,1,21,1,1,0,0,20251,7.4,19924,222,63,7079,4936,22.2,2025.1,red,0.14,35,46,20,red
4521391433,9,6,11,1,1,0,0,18363,7.2,18844,220,52,2120,358,22,1836.3,6,9,5,0,0,0,0,16243,7,18486,215,56,-2120,-358,21.5,1624.3,red,3.33,1.22,17,17,blue
4523062555,4,8,2,0,0,0,0,15200,6.6,17118,228,49,-1806,-541,22.8,1520,8,4,10,0,0,0,0,17006,7,17659,224,49,1806,541,22.4,1700.6,red,0.75,4.5,17,20,red
4458733619,7,7,6,0,0,0,0,17315,7,18632,218,48,297,518,21.8,1731.5,7,7,11,0,0,0,0,17018,7,18114,221,46,-297,-518,22.1,1701.8,red,1.86,2.57,38,23,red
4502966435,4,4,1,1,0,1,0,16516,7.4,19168,259,60,1234,1855,25.9,1651.6,4,4,5,0,0,0,0,15282,6.8,17313,229,44,-1234,-1855,22.9,1528.2,blue,1.25,2.25,19,11,blue
4527093291,4,9,2,0,0,0,0,14010,6.4,15841,170,45,-3956,-2930,17,1401,9,4,9,1,1,0,0,17966,7,18771,207,62,3956,2930,20.7,1796.6,red,0.67,4.5,12,17,red
4505214335,4,7,4,0,0,0,0,15580,6.8,17701,205,52,-731,-118,20.5,1558,7,4,6,2,1,1,0,16311,6.8,17819,229,54,731,118,22.9,1631.1,red,1.14,3.25,15,14,blue
4474787155,7,2,7,1,0,1,0,17731,7.6,20617,238,80,3339,3179,23.8,1773.1,2,7,2,1,1,0,0,14392,6.8,17438,236,46,-3339,-3179,23.6,1439.2,blue,7,0.57,14,12,red
4526583162,9,3,13,1,1,0,0,19186,7.2,19737,261,52,4331,3427,26.1,1918.6,3,9,4,0,0,0,0,14855,6.4,16310,199,48,-4331,-3427,19.9,1485.5,blue,7.33,0.78,20,16,blue
4506026519,7,3,6,0,0,0,0,18135,7,19138,252,40,2275,1360,25.2,1813.5,3,7,3,0,0,0,0,15860,7,17778,212,72,-2275,-1360,21.2,1586,blue,4.33,0.86,20,20,blue
4455419098,7,9,4,0,0,0,0,15947,7,17802,204,56,-2086,-2017,20.4,1594.7,9,7,10,1,1,0,0,18033,7.2,19819,188,64,2086,2017,18.8,1803.3,red,1.22,2.71,19,22,blue
4517480470,10,16,11,1,1,0,0,16681,6.4,16014,168,35,-3637,-2456,16.8,1668.1,16,10,17,0,0,0,0,20318,7.2,18470,219,49,3637,2456,21.9,2031.8,red,1.31,3.3,15,23,red
4523038928,5,1,4,1,1,0,0,16733,7.2,19451,232,62,2685,2307,23.2,1673.3,1,5,2,0,0,0,0,14048,6.8,17144,207,63,-2685,-2307,20.7,1404.8,blue,9,0.6,15,21,blue
4477682436,4,9,4,0,0,0,0,15233,7,17625,220,44,-1121,-858,22,1523.3,9,4,6,1,1,0,0,16354,7,18483,210,40,1121,858,21,1635.4,blue,0.89,3.75,14,20,red
4524565861,7,0,7,0,0,0,0,18406,7.4,19320,247,56,4990,2055,24.7,1840.6,0,7,0,1,1,0,0,13416,6.8,17265,196,70,-4990,-2055,19.6,1341.6,blue,12.03,0,16,80,blue
4486380071,7,16,7,0,0,0,0,16711,6.4,15855,201,51,-3289,-4291,20.1,1671.1,16,7,17,1,0,1,0,20000,7.4,20146,201,49,3289,4291,20.1,2000,red,0.88,4.71,16,16,blue
4479922786,7,8,7,0,0,0,0,16093,6.4,16567,175,40,-1805,-2047,17.5,1609.3,8,7,9,1,1,0,0,17898,6.8,18614,238,48,1805,2047,23.8,1789.8,red,1.75,2.43,18,38,red
4495296529,3,3,2,0,0,0,0,15563,7.2,18747,252,42,446,429,25.2,1556.3,3,3,2,0,0,0,0,15117,6.8,18318,229,62,-446,-429,22.9,1511.7,blue,1.67,1.67,17,20,blue
4492085099,5,5,4,1,0,1,0,15745,6.8,17698,203,60,-859,361,20.3,1574.5,5,5,8,1,1,0,0,16604,6.8,17337,220,52,859,-361,22,1660.4,red,1.8,2.6,18,20,blue
4508010567,8,6,12,0,0,0,0,15958,6.6,17066,185,44,231,-184,18.5,1595.8,6,8,2,1,1,0,0,15727,6.8,17250,208,48,-231,184,20.8,1572.7,red,3.33,1,21,16,red
4524225995,9,5,12,1,1,0,0,17501,7,17203,195,45,3195,1056,19.5,1750.1,5,9,4,0,0,0,0,14306,6.4,16147,166,36,-3195,-1056,16.6,1430.6,blue,4.2,1,27,20,blue
4526275078,7,3,6,1,1,0,0,18038,7.2,19458,240,64,3973,3481,24,1803.8,3,7,1,0,0,0,0,14065,6.6,15977,195,48,-3973,-3481,19.5,1406.5,blue,4.33,0.57,19,15,red
4510818767,4,10,4,0,0,0,0,16256,6.8,17776,248,57,-2528,-2509,24.8,1625.6,10,4,15,2,1,1,0,18784,7.6,20285,221,58,2528,2509,22.1,1878.4,red,0.8,6.25,17,20,blue
4488597120,6,5,2,0,0,0,0,16589,7,18101,239,46,636,-419,23.9,1658.9,5,6,3,1,1,0,0,15953,7.2,18520,216,67,-636,419,21.6,1595.3,blue,1.6,1.33,17,53,red
4472940975,5,1,6,1,1,0,0,15258,7,18398,223,44,993,872,22.3,1525.8,1,5,1,0,0,0,0,14265,6.8,17526,225,59,-993,-872,22.5,1426.5,red,11,0.4,22,71,blue
4526284156,7,9,8,0,0,0,0,16481,7,17470,223,44,-246,-1064,22.3,1648.1,9,7,6,0,0,0,0,16727,7,18534,220,31,246,1064,22,1672.7,blue,1.67,2.14,20,12,red
4501534072,6,5,7,0,0,0,0,15913,7,17268,195,68,-125,-637,19.5,1591.3,5,6,7,1,1,0,0,16038,6.8,17905,232,48,125,637,23.2,1603.8,red,2.6,2,56,25,red
4514010744,4,2,3,1,1,0,0,16162,6.8,17887,257,52,1766,719,25.7,1616.2,2,4,3,0,0,0,0,14396,6.6,17168,215,48,-1766,-719,21.5,1439.6,blue,3.5,1.25,17,18,blue
4508174321,8,4,7,0,0,0,0,17264,7,18035,214,36,1811,875,21.4,1726.4,4,8,5,0,0,0,0,15453,6.6,17160,186,51,-1811,-875,18.6,1545.3,blue,3.75,1.12,43,16,blue
4446018252,7,7,8,1,1,0,0,16700,7,17519,241,40,-418,-1320,24.1,1670,7,7,9,0,0,0,0,17118,7,18839,224,48,418,1320,22.4,1711.8,red,2.14,2.29,23,19,blue
4513214208,7,8,10,0,0,0,0,16337,6.8,17367,197,47,-38,281,19.7,1633.7,8,7,4,1,1,0,0,16375,6.6,17086,192,43,38,-281,19.2,1637.5,red,2.12,1.71,45,19,red
4525996242,4,11,7,0,0,0,0,15790,6.8,17533,208,47,-2878,-1184,20.8,1579,11,4,13,0,0,0,0,18668,7,18717,234,44,2878,1184,23.4,1866.8,blue,1,6,40,34,red
4513138341,4,6,5,0,0,0,0,15970,7,17837,217,55,-703,-653,21.7,1597,6,4,6,1,1,0,0,16673,7.2,18490,221,52,703,653,22.1,1667.3,blue,1.5,3,16,25,red
4520994521,2,7,3,0,0,0,0,14933,7.2,18353,213,52,-1957,-354,21.3,1493.3,7,2,4,2,1,1,0,16890,7,18707,220,60,1957,354,22,1689,red,0.71,5.5,42,22,red
4483840254,9,6,8,2,1,1,0,18060,7.4,19784,241,52,1982,2243,24.1,1806,6,9,5,0,0,0,0,16078,6.6,17541,206,48,-1982,-2243,20.6,1607.8,blue,2.83,1.22,23,20,red
4457455707,4,8,5,0,0,0,0,14732,6.6,16524,208,35,-2642,-2116,20.8,1473.2,8,4,8,0,0,0,0,17374,7,18640,227,44,2642,2116,22.7,1737.4,red,1.12,4,16,34,red
4473463200,7,4,3,1,1,0,0,17121,7,18545,242,56,2393,725,24.2,1712.1,4,7,3,0,0,0,0,14728,7,17820,194,47,-2393,-725,19.4,1472.8,blue,2.5,1,21,30,blue
4506223983,11,7,9,1,1,0,0,18913,6.6,17351,229,38,3002,1582,22.9,1891.3,7,11,8,0,0,0,0,15911,6.4,15769,170,45,-3002,-1582,17,1591.1,blue,2.86,1.36,20,11,blue
4518849828,7,4,6,2,1,1,0,17237,7.2,18352,196,56,1346,849,19.6,1723.7,4,7,3,0,0,0,0,15891,6.8,17503,241,45,-1346,-849,24.1,1589.1,blue,3.25,1,14,19,blue
4458793394,1,11,1,0,0,0,0,13265,6.4,15753,195,52,-6200,-3576,19.5,1326.5,11,1,8,1,1,0,1,19465,7.2,19329,248,44,6200,3576,24.8,1946.5,red,0.18,19,20,21,red
4524969913,14,3,19,1,1,0,0,21020,7.6,21002,237,73,7166,4491,23.7,2102,3,14,6,0,0,0,0,13854,6.6,16511,193,40,-7166,-4491,19.3,1385.4,blue,11,0.64,15,17,blue
4475174876,7,3,11,0,0,0,0,17320,7,18039,210,44,2199,459,21,1732,3,7,4,0,0,0,0,15121,6.8,17580,234,49,-2199,-459,23.4,1512.1,red,6,1,22,16,blue
4477872277,6,8,8,1,1,0,0,15586,6.8,17198,199,45,-1022,-1301,19.9,1558.6,8,6,7,0,0,0,0,16608,6.8,18499,210,41,1022,1301,21,1660.8,blue,1.75,2.5,18,20,blue
4455474376,8,6,5,0,0,0,0,17208,7.6,20217,218,54,931,740,21.8,1720.8,6,8,5,0,0,0,0,16277,7.2,19477,209,56,-931,-740,20.9,1627.7,red,2.17,1.38,91,18,red
4518019885,0,9,0,0,0,0,0,13282,6.4,16226,194,60,-6225,-3975,19.4,1328.2,9,0,9,1,1,0,0,19507,7.4,20201,226,52,6225,3975,22.6,1950.7,red,0,12.65,16,14,red
4520985239,5,12,6,1,1,0,0,15555,6.6,17008,222,41,-3638,-3337,22.2,1555.5,12,5,13,0,0,0,0,19193,7.6,20345,227,56,3638,3337,22.7,1919.3,red,0.92,5,56,19,blue
4525324853,4,5,2,1,0,1,0,17008,7.2,19831,255,68,1903,4023,25.5,1700.8,5,4,12,1,1,0,0,15105,6.4,15808,182,52,-1903,-4023,18.2,1510.5,blue,1.2,4.25,39,25,red
4504703717,6,7,7,1,0,1,0,16050,6.8,17391,191,48,-513,-1056,19.1,1605,7,6,10,0,0,0,0,16563,6.8,18447,235,36,513,1056,23.5,1656.3,red,1.86,2.83,21,101,blue
4510904711,8,8,6,1,0,1,0,16830,7,18264,203,48,257,1183,20.3,1683,8,8,9,1,1,0,0,16573,7,17081,180,56,-257,-1183,18,1657.3,red,1.75,2.12,10,30,blue
4492423421,6,8,5,0,0,0,0,16370,6.8,17433,209,39,-633,-1089,20.9,1637,8,6,12,1,1,0,0,17003,7.2,18522,195,66,633,1089,19.5,1700.3,blue,1.38,3.33,11,15,blue
4458785938,3,9,3,0,0,0,0,14851,6.6,16367,183,66,-3151,-3729,18.3,1485.1,9,3,9,0,0,0,0,18002,7.4,20096,207,46,3151,3729,20.7,1800.2,red,0.67,6,13,16,red
4520732095,4,8,3,0,0,0,0,15325,6.8,17018,215,31,-1931,-1572,21.5,1532.5,8,4,16,1,1,0,0,17256,7.2,18590,220,52,1931,1572,22,1725.6,red,0.88,6,15,18,blue
4460077928,9,8,12,0,0,0,0,18385,7.4,19948,248,65,607,1293,24.8,1838.5,8,9,8,2,1,1,0,17778,7,18655,240,56,-607,-1293,24,1777.8,blue,2.62,1.78,21,22,blue
4518093689,2,7,0,0,0,0,0,14074,6.4,16376,203,43,-3510,-3014,20.3,1407.4,7,2,4,1,0,1,0,17584,7.2,19390,266,44,3510,3014,26.6,1758.4,red,0.29,5.5,15,16,red
4501370502,5,5,2,1,1,0,0,16299,7.2,18568,225,62,1063,-125,22.5,1629.9,5,5,3,0,0,0,0,15236,7,18693,202,57,-1063,125,20.2,1523.6,red,1.4,1.6,16,14,blue
4512954515,7,6,14,1,1,0,0,16644,6.8,17295,238,48,60,-325,23.8,1664.4,6,7,11,0,0,0,0,16584,6.8,17620,229,44,-60,325,22.9,1658.4,red,3.5,2.43,27,27,red
4519014512,6,5,8,2,1,1,0,16997,6.8,17893,215,46,639,-401,21.5,1699.7,5,6,6,0,0,0,0,16358,6.8,18294,220,58,-639,401,22,1635.8,red,2.8,1.83,18,17,blue
4522561277,3,2,1,0,0,0,0,15360,7,18355,220,55,960,39,22,1536,2,3,2,0,0,0,0,14400,6.8,18316,206,52,-960,-39,20.6,1440,red,2,1.33,17,19,blue
4458533375,7,1,6,1,1,0,0,17141,7,18486,230,36,3332,1330,23,1714.1,1,7,0,1,0,1,0,13809,6.8,17156,218,48,-3332,-1330,21.8,1380.9,blue,13,0.14,17,40,blue
4472632367,7,6,8,1,0,1,0,17882,7.2,19474,233,55,2689,1875,23.3,1788.2,6,7,5,0,0,0,0,15193,6.8,17599,218,32,-2689,-1875,21.8,1519.3,blue,2.5,1.57,20,15,red
4507922418,11,9,10,1,1,0,0,18342,7.2,19368,190,65,-30,1414,19,1834.2,9,11,10,0,0,0,0,18372,7,17954,164,48,30,-1414,16.4,1837.2,red,2.33,1.73,43,56,red
4477117307,4,6,8,0,0,0,0,15251,7,18342,197,39,-2343,-2231,19.7,1525.1,6,4,5,2,1,1,0,17594,7.4,20573,238,80,2343,2231,23.8,1759.4,red,2,2.75,19,16,blue
4526116329,8,6,5,0,0,0,0,17693,7,18557,251,40,2501,2231,25.1,1769.3,6,8,7,0,0,0,0,15192,6.4,16326,176,52,-2501,-2231,17.6,1519.2,blue,2.17,1.62,16,16,blue
4456005306,4,8,4,0,0,0,0,15385,6.8,17267,219,52,-2109,-335,21.9,1538.5,8,4,14,1,1,0,0,17494,7,17602,226,40,2109,335,22.6,1749.4,red,1,5.5,17,19,red
4527144982,7,5,7,0,0,0,0,17549,7.4,19400,239,54,2588,1353,23.9,1754.9,5,7,6,0,0,0,0,14961,6.6,18047,192,50,-2588,-1353,19.2,1496.1,blue,2.8,1.57,55,14,blue
4525573622,5,10,6,0,0,0,0,15148,6.6,16861,219,40,-4085,-3256,21.9,1514.8,10,5,14,2,1,1,0,19233,7.4,20117,220,60,4085,3256,22,1923.3,red,1.1,4.8,12,15,red
4513250819,11,11,6,2,1,1,0,17558,7,18661,174,64,-369,-379,17.4,1755.8,11,11,11,0,0,0,0,17927,7.4,19040,188,44,369,379,18.8,1792.7,red,1.55,2,17,38,blue
4525210320,6,3,9,1,1,0,0,16989,7,18073,242,48,1359,132,24.2,1698.9,3,6,2,0,0,0,0,15630,7,17941,239,60,-1359,-132,23.9,1563,red,5,0.83,40,56,blue
4526332479,11,5,9,0,0,0,0,18786,7.4,19353,244,40,3559,3296,24.4,1878.6,5,11,5,0,0,0,0,15227,6.4,16057,187,56,-3559,-3296,18.7,1522.7,blue,4,0.91,22,19,red
4526360728,4,7,2,0,0,0,0,15188,6.8,17740,194,69,-1269,-1991,19.4,1518.8,7,4,5,1,0,1,0,16457,7.2,19731,213,67,1269,1991,21.3,1645.7,red,0.86,3,19,21,red
4459678917,4,7,7,0,0,0,0,15520,6.8,18045,199,72,-2195,-291,19.9,1552,7,4,8,0,0,0,0,17715,7,18336,255,48,2195,291,25.5,1771.5,blue,1.57,3.75,14,17,red
4489870800,13,6,22,1,1,0,0,20876,7.6,21016,226,56,4988,3720,22.6,2087.6,6,13,6,1,0,1,0,15888,6.8,17296,212,51,-4988,-3720,21.2,1588.8,blue,5.83,0.92,54,21,blue
4505884702,6,2,5,0,0,0,0,17059,7.2,18997,268,52,2714,2819,26.8,1705.9,2,6,2,0,0,0,0,14345,6.6,16178,209,38,-2714,-2819,20.9,1434.5,blue,5.5,0.67,16,83,red
4478623490,7,6,6,0,0,0,0,16760,6.8,17857,206,51,-1052,-1064,20.6,1676,6,7,6,1,1,0,0,17812,7.2,18921,231,68,1052,1064,23.1,1781.2,red,2.17,1.71,23,21,blue
4474736524,3,9,2,0,0,0,0,14660,6.6,17265,203,45,-3251,-2143,20.3,1466,9,3,5,1,1,0,0,17911,7.2,19408,234,52,3251,2143,23.4,1791.1,red,0.56,4.67,19,17,red
4456404061,6,5,5,1,0,1,0,15510,7,17367,202,33,-264,550,20.2,1551,5,6,6,1,1,0,0,15774,6.6,16817,202,51,264,-550,20.2,1577.4,red,2.2,1.83,45,21,blue
4476661936,9,14,9,1,0,1,0,16897,6.4,15328,159,26,-2191,-1391,15.9,1689.7,14,9,19,1,1,0,0,19088,6.8,16719,185,39,2191,1391,18.5,1908.8,red,1.29,3.67,20,20,red
4526071907,8,2,12,0,0,0,0,16861,7,18373,227,40,1297,564,22.7,1686.1,2,8,3,0,0,0,0,15564,7,17809,230,52,-1297,-564,23,1556.4,red,10,0.62,17,16,red
4526732497,11,6,9,1,1,0,0,18445,7.2,19242,218,42,2691,2052,21.8,1844.5,6,11,5,0,0,0,0,15754,6.6,17190,205,40,-2691,-2052,20.5,1575.4,blue,3.33,1,18,18,blue
4526899481,4,10,2,0,0,0,0,15777,6.6,18203,221,58,-2713,-1456,22.1,1577.7,10,4,12,1,1,0,0,18490,7.4,19659,219,65,2713,1456,21.9,1849,red,0.6,5.5,20,26,red
4499966434,7,3,7,0,0,0,0,18284,7.2,19460,224,66,2748,2277,22.4,1828.4,3,7,2,1,1,0,0,15536,7,17183,211,66,-2748,-2277,21.1,1553.6,red,4.67,0.71,28,19,red
4519077677,10,8,9,0,0,0,0,17047,6.8,17725,192,38,-537,29,19.2,1704.7,8,10,8,0,0,0,0,17584,7,17696,207,44,537,-29,20.7,1758.4,red,2.38,1.6,17,17,blue
4494870999,5,0,4,1,0,1,1,17606,7.6,20053,229,60,4027,3285,22.9,1760.6,0,5,0,0,0,0,0,13579,6.6,16768,220,52,-4027,-3285,22,1357.9,blue,12.03,0,20,20,blue
4526855429,7,9,10,0,0,0,0,17447,7,17850,216,55,705,1616,21.6,1744.7,9,7,13,0,0,0,0,16742,6.6,16234,194,36,-705,-1616,19.4,1674.2,red,1.89,3.14,10,21,blue
4515231916,1,7,0,1,1,0,0,13789,6.8,16947,210,63,-4038,-2854,21,1378.9,7,1,12,0,0,0,0,17827,7.4,19801,252,52,4038,2854,25.2,1782.7,red,0.14,19,76,27,red
4520362775,11,9,16,0,0,0,0,18557,7.2,18792,192,44,524,478,19.2,1855.7,9,11,7,1,1,0,0,18033,7,18314,213,48,-524,-478,21.3,1803.3,red,3,1.45,20,18,red
4525318009,4,3,5,0,0,0,0,15568,6.8,17520,246,36,40,-731,24.6,1556.8,3,4,6,0,0,0,0,15528,6.8,18251,211,56,-40,731,21.1,1552.8,red,3,2.25,14,37,red
4449209158,10,5,9,0,0,0,0,17327,7.2,18807,220,30,1291,20,22,1732.7,5,10,6,1,1,0,0,16036,7.2,18787,210,63,-1291,-20,21,1603.6,red,3.8,1.1,22,84,blue
4510530243,6,5,9,1,1,0,0,16110,7,17501,206,36,72,-81,20.6,1611,5,6,5,0,0,0,0,16038,6.8,17582,217,59,-72,81,21.7,1603.8,red,3,1.67,19,17,red
4503029657,10,9,10,0,0,0,0,18209,6.8,16955,200,37,1287,440,20,1820.9,9,10,16,0,0,0,0,16922,6.2,16515,198,53,-1287,-440,19.8,1692.2,blue,2.22,2.5,22,12,red
4483768232,5,6,5,1,0,1,0,16023,6.8,17244,207,60,1299,-918,20.7,1602.3,6,5,7,1,1,0,0,14724,7,18162,173,50,-1299,918,17.3,1472.4,blue,1.67,2.6,20,18,blue
4525862363,8,7,6,1,1,0,0,17685,7.2,19338,231,44,1218,1150,23.1,1768.5,7,8,4,0,0,0,0,16467,7,18188,226,48,-1218,-1150,22.6,1646.7,blue,2,1.38,17,17,red
4467871886,4,5,3,1,1,0,0,14803,6.8,17318,213,49,-1380,326,21.3,1480.3,5,4,10,0,0,0,0,16183,7,16992,238,33,1380,-326,23.8,1618.3,blue,1.4,3.75,90,22,red
4477725637,6,7,12,0,0,0,0,15656,6.4,16252,195,44,-1275,-551,19.5,1565.6,7,6,8,1,1,0,0,16931,6.6,16803,202,44,1275,551,20.2,1693.1,red,2.57,2.5,21,24,red
4526149892,12,3,6,1,1,0,0,19154,7.4,20112,258,63,5664,6002,25.8,1915.4,3,12,2,1,0,1,0,13490,6,14110,179,32,-5664,-6002,17.9,1349,blue,6,0.42,24,20,blue
4520855918,9,3,11,1,1,0,0,17483,7.2,18777,222,44,2186,1698,22.2,1748.3,3,9,3,0,0,0,0,15297,6.8,17079,231,51,-2186,-1698,23.1,1529.7,blue,6.67,0.67,19,17,red
4478269360,1,6,1,0,0,0,0,14598,6.6,17033,217,69,-2286,-2574,21.7,1459.8,6,1,9,1,1,0,0,16884,7.2,19607,227,68,2286,2574,22.7,1688.4,red,0.33,15,14,16,blue
4514407181,6,7,8,1,1,0,0,16088,7.2,17857,205,62,-769,-217,20.5,1608.8,7,6,7,1,0,1,0,16857,7,18074,202,62,769,217,20.2,1685.7,red,2,2.33,18,16,blue
4527127761,4,4,3,0,0,0,0,15812,7,17970,241,42,650,128,24.1,1581.2,4,4,4,1,1,0,0,15162,6.8,17842,198,67,-650,-128,19.8,1516.2,blue,1.75,2,20,11,blue
4445960695,5,3,5,2,1,1,0,16030,7.2,19449,240,52,970,748,24,1603,3,5,4,0,0,0,0,15060,7,18701,218,52,-970,-748,21.8,1506,blue,3.33,1.4,16,52,blue
4410120147,4,7,6,1,1,0,0,15787,7.2,18200,230,42,-1856,-1804,23,1578.7,7,4,11,0,0,0,0,17643,7.4,20004,225,66,1856,1804,22.5,1764.3,red,1.43,4.5,148,17,blue
4481252753,10,4,10,1,1,0,0,17870,7.2,18803,177,59,1872,1869,17.7,1787,4,10,4,0,0,0,0,15998,6.8,16934,225,52,-1872,-1869,22.5,1599.8,blue,5,0.8,41,64,blue
4463020828,12,6,17,0,0,0,0,17875,6.8,17882,205,31,1880,1473,20.5,1787.5,6,12,3,0,0,0,0,15995,6.4,16409,190,57,-1880,-1473,19,1599.5,blue,4.83,0.75,25,16,red
4512764436,6,2,8,0,0,0,0,16523,7,18018,196,60,1652,701,19.6,1652.3,2,6,1,0,0,0,0,14871,6.4,17317,239,51,-1652,-701,23.9,1487.1,blue,7,0.5,31,15,blue
4476704273,5,6,4,1,1,0,0,16180,7.2,18710,234,60,-1348,-407,23.4,1618,6,5,6,0,0,0,0,17528,7,19117,245,55,1348,407,24.5,1752.8,blue,1.5,2.4,16,17,blue
4484971945,7,10,6,1,1,0,0,17448,6.8,17864,205,62,-102,363,20.5,1744.8,10,7,11,0,0,0,0,17550,6.8,17501,181,50,102,-363,18.1,1755,red,1.3,3,20,46,blue
4479146684,4,11,3,0,0,0,0,14493,6.6,15935,210,39,-4130,-2849,21,1449.3,11,4,14,1,1,0,0,18623,7,18784,226,36,4130,2849,22.6,1862.3,red,0.64,6.25,18,21,red
4521281559,9,7,6,1,0,1,0,17807,6.8,17661,217,42,1383,1273,21.7,1780.7,7,9,6,1,1,0,0,16424,6.6,16388,192,60,-1383,-1273,19.2,1642.4,blue,2.14,1.44,21,20,red
4525625887,3,5,2,0,0,0,0,15001,6.8,18001,206,65,-1787,-608,20.6,1500.1,5,3,8,1,1,0,0,16788,7,18609,257,62,1787,608,25.7,1678.8,red,1,4.33,18,61,red
4471757577,11,5,13,1,0,1,0,18984,7.2,18355,246,40,3522,1442,24.6,1898.4,5,11,4,0,0,0,0,15462,6.6,16913,186,56,-3522,-1442,18.6,1546.2,blue,4.8,0.82,17,16,blue
4525306254,6,7,7,0,0,0,0,16528,6.8,17624,212,46,-449,-1347,21.2,1652.8,7,6,6,0,0,0,0,16977,7.2,18971,235,53,449,1347,23.5,1697.7,red,1.86,2.17,63,41,blue
4521009917,2,5,4,0,0,0,0,15020,7,17488,224,64,-1756,-985,22.4,1502,5,2,8,2,1,1,0,16776,7,18473,275,48,1756,985,27.5,1677.6,red,1.2,6.5,25,16,blue
4508074072,1,7,0,0,0,0,0,13657,6.4,16618,220,48,-3849,-2159,22,1365.7,7,1,7,1,1,0,0,17506,7,18777,235,56,3849,2159,23.5,1750.6,red,0.14,14,20,19,red
4527469441,8,6,13,0,0,0,0,17672,7.2,18962,245,50,1121,933,24.5,1767.2,6,8,8,1,1,0,0,16551,6.8,18029,238,61,-1121,-933,23.8,1655.1,blue,3.5,1.75,19,37,blue
4527033024,11,2,15,1,1,0,0,19508,7.4,19814,233,60,4882,2658,23.3,1950.8,2,11,1,0,0,0,0,14626,6.8,17156,219,60,-4882,-2658,21.9,1462.6,blue,13,0.27,13,14,red
4525985539,11,5,9,0,0,0,0,18590,7,18992,215,44,2945,2019,21.5,1859,5,11,7,1,0,1,0,15645,6.6,16973,202,48,-2945,-2019,20.2,1564.5,blue,4,1.09,14,15,blue
4527084361,9,6,16,2,1,1,0,17260,6.6,16577,187,49,1006,820,18.7,1726,6,9,10,0,0,0,0,16254,6.4,15757,204,44,-1006,-820,20.4,1625.4,blue,4.17,1.78,19,22,blue
4516329473,3,2,3,1,1,0,0,16095,7,18658,254,53,1287,603,25.4,1609.5,2,3,2,0,0,0,0,14808,6.6,18055,241,51,-1287,-603,24.1,1480.8,blue,3,1.33,17,14,blue
4525363393,4,8,5,1,0,1,0,15384,6.8,17460,211,44,-1817,-1035,21.1,1538.4,8,4,6,1,1,0,0,17201,7,18495,240,48,1817,1035,24,1720.1,red,1.12,3.5,16,17,red
4489475573,11,11,14,0,0,0,0,18795,7.4,19236,231,43,733,675,23.1,1879.5,11,11,11,1,1,0,0,18062,7,18561,213,32,-733,-675,21.3,1806.2,blue,2.27,2,17,130,blue
4527500964,8,5,13,1,1,0,0,17737,7.2,18648,224,60,2413,2163,22.4,1773.7,5,8,7,0,0,0,0,15324,6.6,16485,179,34,-2413,-2163,17.9,1532.4,blue,4.2,1.5,40,20,red
4495332793,2,3,2,1,0,1,0,14191,6.8,16725,207,48,-1093,-1572,20.7,1419.1,3,2,3,0,0,0,0,15284,7.2,18297,239,55,1093,1572,23.9,1528.4,red,1.33,3,12,120,red
4527238809,5,8,6,0,0,0,0,14557,6.4,15691,169,52,-3666,-2993,16.9,1455.7,8,5,8,0,0,0,0,18223,7.2,18684,235,52,3666,2993,23.5,1822.3,red,1.38,3.2,17,19,blue
4505403710,7,2,13,1,1,0,0,16739,7,17995,229,56,1569,664,22.9,1673.9,2,7,2,0,0,0,0,15170,6.8,17331,250,48,-1569,-664,25,1517,red,10,0.57,18,16,blue
4469108094,6,13,6,1,1,0,0,15230,6.6,16550,165,56,-4403,-3750,16.5,1523,13,6,14,0,0,0,0,19633,7.4,20300,238,40,4403,3750,23.8,1963.3,red,0.92,4.5,40,15,blue
4508327940,5,7,5,0,0,0,0,16600,7,18188,250,52,-189,-1118,25,1660,7,5,10,1,1,0,0,16789,7.4,19306,207,64,189,1118,20.7,1678.9,red,1.43,3.4,86,21,red
4472981807,6,12,8,0,0,0,0,16240,6.6,16610,209,52,-2156,-1052,20.9,1624,12,6,12,1,1,0,0,18396,7,17662,167,44,2156,1052,16.7,1839.6,red,1.17,4,22,52,red
4486431159,11,2,14,1,1,0,0,18722,7.2,19399,216,52,4371,3099,21.6,1872.2,2,11,5,0,0,0,0,14351,6.6,16300,228,49,-4371,-3099,22.8,1435.1,blue,12.5,0.64,19,18,blue
4453493719,3,2,2,0,0,0,0,15640,7,18748,246,65,77,630,24.6,1564,2,3,4,1,1,0,0,15563,7,18118,248,62,-77,-630,24.8,1556.3,red,2.5,2,64,19,blue
4527368569,7,5,11,0,0,0,0,17940,7.4,19767,242,55,1938,738,24.2,1794,5,7,3,1,1,0,0,16002,7.2,19029,221,75,-1938,-738,22.1,1600.2,blue,3.6,1.14,19,16,blue
4477116393,4,6,5,0,0,0,0,16414,6.8,18297,247,62,-58,-1047,24.7,1641.4,6,4,2,1,1,0,0,16472,7,19344,244,60,58,1047,24.4,1647.2,red,1.5,2,16,19,red
4486569835,2,6,1,0,0,0,0,14207,6.6,16373,211,48,-2723,-1062,21.1,1420.7,6,2,7,1,1,0,0,16930,6.8,17435,208,57,2723,1062,20.8,1693,red,0.5,6.5,20,21,red
4522493624,7,6,6,1,1,0,0,16737,7.2,18903,240,48,1411,1163,24,1673.7,6,7,3,0,0,0,0,15326,7,17740,177,49,-1411,-1163,17.7,1532.6,blue,2.17,1.29,18,16,blue
4524785732,1,9,1,0,0,0,0,14672,6.6,16566,234,58,-2998,-3331,23.4,1467.2,9,1,10,0,0,0,0,17670,7.2,19897,251,50,2998,3331,25.1,1767,red,0.22,19,13,57,red
4505637581,4,4,4,1,1,0,0,15360,6.8,17742,228,44,97,-1064,22.8,1536,4,4,0,0,0,0,0,15263,7,18806,220,59,-97,1064,22,1526.3,blue,2,1,13,15,blue
4527309087,11,6,7,1,1,0,0,17795,7.2,19039,213,45,1395,1943,21.3,1779.5,6,11,8,0,0,0,0,16400,6.8,17096,198,50,-1395,-1943,19.8,1640,blue,3,1.27,22,16,blue
4448051945,7,2,7,1,1,0,0,16896,7,18664,246,52,2438,1105,24.6,1689.6,2,7,2,0,0,0,0,14458,6.6,17559,211,52,-2438,-1105,21.1,1445.8,blue,7,0.57,22,16,blue
4470529446,4,7,4,0,0,0,0,16182,7,18355,216,46,-925,-360,21.6,1618.2,7,4,7,2,1,1,0,17107,7,18715,212,67,925,360,21.2,1710.7,red,1.14,3.5,11,15,red
4527571899,11,9,11,1,0,1,0,17729,6.8,17260,190,40,679,211,19,1772.9,9,11,7,0,0,0,0,17050,6.8,17049,192,27,-679,-211,19.2,1705,blue,2.44,1.45,19,22,red
4523059418,10,8,12,1,0,1,0,17552,7.2,18284,222,39,1050,-1270,22.2,1755.2,8,10,5,1,1,0,0,16502,7.4,19554,192,46,-1050,1270,19.2,1650.2,red,2.75,1.3,20,37,blue
4526202382,6,4,5,2,1,1,0,16491,7.6,19790,214,72,392,866,21.4,1649.1,4,6,3,0,0,0,0,16099,7.4,18924,241,69,-392,-866,24.1,1609.9,blue,2.75,1.17,14,25,blue
4478385556,9,11,4,0,0,0,0,17643,7.2,18331,221,55,24,483,22.1,1764.3,11,9,17,1,1,0,0,17619,7,17848,153,36,-24,-483,15.3,1761.9,red,1.18,3.11,16,38,blue
4470670940,6,6,7,0,0,0,0,16247,7.4,19667,218,52,266,1738,21.8,1624.7,6,6,8,1,1,0,0,15981,7,17929,213,56,-266,-1738,21.3,1598.1,blue,2.17,2.33,21,19,blue
4471257254,8,6,11,0,0,0,0,17072,6.4,16658,192,36,1396,89,19.2,1707.2,6,8,15,1,1,0,0,15676,6.8,16569,179,53,-1396,-89,17.9,1567.6,blue,3.17,2.62,21,23,blue
4512326355,12,5,11,2,1,1,0,18882,6.6,18137,202,57,3807,1849,20.2,1888.2,5,12,9,0,0,0,0,15075,6.8,16288,187,52,-3807,-1849,18.7,1507.5,blue,4.6,1.17,14,15,blue
4486653289,3,3,4,0,0,0,0,14520,7,17410,182,64,-1127,-843,18.2,1452,3,3,1,0,0,0,0,15647,7,18253,234,60,1127,843,23.4,1564.7,red,2.33,1.33,12,18,blue
4470054451,10,4,14,1,1,0,0,18374,7.6,20120,229,51,3823,3324,22.9,1837.4,4,10,4,0,0,0,0,14551,6.6,16796,176,52,-3823,-3324,17.6,1455.1,blue,6,0.8,16,17,blue
4518536187,6,4,5,1,1,0,0,16073,6.8,17592,211,44,32,822,21.1,1607.3,4,6,8,1,0,1,0,16041,6.2,16770,207,44,-32,-822,20.7,1604.1,red,2.75,2,14,22,blue
4455236483,4,1,6,1,1,0,0,16448,7.2,18932,248,61,1306,431,24.8,1644.8,1,4,2,0,0,0,0,15142,7,18501,262,64,-1306,-431,26.2,1514.2,blue,10,0.75,22,17,blue
4512745203,12,8,12,1,1,0,0,18821,7,18407,203,51,1618,514,20.3,1882.1,8,12,7,1,0,1,0,17203,7.2,17893,181,49,-1618,-514,18.1,1720.3,blue,3,1.25,23,27,blue
4510669368,6,10,6,1,0,1,0,15485,6.8,17138,193,50,-2854,-2798,19.3,1548.5,10,6,9,0,0,0,0,18339,7.4,19936,225,52,2854,2798,22.5,1833.9,red,1.2,3.17,54,15,red
4526763714,5,9,3,1,1,0,0,15129,6.6,16869,204,44,-1417,860,20.4,1512.9,9,5,14,0,0,0,0,16546,6.6,16009,182,36,1417,-860,18.2,1654.6,red,0.89,4.6,18,16,blue
4509431261,5,3,7,0,0,0,0,16329,6.8,17600,205,48,1320,-178,20.5,1632.9,3,5,4,0,0,0,0,15009,6.8,17778,218,48,-1320,178,21.8,1500.9,blue,4,1.4,47,15,blue
4477413718,6,1,5,0,0,0,0,16807,7.2,19976,263,64,2954,3730,26.3,1680.7,1,6,1,1,1,0,0,13853,6.6,16246,177,80,-2954,-3730,17.7,1385.3,blue,11,0.33,20,11,blue
4515934716,11,10,21,0,0,0,0,20330,7,18408,234,44,2460,498,23.4,2033,10,11,24,1,1,0,0,17870,6.8,17910,205,60,-2460,-498,20.5,1787,blue,3.2,3.09,24,25,red
4525352224,6,6,6,1,1,0,0,16666,6.8,17512,185,58,132,-28,18.5,1666.6,6,6,6,0,0,0,0,16534,6.8,17540,237,40,-132,28,23.7,1653.4,blue,2,2,146,48,red
4513354940,7,5,6,1,1,0,0,16946,6.8,17723,247,40,2276,1630,24.7,1694.6,5,7,7,0,0,0,0,14670,6.4,16093,194,29,-2276,-1630,19.4,1467,blue,2.6,1.71,27,21,blue
4484592953,7,4,6,0,0,0,0,17028,7.4,19169,247,52,1586,2622,24.7,1702.8,4,7,4,1,1,0,0,15442,6.6,16547,214,55,-1586,-2622,21.4,1544.2,blue,3.25,1.14,30,18,blue
4466193418,5,5,7,1,0,1,0,16686,7.4,19183,240,55,-418,60,24,1668.6,5,5,3,1,1,0,0,17104,7.2,19123,273,58,418,-60,27.3,1710.4,red,2.4,1.6,28,45,red
4526460873,4,6,2,1,1,0,0,14993,6.8,16922,223,44,-1449,-539,22.3,1499.3,6,4,6,0,0,0,0,16442,6.8,17461,255,40,1449,539,25.5,1644.2,blue,1,3,20,25,red
4495515321,3,1,4,0,0,0,0,14654,7,17393,201,49,-663,-413,20.1,1465.4,1,3,2,1,1,0,0,15317,6.8,17806,248,58,663,413,24.8,1531.7,blue,7,1,20,13,red
4451773620,3,3,6,0,0,0,0,15570,6.8,17440,232,36,-339,-1529,23.2,1557,3,3,1,2,1,1,0,15909,7.2,18969,244,60,339,1529,24.4,1590.9,blue,3,1.33,17,23,red
4519198030,8,8,11,0,0,0,0,17178,7,18476,216,44,-597,-1198,21.6,1717.8,8,8,6,0,0,0,0,17775,7.4,19674,253,52,597,1198,25.3,1777.5,blue,2.38,1.75,25,24,red
4503283064,1,7,2,0,0,0,0,14333,6.8,17362,222,46,-2671,-1258,22.2,1433.3,7,1,6,1,1,0,0,17004,6.8,18620,224,51,2671,1258,22.4,1700.4,red,0.43,13,20,16,red
4465543181,1,10,1,0,0,0,0,14453,6.8,17152,244,52,-2889,-2882,24.4,1445.3,10,1,6,1,1,0,0,17342,7.2,20034,216,55,2889,2882,21.6,1734.2,red,0.2,16,21,23,red
4521774958,3,7,2,1,0,1,0,15932,6.8,17831,238,48,-1111,679,23.8,1593.2,7,3,7,1,1,0,0,17043,6.8,17152,191,44,1111,-679,19.1,1704.3,blue,0.71,4.67,23,9,red
4512943729,3,6,1,0,0,0,0,15101,7,18480,226,66,-1972,-717,22.6,1510.1,6,3,4,1,1,0,0,17073,7.2,19197,263,64,1972,717,26.3,1707.3,red,0.67,3.33,29,19,red
4456258019,6,4,9,0,0,0,0,16628,7,18812,216,60,1457,715,21.6,1662.8,4,6,4,1,1,0,0,15171,7.2,18097,208,40,-1457,-715,20.8,1517.1,red,3.75,1.33,15,15,red
4503866171,4,9,2,2,1,1,0,14997,6.6,16588,217,48,-2566,-2224,21.7,1499.7,9,4,9,0,0,0,0,17563,7.2,18812,216,48,2566,2224,21.6,1756.3,red,0.67,4.5,19,18,red
4469416246,10,8,7,1,0,1,0,17664,7,18757,233,53,563,442,23.3,1766.4,8,10,6,0,0,0,0,17101,7,18315,219,39,-563,-442,21.9,1710.1,blue,2.12,1.4,19,17,blue
4500754839,4,10,4,1,1,0,0,15082,6.8,17691,211,49,-2924,-1587,21.1,1508.2,10,4,6,0,0,0,0,18006,7.4,19278,216,62,2924,1587,21.6,1800.6,blue,0.8,4,18,14,red
4526467348,8,12,5,1,1,0,0,16964,6.8,18163,214,48,-2935,-1462,21.4,1696.4,12,8,15,0,0,0,0,19899,7.4,19625,235,59,2935,1462,23.5,1989.9,red,1.08,3.38,14,17,red
4522860957,7,4,9,0,0,0,0,16999,6.8,17880,228,40,1671,1072,22.8,1699.9,4,7,6,1,1,0,0,15328,6.4,16808,206,55,-1671,-1072,20.6,1532.8,blue,4,1.43,19,22,red
4297209068,6,6,6,0,0,0,0,16621,6.6,17333,220,44,282,399,22,1662.1,6,6,8,0,0,0,0,16339,6.8,16934,216,53,-282,-399,21.6,1633.9,blue,2,2.33,22,21,blue
4452292260,9,11,8,1,1,0,0,17060,6.6,17118,179,36,-896,-661,17.9,1706,11,9,14,0,0,0,0,17956,7,17779,200,52,896,661,20,1795.6,blue,1.55,2.78,38,31,red
4449428423,3,7,5,1,1,0,0,14758,6.6,15950,202,52,-2993,-2494,20.2,1475.8,7,3,12,1,0,1,1,17751,7,18444,215,39,2993,2494,21.5,1775.1,red,1.14,6.33,25,20,blue
4473438026,8,4,11,1,1,0,0,17117,7,18326,204,52,1810,1012,20.4,1711.7,4,8,6,0,0,0,0,15307,6.6,17314,211,44,-1810,-1012,21.1,1530.7,blue,4.75,1.25,21,23,blue
4488784073,6,10,6,0,0,0,0,16413,7,17648,204,49,-2461,-1828,20.4,1641.3,10,6,13,1,1,0,0,18874,7.4,19476,223,64,2461,1828,22.3,1887.4,blue,1.2,3.83,41,20,red
4438230274,3,6,5,0,0,0,0,14448,6.4,15930,209,40,-1620,-1431,20.9,1444.8,6,3,10,1,0,1,0,16068,6.8,17361,204,51,1620,1431,20.4,1606.8,red,1.33,5.33,18,19,red
4492561443,5,1,4,0,0,0,0,16778,7.2,18893,247,48,2375,2688,24.7,1677.8,1,5,0,0,0,0,0,14403,6.6,16205,235,60,-2375,-2688,23.5,1440.3,blue,9,0.2,18,38,blue
4457538787,2,1,3,1,1,0,0,14494,6.8,18008,244,47,-618,-413,24.4,1449.4,1,2,2,0,0,0,0,15112,6.8,18421,247,60,618,413,24.7,1511.2,red,5,1.5,20,42,red
4486823240,9,6,13,0,0,0,0,18267,7.4,19241,226,48,2253,2082,22.6,1826.7,6,9,7,0,0,0,0,16014,6.8,17159,178,55,-2253,-2082,17.8,1601.4,blue,3.67,1.44,19,18,blue
4521965130,6,2,6,1,1,0,0,16440,7,18417,208,50,2821,2754,20.8,1644,2,6,2,0,0,0,0,13619,6.2,15663,203,46,-2821,-2754,20.3,1361.9,red,6,0.67,85,13,blue
4484601181,8,5,8,2,1,1,0,17390,7.2,19016,212,60,1716,1837,21.2,1739,5,8,8,0,0,0,0,15674,6.8,17179,226,36,-1716,-1837,22.6,1567.4,blue,3.2,1.62,16,16,red
4470363141,6,7,6,0,0,0,0,17035,7.2,18588,235,60,501,-495,23.5,1703.5,7,6,4,0,0,0,0,16534,7,19083,207,60,-501,495,20.7,1653.4,blue,1.71,1.83,20,17,blue
4505505523,11,16,19,0,0,0,0,17198,6.4,15293,156,32,-2830,-2212,15.6,1719.8,16,11,24,1,1,0,0,20028,6.8,17505,174,46,2830,2212,17.4,2002.8,red,1.88,3.64,20,20,blue
4526153369,10,2,10,1,0,1,0,17430,6.8,18040,210,42,3140,1824,21,1743,2,10,2,0,0,0,0,14290,6.8,16216,228,48,-3140,-1824,22.8,1429,blue,10,0.4,29,24,blue
4423131691,4,6,4,1,0,1,0,15320,7,16960,217,40,-1152,-1535,21.7,1532,6,4,5,1,1,0,0,16472,7,18495,225,56,1152,1535,22.5,1647.2,red,1.33,2.75,19,55,blue
4497452611,3,4,5,0,0,0,0,15347,6.8,17612,243,48,-704,-193,24.3,1534.7,4,3,3,1,1,0,0,16051,6.8,17805,220,60,704,193,22,1605.1,red,2,2.33,26,16,red
4471981120,12,6,11,0,0,0,0,18002,7,19391,199,36,2621,2483,19.9,1800.2,6,12,5,0,0,0,0,15381,6.8,16908,195,44,-2621,-2483,19.5,1538.1,blue,3.83,0.92,16,12,blue
4480094113,11,16,10,0,0,0,0,17901,6.8,16538,171,44,-2529,-1607,17.1,1790.1,16,11,17,1,0,1,0,20430,7,18145,205,36,2529,1607,20.5,2043,red,1.31,3,14,19,red
4387774615,3,4,1,0,0,0,0,14205,7,18034,197,50,-1099,-396,19.7,1420.5,4,3,4,1,1,0,0,15304,7,18430,236,43,1099,396,23.6,1530.4,red,1,2.67,18,15,red
4515363790,4,6,1,0,0,0,0,13772,6,14954,178,28,-3147,-3323,17.8,1377.2,6,4,6,1,0,1,0,16919,7,18277,223,52,3147,3323,22.3,1691.9,red,0.83,3,15,23,red
4526222193,6,1,7,1,1,0,0,17231,7.2,19272,237,80,3142,2037,23.7,1723.1,1,6,1,0,0,0,0,14089,6.8,17235,245,44,-3142,-2037,24.5,1408.9,blue,13,0.33,27,18,blue
4447414095,6,8,6,0,0,0,0,15983,7.2,19337,233,42,-1231,496,23.3,1598.3,8,6,11,0,0,0,0,17214,7.4,18841,201,52,1231,-496,20.1,1721.4,red,1.5,3.17,19,15,red
4504974041,2,4,2,0,0,0,0,14651,6.8,18301,241,41,-1991,-1055,24.1,1465.1,4,2,4,0,0,0,0,16642,7.2,19356,248,78,1991,1055,24.8,1664.2,red,1,4,14,16,blue
4442091575,11,1,13,1,1,0,1,18789,7.4,20433,231,38,4250,3916,23.1,1878.9,1,11,1,0,0,0,0,14539,6.4,16517,223,57,-4250,-3916,22.3,1453.9,blue,24,0.18,23,17,blue
4516515397,6,12,3,0,0,0,0,15485,6.6,16784,213,28,-3683,-3420,21.3,1548.5,12,6,13,2,1,1,0,19168,7.4,20204,209,63,3683,3420,20.9,1916.8,red,0.75,4.17,14,37,red
4505187643,10,3,11,1,0,1,0,17992,7,18842,212,51,3313,1465,21.2,1799.2,3,10,4,1,1,0,0,14679,6.8,17377,217,52,-3313,-1465,21.7,1467.9,blue,7,0.7,68,13,blue
4526183369,10,8,17,1,1,0,0,18828,7.2,18186,197,53,2117,180,19.7,1882.8,8,10,8,1,0,1,0,16711,6.8,18006,209,47,-2117,-180,20.9,1671.1,blue,3.38,1.6,26,20,blue
4467235457,3,9,3,0,0,0,0,14797,6.6,17124,212,48,-3268,-3888,21.2,1479.7,9,3,6,1,1,0,0,18065,7.6,21012,218,80,3268,3888,21.8,1806.5,red,0.67,5,15,15,blue
4469904395,4,7,5,1,1,0,0,15524,7,17843,228,56,-629,-209,22.8,1552.4,7,4,7,0,0,0,0,16153,6.8,18052,192,55,629,209,19.2,1615.3,blue,1.29,3.5,16,25,red
4461601023,10,4,6,2,1,1,0,18288,7.6,20765,234,68,3184,3874,23.4,1828.8,4,10,5,0,0,0,0,15104,6.8,16891,209,54,-3184,-3874,20.9,1510.4,blue,4,0.9,19,15,blue
4506975246,5,8,2,0,0,0,0,16304,7,18344,222,84,-890,-1261,22.2,1630.4,8,5,5,2,1,1,0,17194,7.4,19605,218,52,890,1261,21.8,1719.4,red,0.88,2.6,52,17,red
4490055696,5,10,8,1,1,0,0,14974,6.2,15389,201,24,-4646,-3186,20.1,1497.4,10,5,17,0,0,0,1,19620,7.2,18575,201,64,4646,3186,20.1,1962,red,1.3,5.4,52,17,red
4519220567,4,2,4,0,0,0,0,16598,7,18693,256,43,1937,1019,25.6,1659.8,2,4,1,1,1,0,0,14661,6.8,17674,239,41,-1937,-1019,23.9,1466.1,red,4,0.75,33,54,blue
4522842470,5,5,7,0,0,0,0,15273,6.8,16349,189,55,15,-2108,18.9,1527.3,5,5,6,1,1,0,0,15258,7,18457,216,54,-15,2108,21.6,1525.8,blue,2.4,2.2,19,27,blue
4448423272,4,5,2,0,0,0,0,15515,7.2,18510,222,55,-44,673,22.2,1551.5,5,4,4,0,0,0,0,15559,6.8,17837,218,56,44,-673,21.8,1555.9,red,1.2,2.25,13,15,blue
4509068036,4,0,2,0,0,0,0,16024,6.8,19005,220,62,3133,2377,22,1602.4,0,4,0,0,0,0,0,12891,6.6,16628,206,44,-3133,-2377,20.6,1289.1,red,12.03,0,18,16,blue
4521845032,4,8,7,0,0,0,0,15667,7,17592,225,60,-2450,-2260,22.5,1566.7,8,4,14,1,1,0,0,18117,7.6,19852,252,60,2450,2260,25.2,1811.7,red,1.38,5.5,21,17,blue
4515955272,9,7,5,0,0,0,0,18451,7.4,19111,226,60,1309,657,22.6,1845.1,7,9,5,0,0,0,0,17142,6.8,18454,206,44,-1309,-657,20.6,1714.2,blue,2,1.33,27,45,red
4519665715,8,9,5,0,0,0,0,16355,6.8,17998,198,59,-994,266,19.8,1635.5,9,8,9,1,1,0,0,17349,6.8,17732,202,40,994,-266,20.2,1734.9,red,1.44,2.25,17,20,red
4465424033,4,12,3,1,0,1,0,15140,6.6,15933,198,48,-4199,-3415,19.8,1514,12,4,11,0,0,0,1,19339,7.2,19348,221,40,4199,3415,22.1,1933.9,red,0.58,5.75,17,25,blue
4505416038,2,1,4,0,0,0,0,15755,7,18468,258,69,1684,1773,25.8,1575.5,1,2,1,0,0,0,0,14071,6.8,16695,212,56,-1684,-1773,21.2,1407.1,red,6,1,57,19,blue
4526044508,6,6,7,0,0,0,0,16302,7,18040,212,45,95,772,21.2,1630.2,6,6,7,1,1,0,0,16207,6.8,17268,205,46,-95,-772,20.5,1620.7,blue,2.17,2.17,22,21,red
4480746827,2,7,3,0,0,0,0,13825,6.8,16773,173,48,-3453,-2582,17.3,1382.5,7,2,4,0,0,0,0,17278,7.4,19355,237,48,3453,2582,23.7,1727.8,red,0.71,5.5,39,15,red
4473157317,5,2,5,1,1,0,0,16724,7,18895,229,64,2432,1875,22.9,1672.4,2,5,3,0,0,0,0,14292,6.6,17020,221,44,-2432,-1875,22.1,1429.2,red,5,1,25,17,blue
4512583390,9,2,11,0,0,0,0,18442,7.4,19414,248,51,2680,1700,24.8,1844.2,2,9,1,2,1,1,0,15762,7,17714,240,52,-2680,-1700,24,1576.2,blue,10,0.33,19,22,blue
4465279641,8,13,4,0,0,0,0,17008,7.2,18223,217,55,-4178,-1302,21.7,1700.8,13,8,13,1,1,0,1,21186,7.4,19525,219,40,4178,1302,21.9,2118.6,red,0.92,3.25,18,16,blue
4489477111,5,3,4,1,1,0,0,16513,7,18334,249,52,897,806,24.9,1651.3,3,5,5,0,0,0,0,15616,6.8,17528,201,76,-897,-806,20.1,1561.6,blue,3,1.6,21,16,red
4479732841,4,6,5,0,0,0,0,15554,7,18372,242,52,-1232,-1020,24.2,1555.4,6,4,5,1,1,0,0,16786,7.4,19392,230,52,1232,1020,23,1678.6,red,1.5,2.75,29,17,red
4514309689,5,9,5,0,0,0,0,15400,7,17541,215,40,-4112,-2493,21.5,1540,9,5,9,0,0,0,0,19512,7.4,20034,219,72,4112,2493,21.9,1951.2,blue,1.11,3.6,13,17,red
4527434584,10,7,11,1,1,0,0,19052,7,18439,242,47,2514,1416,24.2,1905.2,7,10,11,0,0,0,0,16538,6.6,17023,197,48,-2514,-1416,19.7,1653.8,blue,3,1.8,31,40,blue
4525788631,6,12,8,1,1,0,0,16039,6.6,16635,198,36,-2088,-2153,19.8,1603.9,12,6,15,0,0,0,0,18127,7,18788,201,48,2088,2153,20.1,1812.7,red,1.17,4.5,21,33,blue
4527311147,6,8,5,1,1,0,0,17093,7,18357,233,48,-414,-601,23.3,1709.3,8,6,7,0,0,0,0,17507,7.2,18958,243,48,414,601,24.3,1750.7,red,1.38,2.5,19,166,blue
4469649522,4,11,3,0,0,0,0,15440,6.8,16864,207,44,-3368,-3384,20.7,1544,11,4,17,0,0,0,0,18808,7.4,20248,216,68,3368,3384,21.6,1880.8,red,0.64,7,58,18,red
4525620906,4,7,2,0,0,0,0,15547,6.8,18141,214,56,-539,723,21.4,1554.7,7,4,6,1,1,0,0,16086,7,17418,207,43,539,-723,20.7,1608.6,blue,0.86,3.25,18,17,red
4512919782,7,6,10,0,0,0,0,16275,6.8,16968,190,56,495,21,19,1627.5,6,7,10,0,0,0,0,15780,6.8,16947,197,48,-495,-21,19.7,1578,red,2.83,2.29,48,20,blue
4465354125,7,5,9,1,1,0,0,17627,7,19004,204,64,1794,927,20.4,1762.7,5,7,7,0,0,0,0,15833,7,18077,194,64,-1794,-927,19.4,1583.3,blue,3.2,1.71,14,12,blue
4497742597,7,4,10,1,1,0,0,16641,7,18150,221,51,1459,970,22.1,1664.1,4,7,2,0,0,0,0,15182,6.8,17180,210,52,-1459,-970,21,1518.2,red,4.25,0.86,63,16,red
4500293065,6,1,12,1,1,0,0,16009,6.8,17605,194,51,685,333,19.4,1600.9,1,6,0,0,0,0,0,15324,6.6,17272,252,72,-685,-333,25.2,1532.4,blue,18,0.17,22,18,red
4517659672,4,3,4,1,1,0,0,15010,6.8,16558,211,58,-782,-1431,21.1,1501,3,4,3,0,0,0,0,15792,7,17989,248,54,782,1431,24.8,1579.2,red,2.67,1.5,17,20,blue
4477708439,4,5,6,1,1,0,0,15969,7,18868,195,72,-876,389,19.5,1596.9,5,4,9,0,0,0,0,16845,7,18479,228,63,876,-389,22.8,1684.5,blue,2,3.5,48,15,red
4475151034,2,3,6,0,0,0,0,15007,7.2,17469,232,56,-302,-646,23.2,1500.7,3,2,3,0,0,0,0,15309,6.8,18115,248,56,302,646,24.8,1530.9,red,2.67,3,16,34,blue
4526755326,3,8,3,0,0,0,0,14494,6.4,15036,208,44,-4235,-4926,20.8,1449.4,8,3,4,1,1,0,1,18729,7.4,19962,254,74,4235,4926,25.4,1872.9,red,0.75,4,18,18,blue
4522799084,6,6,4,1,0,1,0,16576,7,18349,220,36,-316,63,22,1657.6,6,6,5,0,0,0,0,16892,7,18286,214,50,316,-63,21.4,1689.2,blue,1.67,1.83,19,21,red
4495602419,7,10,8,0,0,0,0,16575,7,18524,204,42,-2362,79,20.4,1657.5,10,7,9,0,0,0,0,18937,7,18445,247,44,2362,-79,24.7,1893.7,red,1.5,2.71,13,231,red
4527042510,12,4,14,2,1,1,0,19339,7.2,19966,225,66,3708,2901,22.5,1933.9,4,12,3,0,0,0,0,15631,6.8,17065,203,60,-3708,-2901,20.3,1563.1,red,6.5,0.58,21,86,blue
4507364977,6,6,7,1,1,0,0,16621,7,19387,206,64,-258,569,20.6,1662.1,6,6,10,0,0,0,0,16879,7.2,18818,225,68,258,-569,22.5,1687.9,blue,2.17,2.67,19,16,red
4526256395,1,6,1,1,0,1,0,14308,6.8,17611,235,48,-2634,-1282,23.5,1430.8,6,1,9,1,1,0,0,16942,7.4,18893,247,66,2634,1282,24.7,1694.2,red,0.33,15,40,22,red
4497764283,6,11,5,0,0,0,0,15165,6.6,16025,188,31,-3709,-4015,18.8,1516.5,11,6,8,1,1,0,0,18874,7.2,20040,227,68,3709,4015,22.7,1887.4,red,1,3.17,16,18,blue
4451728013,11,3,14,0,0,0,0,18754,7.6,20402,202,52,4074,3921,20.2,1875.4,3,11,6,1,1,0,0,14680,6.8,16481,200,44,-4074,-3921,20,1468,red,8.33,0.82,22,35,red
4504012663,7,6,6,1,1,0,0,16608,7.2,18459,233,60,-26,989,23.3,1660.8,6,7,7,0,0,0,0,16634,6.8,17470,203,52,26,-989,20.3,1663.4,red,2.17,1.86,156,17,red
4479907998,7,4,6,1,1,0,0,16375,7,18026,172,62,143,713,17.2,1637.5,4,7,3,1,0,1,0,16232,6.6,17313,217,54,-143,-713,21.7,1623.2,red,3.25,1,45,18,blue
4502893432,5,6,6,1,0,1,0,15987,7,17964,207,44,-155,-47,20.7,1598.7,6,5,6,0,0,0,0,16142,7,18011,231,39,155,47,23.1,1614.2,blue,1.83,2.4,19,16,red
4466996593,8,5,9,1,1,0,0,17027,7.4,19345,217,56,302,1420,21.7,1702.7,5,8,7,1,0,1,0,16725,7,17925,237,44,-302,-1420,23.7,1672.5,red,3.4,1.5,21,23,red
4508032491,5,8,7,0,0,0,0,15885,6.4,16350,216,40,-1615,-1393,21.6,1588.5,8,5,10,2,1,1,0,17500,6.8,17743,221,52,1615,1393,22.1,1750,red,1.5,3.6,18,17,red
4500122994,3,2,1,1,1,0,0,16238,7,18724,241,60,1443,-453,24.1,1623.8,2,3,2,0,0,0,0,14795,7.2,19177,215,68,-1443,453,21.5,1479.5,red,2,1.33,17,22,blue
4520714829,6,7,9,0,0,0,0,16778,7.2,17640,218,60,-1446,-965,21.8,1677.8,7,6,10,2,1,1,1,18224,7,18605,234,39,1446,965,23.4,1822.4,red,2.14,2.83,23,23,blue
4458639336,7,7,2,0,0,0,0,17004,7.2,19168,216,69,341,-352,21.6,1700.4,7,7,4,1,1,0,0,16663,7.2,19520,207,47,-341,352,20.7,1666.3,red,1.29,1.57,12,36,red
4477499518,12,8,10,0,0,0,0,17668,6.8,17036,184,40,-120,-393,18.4,1766.8,8,12,8,0,0,0,0,17788,6.8,17429,194,36,120,393,19.4,1778.8,blue,2.75,1.33,26,18,blue
4525234644,7,3,8,1,1,0,0,16389,7,18131,225,48,566,-528,22.5,1638.9,3,7,5,1,0,1,0,15823,7.2,18659,261,48,-566,528,26.1,1582.3,blue,5,1.14,17,19,red
4484556262,9,7,13,0,0,0,0,17252,6.4,15960,188,39,166,-1644,18.8,1725.2,7,9,8,1,1,0,0,17086,7,17604,192,54,-166,1644,19.2,1708.6,blue,3.14,1.67,11,19,blue
4489972241,7,6,12,1,1,0,1,17854,6.8,16635,195,44,-49,-1803,19.5,1785.4,6,7,6,1,0,1,1,17903,6.8,18438,238,56,49,1803,23.8,1790.3,blue,3.17,1.71,23,20,blue
4457517479,4,8,6,0,0,0,0,15431,6.8,17309,218,47,-2661,-3190,21.8,1543.1,8,4,9,2,1,1,0,18092,7.2,20499,260,63,2661,3190,26,1809.2,red,1.25,4.25,18,111,red
4484101947,2,5,2,0,0,0,0,14985,7,17710,224,60,-1522,-1437,22.4,1498.5,5,2,5,1,1,0,0,16507,7.2,19147,253,56,1522,1437,25.3,1650.7,red,0.8,5,15,16,blue
4452042195,2,3,4,0,0,0,0,16008,6.8,18674,237,83,1060,1708,23.7,1600.8,3,2,5,1,1,0,0,14948,6.8,16966,211,53,-1060,-1708,21.1,1494.8,blue,2,4,19,16,blue
4468603101,9,4,6,1,0,1,1,19663,7.2,19052,247,48,4043,1803,24.7,1966.3,4,9,5,0,0,0,0,15620,6.8,17249,214,51,-4043,-1803,21.4,1562,blue,3.75,1,21,15,red
4517973417,7,1,10,1,1,0,0,16932,7.2,19942,235,55,2699,2575,23.5,1693.2,1,7,1,0,0,0,0,14233,6.8,17367,242,52,-2699,-2575,24.2,1423.3,blue,17,0.29,20,58,blue
4471426578,8,6,9,0,0,0,0,17026,7.2,18824,212,51,843,1776,21.2,1702.6,6,8,2,1,1,0,0,16183,7,17048,220,36,-843,-1776,22,1618.3,blue,2.83,1,46,23,red
4458486391,9,5,7,1,1,0,0,17803,7.4,20184,267,39,2193,2957,26.7,1780.3,5,9,4,0,0,0,0,15610,6.8,17227,207,44,-2193,-2957,20.7,1561,blue,3.2,1,25,21,blue
4520523189,5,3,5,1,1,0,0,15582,7,18842,234,55,-18,788,23.4,1558.2,3,5,7,0,0,0,0,15600,7,18054,202,67,18,-788,20.2,1560,blue,3.33,2,31,39,blue
4520399524,2,4,3,0,0,0,0,14808,6.8,16826,219,50,-1352,-2339,21.9,1480.8,4,2,5,0,0,0,0,16160,7.4,19165,257,51,1352,2339,25.7,1616,blue,1.25,4.5,15,17,red
4452036224,7,9,8,1,1,0,0,16497,6.6,16957,207,44,-1736,-2692,20.7,1649.7,9,7,7,0,0,0,0,18233,7.2,19649,246,48,1736,2692,24.6,1823.3,red,1.67,2.29,17,15,blue
4507431568,5,6,7,0,0,0,0,16503,7,18377,240,59,171,42,24,1650.3,6,5,10,1,1,0,0,16332,7,18335,232,54,-171,-42,23.2,1633.2,blue,2,3.2,16,49,blue
4447906863,4,6,5,0,0,0,0,15522,7,18255,220,52,-1711,-1406,22,1552.2,6,4,6,1,1,0,0,17233,7.4,19661,239,68,1711,1406,23.9,1723.3,red,1.5,3,15,11,blue
4522665247,9,15,9,0,0,0,0,17371,6.8,17227,183,42,-2793,-3416,18.3,1737.1,15,9,12,0,0,0,0,20164,7.6,20643,228,42,2793,3416,22.8,2016.4,red,1.2,3,40,18,red
4482844826,8,7,8,1,1,0,0,17720,7.2,19150,232,50,1549,1179,23.2,1772,7,8,4,1,0,1,0,16171,7,17971,212,34,-1549,-1179,21.2,1617.1,red,2.29,1.38,131,13,blue
4485633247,8,5,7,1,1,0,0,17981,7.2,19233,245,64,2565,1634,24.5,1798.1,5,8,3,0,0,0,0,15416,6.6,17599,199,48,-2565,-1634,19.9,1541.6,blue,3,1,14,15,blue
4481910360,5,3,12,2,1,1,0,15229,6.8,16903,160,48,-174,-70,16,1522.9,3,5,2,0,0,0,0,15403,6.6,16973,235,40,174,70,23.5,1540.3,red,5.67,1,22,20,blue
4513290700,5,7,5,1,0,1,0,16425,7,18524,201,62,-1029,754,20.1,1642.5,7,5,11,1,1,0,0,17454,6.8,17770,225,44,1029,-754,22.5,1745.4,red,1.43,3.6,75,109,blue
4482031505,4,2,7,1,1,0,0,15790,6.8,17238,209,52,785,-350,20.9,1579,2,4,3,0,0,0,0,15005,7,17588,241,59,-785,350,24.1,1500.5,red,5.5,1.25,18,67,blue
4501242317,4,0,6,0,0,0,0,17339,7.2,19573,237,74,3652,1943,23.7,1733.9,0,4,0,1,1,0,0,13687,6.8,17630,217,68,-3652,-1943,21.7,1368.7,blue,12.03,0,55,18,blue
4474968452,4,4,7,0,0,0,0,16487,7,18146,229,60,995,-458,22.9,1648.7,4,4,2,0,0,0,0,15492,7,18604,230,56,-995,458,23,1549.2,red,2.75,1.5,22,19,blue
4435131804,9,2,10,0,0,0,0,17922,7.2,18511,224,37,3703,3118,22.4,1792.2,2,9,4,0,0,0,0,14219,6.2,15393,206,40,-3703,-3118,20.6,1421.9,blue,9.5,0.67,23,21,blue
4492283866,6,7,3,2,1,1,0,16778,6.8,18459,236,55,-74,-482,23.6,1677.8,7,6,10,0,0,0,0,16852,7,18941,212,60,74,482,21.2,1685.2,red,1.29,2.83,21,37,blue
4493157099,8,8,8,2,1,1,0,18068,6.8,18462,204,76,719,387,20.4,1806.8,8,8,8,0,0,0,0,17349,6.8,18075,203,51,-719,-387,20.3,1734.9,blue,2,2,14,13,blue
4464569523,8,5,11,1,1,0,0,17366,7,17659,229,46,1074,52,22.9,1736.6,5,8,3,0,0,0,0,16292,6.8,17607,245,34,-1074,-52,24.5,1629.2,blue,3.8,1,25,23,blue
4480246258,2,8,1,1,0,1,0,15041,6.8,17616,229,58,-3259,-1311,22.9,1504.1,8,2,13,1,1,0,0,18300,7,18927,249,56,3259,1311,24.9,1830,blue,0.38,10.5,16,22,red
4456733355,5,10,7,0,0,0,0,15135,6.8,16444,197,41,-3704,-4361,19.7,1513.5,10,5,12,1,1,0,0,18839,7.6,20805,244,72,3704,4361,24.4,1883.9,red,1.2,4.4,18,42,blue
4512935450,6,13,10,1,0,1,0,16083,6.6,16509,218,52,-2772,-2957,21.8,1608.3,13,6,11,1,1,0,0,18855,7.2,19466,207,52,2772,2957,20.7,1885.5,red,1.23,4,14,20,red
4507962860,8,4,7,1,1,0,0,17446,7,19285,223,61,2322,1048,22.3,1744.6,4,8,1,0,0,0,0,15124,6.8,18237,222,56,-2322,-1048,22.2,1512.4,blue,3.75,0.62,60,14,blue
4525838366,2,7,1,0,0,0,0,14284,7,17853,243,40,-3304,-1505,24.3,1428.4,7,2,8,1,1,0,0,17588,7.2,19358,237,67,3304,1505,23.7,1758.8,red,0.43,7.5,22,23,red
4515795123,8,7,9,0,0,0,0,17585,7.2,19364,213,56,1393,1671,21.3,1758.5,7,8,6,1,1,0,0,16192,7,17693,207,47,-1393,-1671,20.7,1619.2,blue,2.43,1.62,23,13,blue
4510387973,7,1,7,2,1,1,0,16537,7.2,19213,232,53,2954,2444,23.2,1653.7,1,7,0,0,0,0,0,13583,6.8,16769,202,52,-2954,-2444,20.2,1358.3,blue,14,0.14,21,17,blue
4486954946,10,6,11,1,1,0,0,18895,7.2,18495,245,44,3409,1964,24.5,1889.5,6,10,8,0,0,0,0,15486,6.8,16531,180,40,-3409,-1964,18,1548.6,blue,3.5,1.4,23,22,blue
4500400815,4,12,4,0,0,0,0,14370,6.4,15153,167,38,-5228,-6488,16.7,1437,12,4,9,0,0,0,0,19598,7.8,21641,250,69,5228,6488,25,1959.8,red,0.67,5.25,9,57,blue
4388887551,9,4,14,0,0,0,0,18274,7.2,18252,242,57,2422,656,24.2,1827.4,4,9,4,0,0,0,0,15852,7,17596,228,59,-2422,-656,22.8,1585.2,blue,5.75,0.89,31,16,blue
4387753545,11,10,12,1,1,0,0,18286,6.6,16569,183,31,149,-1568,18.3,1828.6,10,11,12,1,0,1,0,18137,7,18137,205,53,-149,1568,20.5,1813.7,blue,2.3,2,19,15,blue
4505469911,7,7,7,1,1,0,0,16352,6.8,18216,224,56,-435,-1431,22.4,1635.2,7,7,7,0,0,0,0,16787,7.2,19647,233,47,435,1431,23.3,1678.7,red,2,2,23,22,red
4518463006,10,8,10,0,0,0,0,17546,7.2,18498,191,44,510,921,19.1,1754.6,8,10,7,1,1,0,0,17036,7,17577,217,51,-510,-921,21.7,1703.6,red,2.5,1.5,43,16,red
4440655415,4,12,5,0,0,0,0,16433,7,18008,227,46,-2203,-2676,22.7,1643.3,12,4,13,1,0,1,0,18636,7.4,20684,204,55,2203,2676,20.4,1863.6,red,0.75,6.25,41,31,red
4492408398,2,3,2,0,0,0,0,15414,7.2,18476,232,68,-304,-1063,23.2,1541.4,3,2,1,1,1,0,0,15718,7.4,19539,237,67,304,1063,23.7,1571.8,blue,1.33,2,38,12,blue
4515778115,7,8,12,0,0,0,0,17737,7,18616,234,44,648,617,23.4,1773.7,8,7,10,1,1,0,0,17089,7,17999,202,51,-648,-617,20.2,1708.9,red,2.38,2.57,18,19,red
4482606346,8,6,11,1,1,0,0,17570,7.2,18879,222,47,1365,1563,22.2,1757,6,8,7,0,0,0,0,16205,6.8,17316,220,52,-1365,-1563,22,1620.5,red,3.17,1.62,20,18,blue
4452033699,7,11,12,0,0,0,0,17131,7.2,18470,242,34,-2550,-1700,24.2,1713.1,11,7,7,0,0,0,1,19681,7.2,20170,258,37,2550,1700,25.8,1968.1,red,1.73,2.57,20,15,red
4525979085,8,6,10,1,0,1,0,17237,6.6,17508,226,40,1932,168,22.6,1723.7,6,8,3,1,1,0,0,15305,6.8,17340,182,48,-1932,-168,18.2,1530.5,red,3,1.12,17,16,blue
4503659177,9,7,11,0,0,0,0,17814,7,18465,206,51,1692,1775,20.6,1781.4,7,9,11,0,0,0,0,16122,6.8,16690,196,42,-1692,-1775,19.6,1612.2,blue,2.86,2,20,16,red
4524685045,8,6,9,1,1,0,0,16738,7.2,19296,214,60,624,1208,21.4,1673.8,6,8,3,0,0,0,0,16114,7,18088,225,33,-624,-1208,22.5,1611.4,blue,2.83,1.12,15,14,red
4526080128,11,3,10,0,0,0,0,18092,7,18652,213,43,4024,2465,21.3,1809.2,3,11,1,1,1,0,0,14068,6.2,16187,212,40,-4024,-2465,21.2,1406.8,blue,7,0.36,18,15,blue
4513514281,6,9,7,0,0,0,0,16522,6.8,17675,223,44,-1128,-2710,22.3,1652.2,9,6,4,1,1,0,0,17650,7.4,20385,224,72,1128,2710,22.4,1765,red,1.44,2.17,13,20,red
4503065925,9,1,15,1,1,0,0,18053,6.8,18267,247,51,4135,1375,24.7,1805.3,1,9,2,0,0,0,0,13918,6.6,16892,211,59,-4135,-1375,21.1,1391.8,blue,24,0.33,16,28,blue
4447295063,10,3,16,0,0,0,0,19475,7.2,18887,233,51,4765,3054,23.3,1947.5,3,10,3,1,1,0,0,14710,6.6,15833,202,52,-4765,-3054,20.2,1471,red,8.67,0.6,17,17,blue
4520552197,12,7,11,1,1,0,0,18693,7.4,19277,206,50,1581,1899,20.6,1869.3,7,12,11,0,0,0,0,17112,6.6,17378,207,44,-1581,-1899,20.7,1711.2,red,3.29,1.5,24,19,blue
4449282228,5,4,7,1,1,0,0,16488,7.2,18632,220,60,1603,1827,22,1648.8,4,5,4,1,0,1,0,14885,6.6,16805,197,44,-1603,-1827,19.7,1488.5,blue,3,1.6,16,21,red
4447643884,8,4,8,0,0,0,0,17531,6.8,18252,230,56,2236,288,23,1753.1,4,8,2,0,0,0,0,15295,6.8,17964,212,48,-2236,-288,21.2,1529.5,red,4,0.75,18,15,blue
4467793261,3,2,3,0,0,0,0,15422,6.8,16988,215,63,1391,214,21.5,1542.2,2,3,3,1,1,0,0,14031,6.8,16774,232,36,-1391,-214,23.2,1403.1,blue,3,1.67,16,18,blue
4472758849,3,6,1,0,0,0,0,15276,7.2,18400,214,59,-1729,-437,21.4,1527.6,6,3,8,1,1,0,0,17005,7,18837,250,52,1729,437,25,1700.5,red,0.67,4.67,37,17,red
4493053223,9,5,12,2,1,1,0,17390,7,17256,196,54,614,-322,19.6,1739,5,9,7,0,0,0,0,16776,6.6,17578,213,48,-614,322,21.3,1677.6,red,4.2,1.33,20,21,blue
4488128761,10,11,10,0,0,0,0,17593,6.8,17439,178,49,-1538,-1233,17.8,1759.3,11,10,15,2,1,1,0,19131,7,18672,201,55,1538,1233,20.1,1913.1,red,1.82,2.6,34,16,blue
4477432389,6,10,7,0,0,0,0,15820,7,18253,203,49,-2116,-1407,20.3,1582,10,6,11,1,1,0,0,17936,7.2,19660,223,44,2116,1407,22.3,1793.6,red,1.3,3.5,35,17,red
4524986663,8,4,5,0,0,0,0,17198,6.8,17495,226,37,2973,1838,22.6,1719.8,4,8,5,1,1,0,0,14225,6.2,15657,141,56,-2973,-1838,14.1,1422.5,blue,3.25,1.12,16,36,blue
4495452428,8,9,7,1,1,0,0,17000,6.8,18009,190,60,-149,427,19,1700,9,8,8,0,0,0,0,17149,7,17582,211,48,149,-427,21.1,1714.9,blue,1.67,2.12,18,18,red
4437780946,6,6,2,0,0,0,0,15196,6.8,18612,209,52,-1240,-76,20.9,1519.6,6,6,6,1,1,0,0,16436,7,18688,210,68,1240,76,21,1643.6,red,1.33,2,22,15,red
4467109109,5,12,3,0,0,0,0,16358,6.8,17640,206,56,-2651,-1695,20.6,1635.8,12,5,14,0,0,0,0,19009,7.2,19335,218,64,2651,1695,21.8,1900.9,blue,0.67,5.2,19,21,blue
4527532264,9,10,13,1,1,0,0,17469,6.8,16911,195,45,-1022,-1200,19.5,1746.9,10,9,13,0,0,0,0,18491,6.8,18111,248,33,1022,1200,24.8,1849.1,blue,2.2,2.56,17,18,blue
4523862114,7,2,4,1,1,0,0,16031,6.8,17458,218,55,1643,882,21.8,1603.1,2,7,0,0,0,0,0,14388,6.6,16576,225,48,-1643,-882,22.5,1438.8,blue,5.5,0.29,25,24,red
4505508838,6,5,7,1,1,0,0,17070,7.2,18971,223,73,760,995,22.3,1707,5,6,6,0,0,0,0,16310,6.8,17976,230,39,-760,-995,23,1631,red,2.6,1.83,22,41,blue
4520879353,3,6,3,0,0,0,0,14782,6.8,17600,238,44,-1454,-1276,23.8,1478.2,6,3,6,1,1,0,0,16236,7.2,18876,204,63,1454,1276,20.4,1623.6,red,1,4,55,46,red
4439683972,5,3,7,1,0,1,0,16610,7.4,19266,246,56,1875,2074,24.6,1661,3,5,3,1,1,0,0,14735,6.8,17192,207,52,-1875,-2074,20.7,1473.5,blue,4,1.2,21,15,blue
4509942464,8,4,11,1,1,0,0,17255,7,18288,237,43,2116,1613,23.7,1725.5,4,8,5,0,0,0,0,15139,6.6,16675,203,52,-2116,-1613,20.3,1513.9,blue,4.75,1.12,20,18,red
4476872627,3,3,5,0,0,0,0,14259,6.4,15830,202,38,-1034,-846,20.2,1425.9,3,3,0,1,1,0,0,15293,6.6,16676,229,54,1034,846,22.9,1529.3,red,2.67,1,17,16,red
4461601408,7,6,7,0,0,0,0,16100,7,18918,223,45,-577,-679,22.3,1610,6,7,3,2,1,1,0,16677,7,19597,237,72,577,679,23.7,1667.7,red,2.33,1.29,59,9,blue
4465670561,13,1,18,1,1,0,0,19641,7.4,19614,207,57,6310,5136,20.7,1964.1,1,13,3,0,0,0,0,13331,6,14478,199,40,-6310,-5136,19.9,1333.1,blue,31,0.31,41,15,blue
4487544750,8,5,8,1,1,0,0,17346,7,18654,208,52,1482,1629,20.8,1734.6,5,8,6,0,0,0,0,15864,6.8,17025,211,47,-1482,-1629,21.1,1586.4,blue,3.2,1.38,31,19,red
4526044694,3,3,3,0,0,0,0,16002,7.2,19380,230,64,787,1089,23,1600.2,3,3,2,1,1,0,0,15215,7.2,18291,231,60,-787,-1089,23.1,1521.5,blue,2,1.67,18,16,red
4523956111,4,0,6,1,1,0,0,16070,7.2,19798,236,72,2170,2480,23.6,1607,0,4,0,0,0,0,0,13900,6.8,17318,240,48,-2170,-2480,24,1390,blue,12.03,0,14,13,blue
4500743979,2,10,1,0,0,0,0,14227,6.6,16822,205,44,-2617,-2322,20.5,1422.7,10,2,11,1,1,0,0,16844,7.2,19144,208,40,2617,2322,20.8,1684.4,red,0.3,10.5,15,16,red
4483174323,10,2,13,0,0,0,0,18715,7.2,19675,226,67,4058,3407,22.6,1871.5,2,10,2,0,0,0,0,14657,6.6,16268,229,44,-4058,-3407,22.9,1465.7,blue,11.5,0.4,35,15,blue
4515249145,9,8,9,1,1,0,0,17375,6.8,18035,217,50,238,368,21.7,1737.5,8,9,11,0,0,0,0,17137,6.8,17667,207,40,-238,-368,20.7,1713.7,blue,2.25,2.11,21,25,blue
4472433085,3,7,3,0,0,0,0,15162,6.8,18046,227,56,-1980,-973,22.7,1516.2,7,3,5,0,0,0,0,17142,7.2,19019,256,56,1980,973,25.6,1714.2,red,0.86,4,55,23,red
4524635959,6,6,6,1,1,0,0,15571,6.8,16898,190,60,-1137,-982,19,1557.1,6,6,5,1,0,1,0,16708,7,17880,228,52,1137,982,22.8,1670.8,red,2,1.83,21,18,red
4527297466,4,5,4,1,1,0,0,15070,6.6,17424,218,44,-124,253,21.8,1507,5,4,6,0,0,0,0,15194,6.8,17171,198,52,124,-253,19.8,1519.4,blue,1.6,2.75,19,14,blue
4527291288,12,4,14,2,1,1,0,18723,7.2,18851,190,59,2246,1265,19,1872.3,4,12,5,0,0,0,0,16477,6.8,17586,227,45,-2246,-1265,22.7,1647.7,blue,6.5,0.75,35,13,blue
4510540123,8,9,7,1,0,1,0,17258,7,18755,214,40,-978,78,21.4,1725.8,9,8,8,1,1,0,0,18236,7.2,18677,207,61,978,-78,20.7,1823.6,red,1.67,2.12,34,13,blue
4466252369,5,6,4,1,0,1,0,16103,7.2,18747,208,55,-2659,88,20.8,1610.3,6,5,11,0,0,0,1,18762,7.4,18659,245,52,2659,-88,24.5,1876.2,red,1.5,3.4,14,17,blue
4487485538,3,9,1,1,0,1,0,14709,6.8,17193,207,56,-3224,-1270,20.7,1470.9,9,3,16,1,1,0,0,17933,7.2,18463,238,34,3224,1270,23.8,1793.3,red,0.44,8.33,19,23,red
4527461215,8,7,10,0,0,0,0,17122,7,17535,204,51,312,-1396,20.4,1712.2,7,8,7,1,1,0,0,16810,7,18931,211,51,-312,1396,21.1,1681,red,2.57,1.75,14,49,blue
4462009562,1,5,0,1,1,0,0,13696,6.8,16789,200,56,-2462,-3352,20,1369.6,5,1,6,1,0,1,0,16158,7.6,20141,202,72,2462,3352,20.2,1615.8,red,0.2,11,42,22,blue
4494610937,9,3,7,1,1,0,0,17764,7.4,19589,235,60,2617,2411,23.5,1776.4,3,9,2,0,0,0,0,15147,6.6,17178,220,56,-2617,-2411,22,1514.7,blue,5.33,0.56,17,35,blue
4526117420,4,3,3,0,0,0,0,16275,7.4,19461,244,60,846,1138,24.4,1627.5,3,4,1,0,0,0,0,15429,7.2,18323,233,60,-846,-1138,23.3,1542.9,blue,2.33,1,20,18,blue
4489477420,11,2,12,2,1,1,1,20124,7.4,19495,230,65,6450,5057,23,2012.4,2,11,2,0,0,0,0,13674,6,14438,205,24,-6450,-5057,20.5,1367.4,blue,11.5,0.36,31,17,blue
4527015583,6,11,4,0,0,0,0,15775,6.8,17025,206,44,-2861,-1651,20.6,1577.5,11,6,14,1,1,0,0,18636,7,18676,210,52,2861,1651,21,1863.6,red,0.91,4.17,15,18,red
4468265290,6,6,2,2,1,1,0,15693,6.6,17206,199,56,355,818,19.9,1569.3,6,6,5,0,0,0,0,15338,6.6,16388,192,48,-355,-818,19.2,1533.8,blue,1.33,1.83,22,19,blue
4526405689,7,2,8,0,0,0,0,17479,7,18923,246,41,2305,482,24.6,1747.9,2,7,0,2,1,1,0,15174,7.2,18441,226,72,-2305,-482,22.6,1517.4,blue,7.5,0.29,14,17,blue
4526061513,9,10,9,1,0,1,0,17840,7.2,19273,226,45,-359,784,22.6,1784,10,9,9,1,1,0,0,18199,7,18489,207,50,359,-784,20.7,1819.9,blue,1.8,2.11,16,19,red
4526999717,5,6,8,0,0,0,0,15259,6.6,15471,180,52,-3967,-3114,18,1525.9,6,5,8,0,0,0,2,19226,7,18585,247,60,3967,3114,24.7,1922.6,red,2.17,2.8,19,13,red
4473464467,4,11,3,1,1,0,0,15225,6.2,16104,187,45,-5182,-3884,18.7,1522.5,11,4,9,1,0,1,2,20407,7.4,19988,246,53,5182,3884,24.6,2040.7,red,0.64,5,14,14,red
4487090574,9,4,11,0,0,0,0,17312,7,19125,217,44,2344,1517,21.7,1731.2,4,9,4,0,0,0,0,14968,6.8,17608,201,59,-2344,-1517,20.1,1496.8,blue,5,0.89,18,43,blue
4459502847,8,4,10,1,0,1,0,16696,7,17832,206,44,865,1006,20.6,1669.6,4,8,3,0,0,0,0,15831,6.6,16826,220,39,-865,-1006,22,1583.1,red,4.5,0.88,17,11,red
4467884728,6,7,6,0,0,0,0,16690,7.2,18319,235,47,-516,-3,23.5,1669,7,6,9,1,1,0,0,17206,7,18322,235,54,516,3,23.5,1720.6,blue,1.71,2.67,22,19,red
4527229646,5,6,3,0,0,0,0,16225,7,18754,219,54,-38,1167,21.9,1622.5,6,5,8,0,0,0,0,16263,6.8,17587,239,32,38,-1167,23.9,1626.3,red,1.33,2.8,44,15,red
4459776671,4,8,8,0,0,0,0,15720,6.4,15834,212,44,-2510,-4246,21.2,1572,8,4,5,2,1,1,0,18230,7.2,20080,249,75,2510,4246,24.9,1823,red,1.5,3.25,17,45,blue
4527324320,2,13,2,0,0,0,0,13738,6.4,15483,169,52,-6260,-3364,16.9,1373.8,13,2,15,0,0,0,0,19998,7,18847,238,34,6260,3364,23.8,1999.8,red,0.31,14,21,43,red
4496739291,10,5,7,1,1,0,0,18240,7,19116,259,31,2953,1980,25.9,1824,5,10,4,0,0,0,0,15287,6.8,17136,197,64,-2953,-1980,19.7,1528.7,blue,3.4,0.9,19,19,blue
4494914553,6,4,7,1,1,0,0,16439,7.2,18635,220,56,1603,1799,22,1643.9,4,6,1,1,0,1,0,14836,6.6,16836,213,51,-1603,-1799,21.3,1483.6,blue,3.25,0.83,16,113,blue
4439615787,4,7,3,0,0,0,0,15761,7,18196,253,32,-1454,-1205,25.3,1576.1,7,4,6,0,0,0,0,17215,7.2,19401,233,48,1454,1205,23.3,1721.5,red,1,3.25,15,16,blue
4489643108,9,8,10,1,0,1,0,18529,7.2,18459,227,57,1550,910,22.7,1852.9,8,9,11,1,1,0,0,16979,6.6,17549,206,51,-1550,-910,20.6,1697.9,red,2.38,2.11,19,21,blue
4417938039,8,10,8,0,0,0,0,16996,6.8,18052,227,44,-1065,626,22.7,1699.6,10,8,13,0,0,0,0,18061,6.8,17426,216,30,1065,-626,21.6,1806.1,red,1.6,2.88,22,23,red
4527181614,10,8,10,0,0,0,0,17665,6.8,17473,207,44,753,-587,20.7,1766.5,8,10,6,0,0,0,0,16912,6.8,18060,191,45,-753,587,19.1,1691.2,blue,2.5,1.4,18,20,blue
4527208167,7,10,5,1,1,0,0,16969,7,18900,198,52,-877,418,19.8,1696.9,10,7,11,0,0,0,0,17846,7.2,18482,229,34,877,-418,22.9,1784.6,blue,1.2,3,89,49,blue
4520578411,2,5,3,1,1,0,0,15474,7.4,19351,244,72,-902,385,24.4,1547.4,5,2,7,1,0,1,0,16376,7.2,18966,237,56,902,-385,23.7,1637.6,red,1,6,22,53,red
4492300291,11,5,15,1,1,0,0,18204,7,18154,186,60,1790,350,18.6,1820.4,5,11,4,0,0,0,0,16414,7,17804,229,57,-1790,-350,22.9,1641.4,blue,5.2,0.82,20,43,red
4500702645,6,5,10,0,0,0,0,17160,7,18228,241,47,1497,717,24.1,1716,5,6,4,1,1,0,0,15663,6.8,17511,218,40,-1497,-717,21.8,1566.3,red,3.2,1.5,25,24,red
4412946059,6,3,4,0,0,0,0,16876,7,18664,256,44,2717,2815,25.6,1687.6,3,6,4,0,0,0,0,14159,6.4,15849,205,43,-2717,-2815,20.5,1415.9,blue,3.33,1.17,23,21,blue
4505362087,10,6,7,0,0,0,0,18129,7.2,19644,230,60,2428,2186,23,1812.9,6,10,9,1,1,0,0,15701,6.8,17458,212,55,-2428,-2186,21.2,1570.1,blue,2.83,1.5,13,39,red
4523866410,6,7,4,0,0,0,0,17210,7.4,19805,243,67,42,1367,24.3,1721,7,6,3,1,1,0,0,17168,7,18438,255,52,-42,-1367,25.5,1716.8,blue,1.43,1.67,21,18,red
4453159239,5,10,3,0,0,0,0,15067,6.6,16500,203,38,-3574,-387,20.3,1506.7,10,5,14,1,0,1,0,18641,6.6,16887,218,40,3574,387,21.8,1864.1,blue,0.8,4.8,16,11,red
4467758598,5,5,4,1,1,0,0,15013,7,17384,198,48,-1008,-717,19.8,1501.3,5,5,6,0,0,0,0,16021,7,18101,225,56,1008,717,22.5,1602.1,red,1.8,2.2,19,19,red
4526476556,7,6,6,0,0,0,0,16946,7.4,19649,221,76,714,1650,22.1,1694.6,6,7,7,0,0,0,0,16232,6.8,17999,215,58,-714,-1650,21.5,1623.2,blue,2.17,1.86,18,17,blue
4508690422,11,5,11,0,0,0,0,18403,7.4,19486,239,48,2239,1539,23.9,1840.3,5,11,4,1,1,0,0,16164,6.6,17947,231,63,-2239,-1539,23.1,1616.4,blue,4.4,0.82,20,26,red
4525929245,2,5,2,1,0,1,0,14115,6.8,16918,199,60,-1909,-1282,19.9,1411.5,5,2,5,1,1,0,0,16024,7,18200,229,52,1909,1282,22.9,1602.4,red,0.8,5,14,16,red
4491198019,2,4,0,0,0,0,0,15321,7,18162,255,55,305,992,25.5,1532.1,4,2,5,1,1,0,0,15016,6.8,17170,222,40,-305,-992,22.2,1501.6,blue,0.5,4.5,21,58,blue
4472346713,5,5,0,0,0,0,0,15850,7,18559,216,52,144,312,21.6,1585,5,5,4,1,1,0,0,15706,7.2,18247,238,56,-144,-312,23.8,1570.6,red,1,1.8,14,17,blue
4526941683,3,1,3,0,0,0,0,15704,7,17817,246,50,789,-175,24.6,1570.4,1,3,2,1,1,0,0,14915,6.8,17992,232,72,-789,175,23.2,1491.5,blue,6,1,15,21,red
4526588067,5,5,7,1,0,1,1,17716,7,17963,216,44,8,-625,21.6,1771.6,5,5,4,1,1,0,0,17708,7.2,18588,249,68,-8,625,24.9,1770.8,blue,2.4,1.8,126,18,red
4525299931,6,7,8,1,0,1,0,16604,7,18077,235,40,-754,-157,23.5,1660.4,7,6,9,0,0,0,0,17358,6.8,18234,243,39,754,157,24.3,1735.8,red,2,2.67,24,28,blue
4468761566,4,8,6,0,0,0,0,14808,6.6,16376,180,42,-3363,-1920,18,1480.8,8,4,7,0,0,0,0,18171,7,18296,212,49,3363,1920,21.2,1817.1,red,1.25,3.75,16,16,blue
4448346419,6,4,8,0,0,0,0,15924,6.8,17006,191,45,-510,-837,19.1,1592.4,4,6,7,1,1,0,0,16434,7,17843,225,60,510,837,22.5,1643.4,blue,3.5,1.83,19,45,red
4516154193,3,5,7,0,0,0,0,14994,6.6,16731,199,41,-1080,-1664,19.9,1499.4,5,3,3,1,0,1,0,16074,7,18395,235,64,1080,1664,23.5,1607.4,red,2,2.67,18,23,blue
4508352698,1,5,0,0,0,0,0,13533,6.4,15497,212,35,-2191,-1498,21.2,1353.3,5,1,9,1,1,0,0,15724,6.8,16995,207,50,2191,1498,20.7,1572.4,red,0.2,14,22,47,red
4522564932,6,3,4,0,0,0,0,18314,7.6,21257,257,76,3274,3262,25.7,1831.4,3,6,3,1,1,0,0,15040,7,17995,195,72,-3274,-3262,19.5,1504,blue,3.33,1,83,44,red
4522607227,4,7,4,0,0,0,0,16387,7.2,18488,235,56,149,210,23.5,1638.7,7,4,9,1,1,0,0,16238,6.8,18278,202,44,-149,-210,20.2,1623.8,red,1.14,4,24,48,red
4502563520,6,6,4,0,0,0,0,15629,6.8,17035,212,42,-317,-27,21.2,1562.9,6,6,11,1,1,0,0,15946,6.8,17062,200,54,317,27,20,1594.6,red,1.67,2.83,25,20,red
4525623661,4,1,1,1,1,0,0,16070,7,18706,251,56,2422,1766,25.1,1607,1,4,3,0,0,0,0,13648,6.6,16940,199,52,-2422,-1766,19.9,1364.8,blue,5,1,15,14,blue
4526492403,4,4,5,1,1,0,0,15596,6.8,18105,223,47,370,-66,22.3,1559.6,4,4,4,0,0,0,0,15226,7,18171,200,51,-370,66,20,1522.6,red,2.25,2,20,50,blue
4452102075,5,2,8,1,1,0,0,17010,7,18660,250,58,2312,1175,25,1701,2,5,2,0,0,0,0,14698,6.6,17485,220,54,-2312,-1175,22,1469.8,blue,6.5,0.8,61,37,blue
4526435733,8,9,10,1,0,1,0,17431,7,17957,208,34,-96,277,20.8,1743.1,9,8,8,1,1,0,0,17527,6.6,17680,215,52,96,-277,21.5,1752.7,red,2,2.12,98,18,red
4511865277,7,11,6,0,0,0,0,16664,6.8,17627,214,48,-2262,-1763,21.4,1666.4,11,7,16,1,1,0,0,18926,7.4,19390,195,60,2262,1763,19.5,1892.6,red,1.18,3.86,47,22,red
4491791821,4,11,5,0,0,0,0,15144,6.4,16164,197,48,-4293,-3731,19.7,1514.4,11,4,18,0,0,0,0,19437,7.4,19895,241,60,4293,3731,24.1,1943.7,red,0.82,7.25,14,17,blue
4526215462,5,6,8,0,0,0,0,15703,6.6,17085,195,53,-1085,-1869,19.5,1570.3,6,5,5,2,1,1,0,16788,7.2,18954,229,48,1085,1869,22.9,1678.8,red,2.17,2.2,20,19,blue
4410578219,10,5,15,0,0,0,0,18062,6.8,17582,220,33,2301,667,22,1806.2,5,10,9,1,1,0,0,15761,6.6,16915,204,52,-2301,-667,20.4,1576.1,blue,5,1.4,47,30,blue
4488986123,7,5,8,1,1,0,0,16787,6.8,17483,208,40,800,-237,20.8,1678.7,5,7,7,0,0,0,0,15987,6.8,17720,236,44,-800,237,23.6,1598.7,red,3,1.71,19,16,red
4447860294,12,10,5,1,0,1,1,19785,7.4,20587,221,63,2510,2517,22.1,1978.5,10,12,10,1,1,0,0,17275,7,18070,213,48,-2510,-2517,21.3,1727.5,blue,1.7,1.67,10,15,red
4499534463,10,5,9,2,1,1,0,18408,7.4,19955,208,73,1917,1186,20.8,1840.8,5,10,4,0,0,0,0,16491,7,18769,211,41,-1917,-1186,21.1,1649.1,blue,3.8,0.9,84,19,blue
4484161363,11,11,13,1,1,0,0,18614,7,18540,208,48,-558,-1482,20.8,1861.4,11,11,15,0,0,0,0,19172,7.6,20022,227,52,558,1482,22.7,1917.2,red,2.18,2.36,20,19,red
4504166210,12,10,12,1,0,1,0,19704,7,18253,209,44,3067,503,20.9,1970.4,10,12,6,1,1,0,0,16637,6.8,17750,174,56,-3067,-503,17.4,1663.7,blue,2.4,1.33,254,17,blue
4488005635,2,5,2,1,1,0,0,15281,6.8,17495,248,52,-1201,-919,24.8,1528.1,5,2,11,0,0,0,0,16482,6.8,18414,247,42,1201,919,24.7,1648.2,red,0.8,8,16,24,red
4525852452,1,3,1,1,1,0,0,13253,6.4,16475,190,51,-2310,-2290,19,1325.3,3,1,1,0,0,0,0,15563,7.4,18765,248,60,2310,2290,24.8,1556.3,red,0.67,4,16,16,red
4486701879,8,8,15,1,1,0,0,17192,7,17774,190,59,203,557,19,1719.2,8,8,14,0,0,0,0,16989,6.8,17217,235,44,-203,-557,23.5,1698.9,red,2.88,2.75,39,24,red
4527355079,6,5,9,1,1,0,0,16796,6.8,18185,232,34,117,248,23.2,1679.6,5,6,9,0,0,0,0,16679,6.8,17937,221,52,-117,-248,22.1,1667.9,red,3,2.33,24,50,red
4475328452,11,7,10,1,1,0,0,18582,6.8,18084,207,36,2419,1118,20.7,1858.2,7,11,8,0,0,0,0,16163,7,16966,193,52,-2419,-1118,19.3,1616.3,blue,3,1.36,17,19,red
4478115052,6,5,7,1,0,1,0,17098,7.4,20021,243,54,447,919,24.3,1709.8,5,6,6,0,0,0,0,16651,7,19102,220,67,-447,-919,22,1665.1,red,2.6,1.83,44,90,red
4481459325,5,6,5,1,0,1,0,15766,6.8,17649,209,48,-1219,-759,20.9,1576.6,6,5,10,1,1,0,0,16985,7,18408,227,59,1219,759,22.7,1698.5,red,1.67,3.2,25,121,red
4493760439,3,5,3,1,1,0,0,14767,6.8,16754,214,60,-1371,-1951,21.4,1476.7,5,3,4,0,0,0,0,16138,7,18705,256,43,1371,1951,25.6,1613.8,blue,1.2,3,145,26,blue
4494225858,10,3,13,2,1,1,1,18929,7,18674,170,60,3235,1168,17,1892.9,3,10,6,0,0,0,0,15694,7,17506,241,44,-3235,-1168,24.1,1569.4,blue,7.67,0.9,24,37,blue
4465719445,10,5,12,1,1,0,0,18046,7.4,19739,226,52,2299,1804,22.6,1804.6,5,10,5,0,0,0,0,15747,7.2,17935,229,48,-2299,-1804,22.9,1574.7,blue,4.4,1,24,23,blue
4443967905,8,10,6,1,1,0,0,17035,7,17308,204,48,-1556,-3181,20.4,1703.5,10,8,9,0,0,0,0,18591,7.4,20489,213,67,1556,3181,21.3,1859.1,red,1.4,2.38,18,26,red
4478736587,3,7,3,0,0,0,0,15992,6.8,17572,251,52,-1323,-1622,25.1,1599.2,7,3,10,2,1,1,0,17315,7.2,19194,218,60,1323,1622,21.8,1731.5,red,0.86,5.67,17,19,red
4470281902,8,6,11,0,0,0,0,17791,7,18244,216,48,1625,552,21.6,1779.1,6,8,9,1,1,0,0,16166,6.8,17692,215,48,-1625,-552,21.5,1616.6,blue,3.17,1.88,18,18,blue
4526285141,5,4,3,1,1,0,0,16517,6.8,17812,246,49,819,-48,24.6,1651.7,4,5,4,0,0,0,0,15698,7.2,17860,245,57,-819,48,24.5,1569.8,blue,2,1.6,21,16,red
4485867015,7,8,4,1,1,0,0,15863,7,18126,178,58,-735,-742,17.8,1586.3,8,7,3,0,0,0,0,16598,7,18868,231,56,735,742,23.1,1659.8,red,1.38,1.57,17,17,blue
4511796772,5,2,5,0,0,0,0,16779,7,18382,268,52,2386,395,26.8,1677.9,2,5,4,0,0,0,0,14393,7,17987,204,64,-2386,-395,20.4,1439.3,blue,5,1.2,20,16,blue
4445718276,10,9,8,0,0,0,0,17145,6.8,18179,180,43,-1281,-525,18,1714.5,9,10,9,0,0,0,0,18426,7,18704,212,62,1281,525,21.2,1842.6,red,2,1.8,20,36,red
4484453587,4,5,4,0,0,0,0,15161,7,17998,194,72,-786,-837,19.4,1516.1,5,4,3,1,1,0,0,15947,7.2,18835,231,55,786,837,23.1,1594.7,blue,1.6,2,16,18,red
4495666281,6,9,5,1,1,0,0,17451,7,18484,249,59,-224,-1881,24.9,1745.1,9,6,10,0,0,0,0,17675,7.4,20365,205,38,224,1881,20.5,1767.5,blue,1.22,3.17,18,18,blue
4468732592,7,4,10,0,0,0,0,18342,7.4,20325,224,75,2587,2759,22.4,1834.2,4,7,3,1,1,0,0,15755,6.6,17566,213,54,-2587,-2759,21.3,1575.5,blue,4.25,1,21,166,blue
4472857814,5,5,8,1,1,0,0,16498,7,18296,259,50,460,183,25.9,1649.8,5,5,7,0,0,0,0,16038,7,18113,213,53,-460,-183,21.3,1603.8,blue,2.6,2.4,21,14,red
4513491112,3,8,2,0,0,0,0,14975,7,17721,227,40,-3348,-1795,22.7,1497.5,8,3,10,1,0,1,0,18323,7.2,19516,224,58,3348,1795,22.4,1832.3,red,0.62,6,85,41,red
4506444095,9,2,7,1,0,1,0,17017,7,19023,204,50,2350,2705,20.4,1701.7,2,9,3,1,1,0,0,14667,6.6,16318,220,72,-2350,-2705,22,1466.7,blue,8,0.56,20,16,blue
4492236236,2,10,1,0,0,0,0,13872,6.4,17095,197,43,-6115,-3209,19.7,1387.2,10,2,9,0,0,0,0,19987,7.4,20304,264,47,6115,3209,26.4,1998.7,red,0.3,9.5,13,19,red
4494973929,8,8,9,2,1,1,0,17940,7.4,19545,216,68,1340,1826,21.6,1794,8,8,4,0,0,0,0,16600,6.8,17719,219,48,-1340,-1826,21.9,1660,blue,2.12,1.5,90,19,red
4522593287,3,8,4,0,0,0,0,14037,6.2,15309,167,54,-2491,-2521,16.7,1403.7,8,3,6,2,1,1,0,16528,7,17830,202,36,2491,2521,20.2,1652.8,red,0.88,4.67,19,38,blue
4492594471,5,7,6,1,1,0,0,15534,7,17293,207,44,-1109,-1493,20.7,1553.4,7,5,4,0,0,0,0,16643,7.2,18786,223,47,1109,1493,22.3,1664.3,red,1.57,2.2,37,88,blue
4485270113,8,6,11,1,1,0,0,18074,7.4,19942,252,59,1634,1007,25.2,1807.4,6,8,7,0,0,0,0,16440,7,18935,223,56,-1634,-1007,22.3,1644,blue,3.17,1.62,24,17,blue
4507083643,11,8,15,2,1,1,0,17640,6.6,17082,164,45,1252,-271,16.4,1764,8,11,11,0,0,0,0,16388,6.8,17353,176,52,-1252,271,17.6,1638.8,blue,3.25,1.73,16,17,blue
4516192998,3,5,4,1,1,0,0,15539,6.8,17962,241,55,-244,1250,24.1,1553.9,5,3,3,0,0,0,0,15783,6.8,16712,185,43,244,-1250,18.5,1578.3,blue,1.4,2.67,45,43,red
4455227439,9,6,10,1,0,1,0,17854,7,17358,170,61,2180,462,17,1785.4,6,9,6,1,1,0,0,15674,6.8,16896,209,31,-2180,-462,20.9,1567.4,blue,3.17,1.33,15,14,red
4464665757,9,6,10,2,1,1,1,18924,7,18340,216,64,2660,-730,21.6,1892.4,6,9,3,0,0,0,0,16264,7,19070,221,83,-2660,730,22.1,1626.4,blue,3.17,1,16,24,blue
4391439154,10,2,7,1,1,0,0,18828,7.4,20691,244,68,4124,3900,24.4,1882.8,2,10,1,0,0,0,0,14704,6.8,16791,220,56,-4124,-3900,22,1470.4,blue,8.5,0.3,19,16,blue
4298874562,6,6,4,0,0,0,0,16192,7,18524,218,59,34,985,21.8,1619.2,6,6,7,1,1,0,0,16158,6.8,17539,209,41,-34,-985,20.9,1615.8,blue,1.67,2.17,24,17,blue
4500882500,9,9,10,0,0,0,0,17312,6.6,17334,231,35,-674,530,23.1,1731.2,9,9,13,0,0,0,0,17986,6.8,16804,200,52,674,-530,20,1798.6,blue,2.11,2.44,18,14,red
4484733667,3,3,4,0,0,0,0,14951,6.8,17903,225,44,-1036,-942,22.5,1495.1,3,3,3,1,1,0,0,15987,7.2,18845,252,58,1036,942,25.2,1598.7,red,2.33,2,18,18,blue
4513183607,8,6,11,1,1,0,0,17405,7,18074,204,51,1059,-338,20.4,1740.5,6,8,9,0,0,0,0,16346,7,18412,221,36,-1059,338,22.1,1634.6,red,3.17,1.88,50,15,blue
4465443052,12,13,12,0,0,0,0,19201,7,19303,215,56,-1398,-26,21.5,1920.1,13,12,13,1,1,0,1,20599,7.2,19329,215,40,1398,26,21.5,2059.9,blue,1.85,2.17,16,20,blue
4433590023,13,0,14,1,1,0,1,20095,7.6,20229,219,48,6770,4384,21.9,2009.5,0,13,0,0,0,0,0,13325,6.6,15845,199,56,-6770,-4384,19.9,1332.5,blue,12.03,0,23,17,blue
4444418743,3,5,3,1,1,0,0,14799,6.6,17594,227,48,-1302,-611,22.7,1479.9,5,3,6,0,0,0,0,16101,6.8,18205,201,56,1302,611,20.1,1610.1,red,1.2,3.67,19,16,red
4493865570,4,1,3,2,1,1,0,17220,7.4,19745,233,52,3373,2086,23.3,1722,1,4,0,0,0,0,0,13847,7,17659,225,51,-3373,-2086,22.5,1384.7,blue,7,0.25,14,13,blue
4499463282,5,8,6,2,1,1,0,15494,6.4,16228,187,59,-3528,-2277,18.7,1549.4,8,5,8,0,0,0,0,19022,7,18505,260,44,3528,2277,26,1902.2,red,1.38,3.2,20,20,red
4478654416,12,9,17,0,0,0,0,18722,7.2,18687,212,69,941,2107,21.2,1872.2,9,12,7,1,1,0,0,17781,6.6,16580,225,34,-941,-2107,22.5,1778.1,blue,3.22,1.33,17,21,blue
4526156399,5,8,4,0,0,0,0,15440,6.6,16608,209,39,-1404,443,20.9,1544,8,5,12,0,0,0,0,16844,6.6,16165,188,45,1404,-443,18.8,1684.4,blue,1.12,4,13,56,blue
4511011052,19,3,25,0,0,0,1,23278,7.8,22125,240,48,8667,7645,24,2327.8,3,19,7,0,0,0,0,14611,6.2,14480,189,46,-8667,-7645,18.9,1461.1,blue,14.67,0.53,41,18,red
4521091786,6,9,5,1,0,1,0,16525,6.8,18095,204,47,-1782,-972,20.4,1652.5,9,6,11,1,1,0,0,18307,7.2,19067,217,67,1782,972,21.7,1830.7,red,1.22,3.33,15,21,blue
4526935015,6,3,5,1,1,0,0,16638,7.2,18824,212,67,1402,1512,21.2,1663.8,3,6,3,0,0,0,0,15236,6.8,17312,230,52,-1402,-1512,23,1523.6,blue,3.67,1,21,23,blue
4477669847,3,3,3,0,0,0,0,15562,6.8,17070,224,35,472,-797,22.4,1556.2,3,3,3,0,0,0,0,15090,7,17867,222,46,-472,797,22.2,1509,blue,2,2,23,42,blue
4526015422,2,0,4,2,1,1,0,15919,6.6,17737,262,56,1935,411,26.2,1591.9,0,2,0,0,0,0,0,13984,6.6,17326,244,55,-1935,-411,24.4,1398.4,blue,12.03,0,16,20,blue
4500949435,4,6,8,1,0,1,0,15922,7,17677,245,59,-1185,-1150,24.5,1592.2,6,4,7,1,1,0,0,17107,7.2,18827,236,48,1185,1150,23.6,1710.7,red,2,3.25,22,21,red
4497605485,3,5,2,1,1,0,0,15213,6.8,17861,252,47,-388,-325,25.2,1521.3,5,3,3,0,0,0,0,15601,7,18186,209,62,388,325,20.9,1560.1,blue,1,2.67,27,21,red
4505037739,7,3,12,2,1,1,0,16247,6.6,17036,205,55,1768,939,20.5,1624.7,3,7,2,0,0,0,0,14479,6.6,16097,189,48,-1768,-939,18.9,1447.9,red,6.33,0.71,19,14,blue
4519989854,10,3,8,2,1,1,0,19082,7.2,18868,231,60,5391,2596,23.1,1908.2,3,10,2,0,0,0,0,13691,6.2,16272,176,48,-5391,-2596,17.6,1369.1,blue,6,0.5,25,18,blue
4495670658,6,3,8,1,1,0,0,17146,7.2,18930,219,60,2326,1907,21.9,1714.6,3,6,2,0,0,0,0,14820,6.6,17023,206,59,-2326,-1907,20.6,1482,blue,4.67,0.83,21,14,red
4471752713,5,1,7,1,1,0,0,17079,7.6,20271,238,80,2508,1742,23.8,1707.9,1,5,2,0,0,0,0,14571,7.2,18529,249,55,-2508,-1742,24.9,1457.1,blue,12,0.6,57,13,blue
4504512866,6,7,7,0,0,0,0,17330,7,17971,237,52,-365,-1278,23.7,1733,7,6,8,1,1,0,0,17695,7.2,19249,227,63,365,1278,22.7,1769.5,red,1.86,2.5,14,18,blue
4527231679,7,3,7,0,0,0,0,16838,7.2,18339,239,53,1828,302,23.9,1683.8,3,7,0,1,1,0,0,15010,6.8,18037,235,44,-1828,-302,23.5,1501,red,4.67,0.43,15,19,blue
4513896209,8,9,8,1,0,1,0,17424,6.8,17446,220,51,-836,-1109,22,1742.4,9,8,14,0,0,0,0,18260,7.2,18555,211,43,836,1109,21.1,1826,red,1.78,2.88,14,15,blue
4526521494,5,4,9,0,0,0,0,15885,6.8,17840,233,35,-350,626,23.3,1588.5,4,5,5,0,0,0,0,16235,7,17214,221,56,350,-626,22.1,1623.5,red,3.5,1.8,21,20,blue
4526037570,7,4,10,1,1,0,0,16339,7,17365,224,40,457,-959,22.4,1633.9,4,7,3,1,0,1,0,15882,7,18324,254,56,-457,959,25.4,1588.2,red,4.25,1,16,11,blue
4518674001,7,2,10,1,1,0,0,17693,7.2,18485,241,54,3712,2007,24.1,1769.3,2,7,4,0,0,0,0,13981,6.6,16478,196,49,-3712,-2007,19.6,1398.1,blue,8.5,0.86,28,20,blue
4485978471,16,5,21,1,1,0,0,20032,7.4,20277,166,48,3931,4106,16.6,2003.2,5,16,4,0,0,0,0,16101,6.6,16171,198,44,-3931,-4106,19.8,1610.1,blue,7.4,0.56,23,15,blue
4469123840,4,4,5,1,0,1,0,15447,7,17708,201,43,63,261,20.1,1544.7,4,4,1,1,1,0,0,15384,6.8,17447,228,49,-63,-261,22.8,1538.4,blue,2.25,1.25,45,22,red
4439650627,3,8,4,0,0,0,0,14099,6.4,15839,200,32,-4496,-4428,20,1409.9,8,3,10,2,1,1,0,18595,7.4,20267,227,84,4496,4428,22.7,1859.5,red,0.88,6,14,21,red
4484160987,3,6,6,1,1,0,0,15335,6.6,17217,219,49,-839,-82,21.9,1533.5,6,3,5,0,0,0,0,16174,7,17299,225,36,839,82,22.5,1617.4,blue,1.5,3.67,18,16,red
4494108610,2,13,2,0,0,0,0,14198,6.4,15730,195,41,-4030,-2539,19.5,1419.8,13,2,15,0,0,0,0,18228,7,18269,198,43,4030,2539,19.8,1822.8,red,0.31,14,12,18,red
4518221648,4,6,4,0,0,0,0,15298,6.6,16504,208,47,-1596,-1269,20.8,1529.8,6,4,10,1,1,0,0,16894,6.8,17773,210,52,1596,1269,21,1689.4,blue,1.33,4,16,15,blue
4469155463,4,11,3,1,1,0,0,15564,6.8,17844,236,55,-4523,-3174,23.6,1556.4,11,4,9,1,0,1,1,20087,7.6,21018,231,52,4523,3174,23.1,2008.7,red,0.64,5,86,21,red
4526793849,8,4,2,2,1,1,1,17696,7.2,18812,224,56,1786,2804,22.4,1769.6,4,8,7,0,0,0,0,15910,6.4,16008,200,52,-1786,-2804,20,1591,blue,2.5,1.38,13,21,red
4517828246,6,8,4,1,1,0,0,16047,6.8,18407,214,58,-1495,330,21.4,1604.7,8,6,11,0,0,0,0,17542,6.8,18077,205,54,1495,-330,20.5,1754.2,blue,1.25,3.17,20,17,red
4525867970,3,8,5,0,0,0,0,14112,6.4,15898,216,28,-2834,-2773,21.6,1411.2,8,3,8,1,1,0,0,16946,7,18671,203,44,2834,2773,20.3,1694.6,red,1,5.33,32,51,red
4527044244,3,5,2,0,0,0,0,15314,7,17971,226,45,-888,1328,22.6,1531.4,5,3,3,1,0,1,0,16202,6.8,16643,220,37,888,-1328,22,1620.2,red,1,2.67,17,17,red
4526338952,7,10,11,1,1,0,0,16057,6.8,17123,187,60,-2259,-898,18.7,1605.7,10,7,14,0,0,0,0,18316,6.8,18021,227,32,2259,898,22.7,1831.6,blue,1.8,3.43,21,15,blue
4503188502,6,6,6,0,0,0,0,16266,7,18203,208,40,1300,127,20.8,1626.6,6,6,4,1,1,0,0,14966,7.2,18076,155,66,-1300,-127,15.5,1496.6,blue,2,1.67,29,34,blue
4514213426,4,11,4,1,1,0,0,15168,6.6,16728,197,56,-3764,-1700,19.7,1516.8,11,4,12,0,0,0,0,18932,6.8,18428,198,56,3764,1700,19.8,1893.2,red,0.73,5.75,23,23,red
4493419814,9,10,13,1,0,1,0,17665,6.8,18891,211,44,-1426,-272,21.1,1766.5,10,9,14,1,1,0,0,19091,7.2,19163,214,64,1426,272,21.4,1909.1,blue,2.2,2.67,12,15,blue
4459193358,4,5,2,1,0,1,0,14366,6.8,17267,207,37,-1614,15,20.7,1436.6,5,4,9,1,1,0,0,15980,7,17252,216,62,1614,-15,21.6,1598,red,1.2,3.5,17,17,red
4454250539,11,7,14,0,0,0,0,19106,6.8,17739,189,60,2013,900,18.9,1910.6,7,11,8,0,0,0,0,17093,6.6,16839,188,47,-2013,-900,18.8,1709.3,blue,3.57,1.36,37,18,red
4457538069,0,9,0,1,1,0,0,13850,6.8,16985,217,60,-4513,-2787,21.7,1385,9,0,15,0,0,0,0,18363,7.4,19772,246,53,4513,2787,24.6,1836.3,red,0,12.65,18,27,red
4517636739,7,12,4,0,0,0,0,15633,6.4,16398,188,40,-5271,-4236,18.8,1563.3,12,7,14,2,1,1,0,20904,7.6,20634,269,67,5271,4236,26.9,2090.4,red,0.92,3.71,25,29,red
4501021629,9,8,8,0,0,0,0,17208,6.8,17852,194,36,-197,919,19.4,1720.8,8,9,10,0,0,0,0,17405,6.6,16933,218,40,197,-919,21.8,1740.5,blue,2.12,2,15,11,blue
4505568037,6,6,6,2,1,1,0,15771,6.8,17334,187,59,-2842,-1722,18.7,1577.1,6,6,9,0,0,0,1,18613,7,19056,264,52,2842,1722,26.4,1861.3,red,2,2.5,33,41,blue
4521499585,2,9,2,1,1,0,0,14132,6.8,16898,210,48,-4668,-3772,21,1413.2,9,2,11,1,0,1,0,18800,7.6,20670,226,67,4668,3772,22.6,1880,red,0.44,10,12,13,red
4434070887,14,3,18,1,1,0,0,18413,7.2,19646,196,61,3994,3953,19.6,1841.3,3,14,2,0,0,0,0,14419,6.2,15693,213,40,-3994,-3953,21.3,1441.9,blue,10.67,0.36,19,16,red
4515536564,6,11,6,1,1,0,0,15673,6.6,17330,197,63,-2420,-2518,19.7,1567.3,11,6,10,0,0,0,0,18093,7.4,19848,197,68,2420,2518,19.7,1809.3,red,1.09,3.5,20,19,blue
4461412010,6,1,2,1,1,0,0,17091,7.2,19482,229,64,2805,2754,22.9,1709.1,1,6,1,0,0,0,0,14286,6.6,16728,235,45,-2805,-2754,23.5,1428.6,blue,8,0.33,14,28,blue
4484545103,8,7,7,0,0,0,0,16885,6.6,17748,220,40,-11,-1495,22,1688.5,7,8,6,1,1,0,0,16896,7.2,19243,213,60,11,1495,21.3,1689.6,red,2.14,1.62,17,18,blue
4526866372,3,10,6,0,0,0,0,14836,6.4,16507,214,45,-3421,-2836,21.4,1483.6,10,3,9,1,1,0,0,18257,7.2,19343,229,44,3421,2836,22.9,1825.7,red,0.9,6.33,17,18,red
4459496289,11,8,7,0,0,0,0,18303,7.2,19278,220,52,1142,841,22,1830.3,8,11,7,0,0,0,0,17161,7,18437,201,56,-1142,-841,20.1,1716.1,red,2.25,1.36,18,18,red
4513818469,4,8,8,0,0,0,0,15503,6.8,18406,204,52,-2892,-2716,20.4,1550.3,8,4,6,2,1,1,0,18395,7.6,21122,261,72,2892,2716,26.1,1839.5,red,1.5,3.5,16,15,red
4460468802,3,3,3,1,1,0,0,15398,6.8,17885,227,64,324,231,22.7,1539.8,3,3,1,1,0,1,0,15074,6.8,17654,239,47,-324,-231,23.9,1507.4,blue,2,1.33,23,16,red
4526765875,11,3,15,0,0,0,0,18420,7.4,19497,214,49,3865,3559,21.4,1842,3,11,3,1,1,0,0,14555,6.4,15938,203,46,-3865,-3559,20.3,1455.5,red,8.67,0.55,13,16,blue
4527484965,4,11,5,0,0,0,0,14702,6.6,16103,193,33,-3191,-1620,19.3,1470.2,11,4,17,1,1,0,0,17893,7,17723,219,48,3191,1620,21.9,1789.3,red,0.82,7,20,31,red
4448300044,12,9,8,0,0,0,0,19355,7.6,20151,208,60,2070,1019,20.8,1935.5,9,12,9,0,0,0,0,17285,7.2,19132,217,51,-2070,-1019,21.7,1728.5,blue,2.22,1.5,19,15,blue
4451562288,5,9,4,0,0,0,0,14980,6.8,17318,187,46,-3729,-3285,18.7,1498,9,5,7,1,1,0,0,18709,7.6,20603,257,56,3729,3285,25.7,1870.9,blue,1,3.2,21,24,red
4502876897,6,10,7,2,1,1,0,17520,7.4,19706,239,73,-1127,471,23.9,1752,10,6,10,0,0,0,0,18647,7.2,19235,239,55,1127,-471,23.9,1864.7,blue,1.3,3.33,24,17,blue
4527319271,17,4,25,2,1,1,0,21257,7.4,20163,220,48,6713,5380,22,2125.7,4,17,3,0,0,0,0,14544,6.2,14783,170,51,-6713,-5380,17,1454.4,blue,10.5,0.41,94,13,red
4489954000,3,4,5,1,1,0,0,15565,6.8,17390,227,60,350,-664,22.7,1556.5,4,3,4,1,0,1,0,15215,7,18054,221,52,-350,664,22.1,1521.5,blue,2,2.67,17,18,red
4502464132,7,4,7,1,1,0,0,16723,6.8,17764,193,52,2568,3054,19.3,1672.3,4,7,6,0,0,0,0,14155,6.2,14710,183,28,-2568,-3054,18.3,1415.5,red,3.5,1.43,90,19,blue
4487706140,3,6,2,0,0,0,0,15096,6.8,16516,222,46,-1625,-2418,22.2,1509.6,6,3,10,0,0,0,0,16721,7,18934,236,56,1625,2418,23.6,1672.1,red,0.83,5.33,17,19,blue
4297422468,4,6,0,0,0,0,0,14827,6.6,17370,207,55,-2713,-1237,20.7,1482.7,6,4,11,2,1,1,0,17540,7.2,18607,247,56,2713,1237,24.7,1754,red,0.67,4.25,20,26,red
4519226800,10,4,10,1,1,0,0,17354,7,18530,217,57,1743,2124,21.7,1735.4,4,10,4,0,0,0,0,15611,6.8,16406,236,56,-1743,-2124,23.6,1561.1,blue,5,0.8,25,18,red
4523346192,5,7,5,1,0,1,0,15814,6.8,17936,229,39,-1706,-685,22.9,1581.4,7,5,10,1,1,0,0,17520,7,18621,238,68,1706,685,23.8,1752,red,1.43,3.4,14,16,red
4475412255,5,6,4,0,0,0,0,15882,6.6,17373,231,46,-764,-128,23.1,1588.2,6,5,6,1,1,0,0,16646,6.8,17501,225,43,764,128,22.5,1664.6,red,1.5,2.4,13,11,red
4494892035,3,9,4,0,0,0,0,15331,6.6,16126,212,48,-2436,-3016,21.2,1533.1,9,3,5,1,1,0,0,17767,7.2,19142,237,45,2436,3016,23.7,1776.7,red,0.78,4.67,19,15,red
4511111206,8,14,11,0,0,0,0,17886,6.4,15999,219,32,-1988,-1490,21.9,1788.6,14,8,17,2,1,1,0,19874,6.8,17489,151,48,1988,1490,15.1,1987.4,red,1.36,3.88,20,14,blue
4495247088,5,5,6,1,0,1,0,16897,7.2,18457,218,68,942,952,21.8,1689.7,5,5,4,0,0,0,0,15955,6.8,17505,220,57,-942,-952,22,1595.5,blue,2.2,1.8,16,19,red
4525945422,4,7,4,0,0,0,0,15613,6.6,18046,244,46,-1002,-498,24.4,1561.3,7,4,9,2,1,1,0,16615,7,18544,181,60,1002,498,18.1,1661.5,blue,1.14,4,20,61,blue
4515539649,8,3,15,1,1,0,0,16902,7.2,18641,189,52,1787,1001,18.9,1690.2,3,8,4,1,0,1,0,15115,6.8,17640,222,48,-1787,-1001,22.2,1511.5,blue,7.67,0.88,47,19,blue
4436942531,9,6,10,0,0,0,0,16544,6.6,16417,191,41,1239,568,19.1,1654.4,6,9,8,1,0,1,0,15305,6.4,15849,179,41,-1239,-568,17.9,1530.5,red,3.17,1.56,24,49,blue
4524850374,8,8,8,0,0,0,0,16357,6.6,16464,193,37,-232,97,19.3,1635.7,8,8,8,1,1,0,0,16589,6.6,16367,196,56,232,-97,19.6,1658.9,red,2,2,29,18,red
4518310338,6,3,6,1,1,0,0,16255,7,18434,225,39,974,748,22.5,1625.5,3,6,4,0,0,0,0,15281,7,17686,201,56,-974,-748,20.1,1528.1,blue,4,1.17,17,18,red
4494785966,4,6,7,1,0,1,0,16685,7,18643,236,71,289,-201,23.6,1668.5,6,4,4,1,1,0,0,16396,7,18844,234,52,-289,201,23.4,1639.6,blue,1.83,2.5,17,20,red
4492591291,4,12,3,0,0,0,0,15036,6.4,15796,194,52,-2568,-3931,19.4,1503.6,12,4,8,0,0,0,0,17604,7.4,19727,198,57,2568,3931,19.8,1760.4,red,0.58,5,32,41,red
4527527464,9,5,7,1,0,1,0,17554,7,18464,240,44,2402,2330,24,1755.4,5,9,3,0,0,0,0,15152,6.4,16134,172,54,-2402,-2330,17.2,1515.2,blue,3.2,0.89,20,22,blue
4526022064,6,2,10,1,1,0,0,17066,7,18756,230,61,1998,1200,23,1706.6,2,6,2,0,0,0,0,15068,6.8,17556,253,48,-1998,-1200,25.3,1506.8,red,8,0.67,20,16,red
4495178301,4,3,7,0,0,0,0,15989,6.8,17682,254,48,-77,-1515,25.4,1598.9,3,4,3,2,1,1,0,16066,7,19197,250,74,77,1515,25,1606.6,red,3.67,1.5,22,19,blue
4521643886,7,5,5,0,0,0,0,15984,7,18367,205,49,763,1019,20.5,1598.4,5,7,6,1,1,0,0,15221,6.8,17348,175,54,-763,-1019,17.5,1522.1,blue,2.4,1.57,15,79,blue
4517691436,11,8,12,0,0,0,0,17804,6.8,17743,210,41,1092,806,21,1780.4,8,11,10,0,0,0,0,16712,6.6,16937,208,23,-1092,-806,20.8,1671.2,red,2.88,1.64,16,15,red
4526234314,7,7,9,1,1,0,0,16136,6.4,16071,212,47,436,-475,21.2,1613.6,7,7,6,0,0,0,0,15700,6.8,16546,190,42,-436,475,19,1570,red,2.29,1.86,21,23,red
4499332976,3,7,4,0,0,0,0,14631,6.8,17718,226,41,-2671,-719,22.6,1463.1,7,3,6,1,1,0,0,17302,7,18437,252,48,2671,719,25.2,1730.2,red,1,4.33,47,25,red
4527576450,4,8,3,0,0,0,0,14668,6.6,16865,193,32,-2958,-1446,19.3,1466.8,8,4,9,1,1,0,0,17626,7,18311,232,43,2958,1446,23.2,1762.6,red,0.88,4.25,15,17,red
4513403175,10,1,14,2,1,1,0,19263,7.2,19673,236,59,4739,2119,23.6,1926.3,1,10,0,0,0,0,0,14524,6.8,17554,231,60,-4739,-2119,23.1,1452.4,blue,24,0.1,23,20,blue
4521545433,2,7,2,0,0,0,0,14645,6.8,16717,224,44,-1518,-2542,22.4,1464.5,7,2,4,0,0,0,0,16163,7.2,19259,207,60,1518,2542,20.7,1616.3,blue,0.57,5.5,17,60,blue
4519543034,8,6,7,0,0,0,0,17628,7,18881,233,69,1458,1753,23.3,1762.8,6,8,5,1,1,0,0,16170,7,17128,196,66,-1458,-1753,19.6,1617,blue,2.5,1.38,52,17,blue
4522469111,4,7,8,0,0,0,0,16002,6.6,16283,204,45,98,-786,20.4,1600.2,7,4,8,1,1,0,0,15904,6.6,17069,193,44,-98,786,19.3,1590.4,blue,1.71,3.75,18,20,blue
4505453773,5,12,6,0,0,0,0,15851,6.6,16800,182,56,-3248,-2442,18.2,1585.1,12,5,9,1,1,0,0,19099,7.2,19242,243,44,3248,2442,24.3,1909.9,red,0.92,4.2,48,19,red
4502635512,10,1,9,1,1,0,0,18484,7,19140,230,54,3439,3469,23,1848.4,1,10,1,0,0,0,0,15045,6.4,15671,218,46,-3439,-3469,21.8,1504.5,blue,19,0.2,23,17,blue
4518203153,6,4,8,0,0,0,0,15840,6.8,16689,204,48,-376,-1118,20.4,1584,4,6,4,0,0,0,0,16216,6.8,17807,228,43,376,1118,22.8,1621.6,red,3.5,1.33,28,24,red
4524045722,9,4,8,1,0,1,0,18829,7.2,18693,233,52,4141,2833,23.3,1882.9,4,9,3,0,0,0,0,14688,6.6,15860,198,51,-4141,-2833,19.8,1468.8,blue,4.25,0.78,35,13,blue
4515874786,7,11,8,1,1,0,0,16728,7,17887,191,64,-2358,-1400,19.1,1672.8,11,7,11,1,0,1,0,19086,7.2,19287,211,64,2358,1400,21.1,1908.6,red,1.36,3.14,45,40,red
4513418433,7,13,5,0,0,0,0,15744,6.8,16509,201,48,-3762,-1626,20.1,1574.4,13,7,16,2,1,1,0,19506,6.8,18135,213,52,3762,1626,21.3,1950.6,red,0.92,4.14,21,19,red
4527186536,4,7,5,1,1,0,0,16640,7,18123,223,60,159,-369,22.3,1664,7,4,4,1,0,1,0,16481,7.2,18492,214,44,-159,369,21.4,1648.1,red,1.29,2.75,18,12,blue
4524735926,2,6,0,0,0,0,0,13744,6.8,16719,207,47,-2438,-1929,20.7,1374.4,6,2,5,0,0,0,0,16182,6.8,18648,241,32,2438,1929,24.1,1618.2,red,0.33,5.5,17,38,red
4507384593,8,7,15,0,0,0,0,17885,6.8,17553,216,47,2071,1096,21.6,1788.5,7,8,10,1,1,0,0,15814,6.6,16457,188,36,-2071,-1096,18.8,1581.4,blue,3.29,2.12,20,31,blue
4517776059,10,1,8,1,1,0,0,18646,7,19491,237,49,5148,2922,23.7,1864.6,1,10,0,0,0,0,0,13498,6.4,16569,210,43,-5148,-2922,21,1349.8,blue,18,0.1,20,14,blue
4507316147,2,5,3,0,0,0,0,14219,6.6,16055,213,40,-2405,-1720,21.3,1421.9,5,2,7,0,0,0,0,16624,6.8,17775,235,37,2405,1720,23.5,1662.4,red,1,6,21,51,blue
4521070500,4,3,4,0,0,0,0,15616,6.8,18728,224,40,441,379,22.4,1561.6,3,4,2,0,0,0,0,15175,6.8,18349,230,48,-441,-379,23,1517.5,blue,2.67,1.25,20,17,red
4503463273,10,10,14,1,1,0,1,19177,7,17889,197,60,759,-221,19.7,1917.7,10,10,11,1,0,1,1,18418,7,18110,178,43,-759,221,17.8,1841.8,blue,2.4,2.1,14,16,blue
4513159115,5,4,4,0,0,0,0,15977,7,18445,205,48,898,732,20.5,1597.7,4,5,2,0,0,0,0,15079,7,17713,215,44,-898,-732,21.5,1507.9,red,2.25,1.2,14,20,red
4526758106,9,6,10,2,1,1,0,18302,7.2,18292,228,64,2397,958,22.8,1830.2,6,9,8,0,0,0,0,15905,7,17334,202,40,-2397,-958,20.2,1590.5,blue,3.17,1.56,22,18,blue
4526377831,5,3,9,1,1,0,0,15634,6.8,16928,223,40,1149,1056,22.3,1563.4,3,5,5,0,0,0,0,14485,6.4,15872,208,48,-1149,-1056,20.8,1448.5,blue,4.67,1.6,21,18,red
4521832077,5,5,5,0,0,0,0,16165,7.2,18868,229,52,857,1040,22.9,1616.5,5,5,3,1,1,0,0,15308,7,17828,197,56,-857,-1040,19.7,1530.8,blue,2,1.6,24,19,red
4502257750,6,9,5,0,0,0,0,15900,6.6,16277,208,40,-3237,-2680,20.8,1590,9,6,6,1,0,1,1,19137,7,18957,219,52,3237,2680,21.9,1913.7,red,1.22,2.5,19,42,blue
4516563869,8,6,10,1,1,0,0,17776,6.8,18126,224,45,1072,411,22.4,1777.6,6,8,8,0,0,0,0,16704,6.6,17715,238,51,-1072,-411,23.8,1670.4,blue,3,1.75,18,19,blue
4526678710,9,13,12,1,1,0,0,17597,6.6,16212,188,40,-1522,-1504,18.8,1759.7,13,9,15,0,0,0,0,19119,6.8,17716,185,37,1522,1504,18.5,1911.9,blue,1.62,3.11,23,17,blue
4519687023,2,6,2,0,0,0,0,14071,6.8,16114,231,47,-2633,-1640,23.1,1407.1,6,2,6,1,1,0,0,16704,6.8,17754,238,52,2633,1640,23.8,1670.4,blue,0.67,6,19,17,red
4524566324,8,9,8,1,0,1,0,17380,7.2,18665,220,60,-213,399,22,1738,9,8,14,0,0,0,0,17593,7,18266,215,36,213,-399,21.5,1759.3,red,1.78,2.88,24,15,red
4516104622,3,5,2,0,0,0,0,14666,6.8,17730,215,38,-3315,-2013,21.5,1466.6,5,3,2,2,1,1,1,17981,7.2,19743,257,70,3315,2013,25.7,1798.1,red,1,2.33,20,25,blue
4518398383,11,4,4,1,1,0,0,18232,7.4,19347,231,55,3987,3310,23.1,1823.2,4,11,3,0,0,0,0,14245,6.4,16037,168,40,-3987,-3310,16.8,1424.5,red,3.75,0.64,15,13,blue
4523660012,7,8,8,0,0,0,0,17004,7.2,19083,193,52,-417,81,19.3,1700.4,8,7,7,1,1,0,0,17421,7.2,19002,206,59,417,-81,20.6,1742.1,blue,1.88,2.14,14,41,blue
4519379201,7,17,5,0,0,0,0,15664,6.6,16740,174,48,-4732,-1805,17.4,1566.4,17,7,20,1,1,0,0,20396,7,18545,228,38,4732,1805,22.8,2039.6,blue,0.71,5.29,55,20,red
4522456399,10,8,17,1,0,1,0,18432,7,17701,203,53,1517,-69,20.3,1843.2,8,10,16,1,1,0,0,16915,6.8,17770,193,52,-1517,69,19.3,1691.5,red,3.38,2.4,21,15,blue
4527461738,3,11,3,0,0,0,0,15495,7,17144,231,40,-2609,-2248,23.1,1549.5,11,3,7,1,1,0,0,18104,7,19392,237,56,2609,2248,23.7,1810.4,red,0.55,6,41,22,red
4519749529,5,7,4,1,1,0,0,16318,7.2,18452,234,56,-67,-481,23.4,1631.8,7,5,4,0,0,0,0,16385,7.2,18933,200,66,67,481,20,1638.5,blue,1.29,2.2,19,22,blue
4523069328,5,3,9,1,1,0,0,16123,6.6,17197,204,50,593,-702,20.4,1612.3,3,5,2,0,0,0,0,15530,7,17899,238,60,-593,702,23.8,1553,blue,4.67,1,20,15,blue
4515266360,2,8,2,0,0,0,0,14079,7,17003,207,43,-3388,-1882,20.7,1407.9,8,2,6,1,1,0,0,17467,7.2,18885,239,44,3388,1882,23.9,1746.7,blue,0.5,7,38,17,red
4517634748,9,2,13,1,1,0,0,18081,7.2,19648,214,57,4233,3106,21.4,1808.1,2,9,2,0,0,0,0,13848,6.6,16542,193,45,-4233,-3106,19.3,1384.8,blue,11,0.44,19,21,blue
4527545392,6,8,7,0,0,0,0,16449,6.6,16962,232,48,-167,-395,23.2,1644.9,8,6,9,0,0,0,0,16616,7,17357,196,46,167,395,19.6,1661.6,blue,1.62,2.83,30,26,red
4522806389,2,4,1,0,0,0,0,14947,7,17628,241,52,-2088,-2417,24.1,1494.7,4,2,4,1,1,0,0,17035,7.2,20045,280,68,2088,2417,28,1703.5,red,0.75,4,18,20,blue
4511647215,5,7,8,1,0,1,0,15457,6.6,17048,191,58,-1647,-3035,19.1,1545.7,7,5,7,1,1,0,0,17104,7.4,20083,251,54,1647,3035,25.1,1710.4,red,1.86,2.8,16,17,red
4506455461,5,4,6,1,1,0,0,17129,7.2,18794,256,47,1004,211,25.6,1712.9,4,5,4,0,0,0,0,16125,6.8,18583,234,56,-1004,-211,23.4,1612.5,red,2.75,1.6,14,14,red
4499849238,8,6,7,2,1,1,0,17527,7.2,19414,236,64,1625,1945,23.6,1752.7,6,8,2,0,0,0,0,15902,6.8,17469,208,52,-1625,-1945,20.8,1590.2,blue,2.5,1,27,18,red
4524047354,4,10,3,0,0,0,0,14396,6.6,16065,203,40,-4339,-2857,20.3,1439.6,10,4,4,0,0,0,0,18735,7,18922,234,56,4339,2857,23.4,1873.5,red,0.7,3.5,46,20,red
4521429241,5,8,6,1,1,0,0,16131,7,17821,206,55,-1142,229,20.6,1613.1,8,5,6,1,0,1,0,17273,6.8,17592,221,52,1142,-229,22.1,1727.3,blue,1.38,2.8,32,18,blue
4514713257,10,3,10,0,0,0,0,19476,7.8,20412,262,51,4774,3524,26.2,1947.6,3,10,3,1,1,0,0,14702,6.8,16888,211,43,-4774,-3524,21.1,1470.2,blue,6.67,0.6,18,19,red
4519801172,3,16,5,0,0,0,0,14316,6.2,14965,195,44,-5219,-4005,19.5,1431.6,16,3,23,1,1,0,0,19535,7.2,18970,183,48,5219,4005,18.3,1953.5,red,0.5,13,18,18,blue
4517836453,3,7,3,0,0,0,0,15159,6.6,17052,235,60,-1984,-1530,23.5,1515.9,7,3,16,1,1,0,0,17143,6.8,18582,238,47,1984,1530,23.8,1714.3,blue,0.86,7.67,17,20,blue
4523101614,5,3,2,0,0,0,0,15800,7,18222,236,40,697,700,23.6,1580,3,5,6,1,0,1,0,15103,6.8,17522,209,78,-697,-700,20.9,1510.3,blue,2.33,1.8,15,14,blue
4519799499,5,5,6,0,0,0,0,16780,7,19102,253,63,774,1187,25.3,1678,5,5,7,1,1,0,0,16006,7,17915,233,52,-774,-1187,23.3,1600.6,red,2.2,2.4,23,23,blue
4511553683,7,5,7,1,1,0,0,16424,7,17990,205,60,427,479,20.5,1642.4,5,7,4,0,0,0,0,15997,7,17511,237,44,-427,-479,23.7,1599.7,red,2.8,1.29,18,22,red
4519913894,3,4,2,1,0,1,1,17035,7.2,18941,257,52,1487,617,25.7,1703.5,4,3,6,1,1,0,0,15548,7,18324,223,64,-1487,-617,22.3,1554.8,blue,1.25,3.33,22,21,blue
4523542787,3,5,4,0,0,0,0,14776,6.8,17631,203,64,-1960,-1464,20.3,1477.6,5,3,5,1,1,0,0,16736,7.2,19095,252,56,1960,1464,25.2,1673.6,red,1.4,3.33,18,15,red
4527291064,10,1,15,0,0,0,0,18697,7.2,19162,237,36,4695,2313,23.7,1869.7,1,10,1,0,0,0,0,14002,6.4,16849,235,44,-4695,-2313,23.5,1400.2,blue,25,0.2,14,12,blue
4505590856,3,2,7,0,0,0,0,14452,6.8,16280,202,40,47,-264,20.2,1445.2,2,3,2,1,1,0,0,14405,6.6,16544,226,48,-47,264,22.6,1440.5,red,5,1.33,78,16,blue
4525935490,6,13,6,1,1,0,0,16540,7,18158,235,66,-2145,-917,23.5,1654,13,6,15,1,0,1,0,18685,7.2,19075,193,48,2145,917,19.3,1868.5,red,0.92,4.67,34,17,blue
4515376019,8,6,5,2,1,1,0,16650,6.8,17551,233,37,907,-411,23.3,1665,6,8,3,0,0,0,0,15743,6.6,17962,195,66,-907,411,19.5,1574.3,red,2.17,1.12,20,17,blue
4518369652,7,5,6,1,0,1,0,16887,7,18500,212,39,1564,1214,21.2,1688.7,5,7,5,1,1,0,0,15323,6.6,17286,200,47,-1564,-1214,20,1532.3,blue,2.6,1.43,22,67,blue
4512094452,11,7,12,1,1,0,0,18096,7.2,18860,222,56,686,350,22.2,1809.6,7,11,7,1,0,1,0,17410,7,18510,193,68,-686,-350,19.3,1741,red,3.29,1.27,15,41,red
4491649384,6,4,7,2,1,1,0,16199,7,18445,213,53,531,947,21.3,1619.9,4,6,4,0,0,0,0,15668,6.8,17498,234,40,-531,-947,23.4,1566.8,blue,3.25,1.33,45,14,red
4522848273,6,8,8,1,1,0,0,16956,7,18364,197,72,-506,-228,19.7,1695.6,8,6,9,0,0,0,0,17462,7,18592,234,48,506,228,23.4,1746.2,blue,1.75,2.83,15,16,blue
4523081068,7,8,5,0,0,0,0,15646,7,17325,192,35,-1528,-1421,19.2,1564.6,8,7,8,1,1,0,0,17174,7.2,18746,225,42,1528,1421,22.5,1717.4,blue,1.5,2.29,20,30,red
4522304761,4,6,5,1,0,1,0,15426,7,18021,207,59,-2376,-894,20.7,1542.6,6,4,9,1,1,0,0,17802,7,18915,227,59,2376,894,22.7,1780.2,blue,1.5,3.75,57,45,red
4517734306,6,7,8,0,0,0,0,16308,7,17279,217,48,-313,-1056,21.7,1630.8,7,6,10,1,1,0,0,16621,7,18335,207,59,313,1056,20.7,1662.1,red,2,2.83,17,37,blue
4500690189,4,6,2,0,0,0,0,15293,6.8,17871,204,56,-1306,-998,20.4,1529.3,6,4,9,2,1,1,0,16599,7,18869,221,52,1306,998,22.1,1659.9,red,1,3.75,19,21,blue
4527447311,4,4,4,1,0,1,0,16389,6.6,17526,210,48,997,-1143,21,1638.9,4,4,4,1,1,0,0,15392,7.2,18669,204,72,-997,1143,20.4,1539.2,red,2,2,17,18,blue
4519928092,10,7,9,2,1,1,0,18572,7.2,19279,208,60,1923,734,20.8,1857.2,7,10,4,0,0,0,0,16649,7,18545,205,51,-1923,-734,20.5,1664.9,blue,2.71,1.1,25,16,blue
4524990107,8,6,8,2,1,1,1,18250,7,17742,235,37,2518,860,23.5,1825,6,8,6,0,0,0,0,15732,6.6,16882,216,40,-2518,-860,21.6,1573.2,blue,2.67,1.5,18,16,blue
4517708245,4,12,7,0,0,0,0,15123,6.6,15874,169,48,-4949,-3427,16.9,1512.3,12,4,14,2,1,1,1,20072,7.2,19301,221,56,4949,3427,22.1,2007.2,blue,0.92,6.5,17,20,blue
4501265779,8,6,7,0,0,0,0,16793,6.8,17595,210,36,115,-80,21,1679.3,6,8,6,1,1,0,0,16678,6.8,17675,238,41,-115,80,23.8,1667.8,red,2.5,1.5,14,17,red
4517636448,2,9,1,0,0,0,0,14259,6.4,16277,216,41,-4814,-3701,21.6,1425.9,9,2,14,2,1,1,1,19073,7.4,19978,240,52,4814,3701,24,1907.3,blue,0.33,11.5,14,19,red
4500647186,4,2,4,1,1,0,0,16607,7,19014,261,68,2261,1906,26.1,1660.7,2,4,0,0,0,0,0,14346,6.6,17108,221,52,-2261,-1906,22.1,1434.6,blue,4,0.5,37,21,blue
4509532137,5,14,3,0,0,0,0,15425,6.6,16296,204,31,-2904,-3121,20.4,1542.5,14,5,10,0,0,0,0,18329,7.2,19417,212,48,2904,3121,21.2,1832.9,red,0.57,4.8,25,22,blue
4495631767,9,2,9,2,1,1,1,20464,7.4,19989,251,65,6597,4613,25.1,2046.4,2,9,2,0,0,0,0,13867,6.2,15376,215,40,-6597,-4613,21.5,1386.7,blue,9,0.44,26,17,blue
4526530551,3,7,2,1,1,0,0,14344,6.6,16049,193,63,-4269,-3208,19.3,1434.4,7,3,5,0,0,0,1,18613,7.2,19257,232,63,4269,3208,23.2,1861.3,red,0.71,4,17,21,red
4521258257,4,4,3,0,0,0,0,15936,6.8,16572,229,44,218,-1933,22.9,1593.6,4,4,5,1,1,0,0,15718,7,18505,243,52,-218,1933,24.3,1571.8,blue,1.75,2.25,24,47,blue
4501004124,8,2,9,1,0,1,1,18188,7,18675,208,49,3263,1440,20.8,1818.8,2,8,2,1,1,0,0,14925,6.8,17235,200,68,-3263,-1440,20,1492.5,blue,8.5,0.5,20,19,blue
4516130084,3,6,0,0,0,0,0,14686,6.8,17861,238,44,-3597,-862,23.8,1468.6,6,3,8,1,1,0,1,18283,7,18723,243,52,3597,862,24.3,1828.3,red,0.5,4.67,18,23,red
4521199121,0,4,0,0,0,0,0,14211,7,17395,227,63,-1725,-1169,22.7,1421.1,4,0,7,1,1,0,0,15936,7,18564,230,55,1725,1169,23,1593.6,red,0,12.65,14,53,red
4519589584,4,2,3,0,0,0,0,15995,7.2,19023,220,72,500,64,22,1599.5,2,4,1,2,1,1,0,15495,7,18959,234,68,-500,-64,23.4,1549.5,red,3.5,0.75,19,15,blue
4527490147,3,12,0,0,0,0,0,14798,6.8,17372,225,48,-5533,-2481,22.5,1479.8,12,3,13,0,0,0,0,20331,7.6,19853,233,49,5533,2481,23.3,2033.1,red,0.25,8.33,11,84,red
4524934660,5,1,4,1,1,0,0,15823,7,17964,197,48,2028,1165,19.7,1582.3,1,5,1,0,0,0,0,13795,6.8,16799,205,46,-2028,-1165,20.5,1379.5,blue,9,0.4,20,16,blue
4518531939,2,6,3,0,0,0,0,14874,6.8,16729,232,60,-3131,-1768,23.2,1487.4,6,2,5,2,1,1,1,18005,7.2,18497,221,47,3131,1768,22.1,1800.5,red,0.83,5.5,21,21,blue
4522498340,11,6,10,1,1,0,1,19517,7,18337,216,50,3304,-85,21.6,1951.7,6,11,7,0,0,0,0,16213,7,18422,208,52,-3304,85,20.8,1621.3,blue,3.5,1.18,16,54,blue
4524424750,8,6,6,0,0,0,0,16691,6.8,16656,191,64,-1421,-1364,19.1,1669.1,6,8,7,0,0,0,1,18112,7,18020,237,51,1421,1364,23.7,1811.2,blue,2.33,1.62,20,31,blue
4510772679,5,7,8,0,0,0,0,15328,6.4,16143,191,39,-1980,-3337,19.1,1532.8,7,5,9,1,1,0,0,17308,7,19480,227,60,1980,3337,22.7,1730.8,red,1.86,3.2,43,17,red
4500335888,7,4,5,1,1,0,0,17052,7.2,19250,234,64,1648,1881,23.4,1705.2,4,7,4,0,0,0,0,15404,6.6,17369,223,38,-1648,-1881,22.3,1540.4,blue,3,1.14,16,19,red
4525562740,9,6,6,0,0,0,0,16749,6.6,17028,177,64,239,285,17.7,1674.9,6,9,5,0,0,0,0,16510,6.6,16743,219,59,-239,-285,21.9,1651,blue,2.5,1.22,26,25,blue
4521641335,13,7,13,1,0,1,0,18022,6.8,17168,182,36,1643,2462,18.2,1802.2,7,13,6,1,1,0,1,16379,6.2,14706,153,46,-1643,-2462,15.3,1637.9,blue,3.71,1,48,19,blue
4520493215,5,1,9,0,0,0,0,15675,6.8,17474,198,48,994,-85,19.8,1567.5,1,5,1,1,1,0,0,14681,7,17559,243,66,-994,85,24.3,1468.1,blue,14,0.4,59,17,blue
4492356958,12,12,13,1,1,0,0,19131,7,18354,209,38,-1025,-1860,20.9,1913.1,12,12,9,1,0,1,1,20156,7.6,20214,220,52,1025,1860,22,2015.6,blue,2.08,1.75,21,19,blue
4525623416,2,6,2,1,1,0,0,14294,6.6,17461,220,61,-2820,-2226,22,1429.4,6,2,5,1,0,1,0,17114,7.4,19687,236,49,2820,2226,23.6,1711.4,red,0.67,5.5,22,14,red
4503243020,3,12,3,0,0,0,0,14232,6.6,16592,216,38,-5617,-4035,21.6,1423.2,12,3,17,1,1,0,0,19849,7.6,20627,238,68,5617,4035,23.8,1984.9,red,0.5,9.67,19,17,red
4503318833,4,8,4,0,0,0,0,15715,6.8,17533,229,40,-2733,-2104,22.9,1571.5,8,4,9,2,1,1,0,18448,7.4,19637,237,56,2733,2104,23.7,1844.8,red,1,4.25,14,19,red
4510784617,5,8,2,0,0,0,0,16003,7,18252,221,50,5,185,22.1,1600.3,8,5,7,1,1,0,0,15998,6.8,18067,189,45,-5,-185,18.9,1599.8,red,0.88,3,32,47,blue
4502271780,4,8,2,0,0,0,0,15901,6.8,18288,233,55,-1333,284,23.3,1590.1,8,4,13,1,1,0,0,17234,7,18004,214,40,1333,-284,21.4,1723.4,red,0.75,5.25,11,14,red
4511941552,8,2,9,1,1,0,0,16699,7,18113,238,36,1718,1073,23.8,1669.9,2,8,3,0,0,0,0,14981,6.8,17040,225,56,-1718,-1073,22.5,1498.1,blue,8.5,0.62,23,19,red
4500284767,6,7,9,1,1,0,0,16269,7,17222,222,44,-2132,-2887,22.2,1626.9,7,6,5,1,0,1,0,18401,7.4,20109,255,55,2132,2887,25.5,1840.1,red,2.14,2,17,19,blue
4515642835,16,5,17,1,1,0,0,21297,7.2,19371,221,42,6439,4362,22.1,2129.7,5,16,7,1,0,1,0,14858,6.2,15009,165,43,-6439,-4362,16.5,1485.8,blue,6.6,0.75,15,14,blue
4527476599,3,7,3,2,1,1,0,14618,6.6,16828,199,56,-2564,-2469,19.9,1461.8,7,3,6,0,0,0,0,17182,7,19297,244,58,2564,2469,24.4,1718.2,red,0.86,4.33,18,20,red
4524320720,4,10,3,1,1,0,0,15571,6.8,17116,228,63,-3481,-1919,22.8,1557.1,10,4,13,1,0,1,0,19052,7.4,19035,258,36,3481,1919,25.8,1905.2,red,0.7,5.75,34,18,red
4518579110,9,7,8,0,0,0,0,19087,7.2,19779,250,60,2350,1981,25,1908.7,7,9,7,1,1,0,0,16737,7,17798,216,42,-2350,-1981,21.6,1673.7,red,2.43,1.56,22,22,blue
4510930403,3,11,3,0,0,0,0,14731,6.6,16187,193,36,-3804,-2878,19.3,1473.1,11,3,17,1,1,0,0,18535,7.4,19065,217,44,3804,2878,21.7,1853.5,red,0.55,9.33,23,48,blue
4508104960,8,2,11,1,1,0,0,17375,7,18886,241,38,2804,2924,24.1,1737.5,2,8,3,0,0,0,0,14571,6.6,15962,226,40,-2804,-2924,22.6,1457.1,blue,9.5,0.62,23,19,blue
4515181704,7,4,3,0,0,0,0,17116,7.2,18779,245,52,951,-101,24.5,1711.6,4,7,3,1,0,1,0,16165,7.2,18880,252,53,-951,101,25.2,1616.5,blue,2.5,1,20,17,blue
4502568283,7,7,8,2,1,1,1,19435,7.4,19608,248,63,2831,1855,24.8,1943.5,7,7,6,0,0,0,0,16604,6.8,17753,197,48,-2831,-1855,19.7,1660.4,blue,2.14,1.86,18,16,red
4527497632,7,14,5,0,0,0,0,16467,6.6,16438,190,41,-4264,-4127,19,1646.7,14,7,19,1,1,0,0,20731,7.4,20565,245,44,4264,4127,24.5,2073.1,blue,0.86,4.71,23,38,blue
4520326449,8,7,10,0,0,0,0,17409,6.8,18491,259,40,2006,617,25.9,1740.9,7,8,4,1,1,0,0,15403,7,17874,183,52,-2006,-617,18.3,1540.3,blue,2.57,1.38,23,43,blue
4525574521,5,3,8,2,1,1,0,17492,7.4,19477,244,59,1708,419,24.4,1749.2,3,5,3,0,0,0,0,15784,7.2,19058,237,54,-1708,-419,23.7,1578.4,red,4.33,1.2,50,102,blue
4527045294,6,11,8,0,0,0,0,16536,6.8,16917,232,41,-2018,-2401,23.2,1653.6,11,6,12,1,1,0,0,18554,7,19318,232,48,2018,2401,23.2,1855.4,red,1.27,3.83,20,80,red
4500649869,3,2,3,1,1,0,0,15298,7,17946,232,60,383,-759,23.2,1529.8,2,3,0,0,0,0,0,14915,7.2,18705,233,72,-383,759,23.3,1491.5,blue,3,0.67,16,17,blue
4519483858,5,12,1,0,0,0,0,15217,6.4,16160,193,39,-4199,-3576,19.3,1521.7,12,5,10,1,1,0,0,19416,7.2,19736,270,48,4199,3576,27,1941.6,red,0.5,4.4,22,31,blue
4522487692,3,6,4,0,0,0,0,15930,7,19263,241,71,-1240,-793,24.1,1593,6,3,6,1,1,0,0,17170,7.2,20056,252,64,1240,793,25.2,1717,blue,1.17,4,17,18,red
4518119286,6,6,7,1,1,0,0,16521,6.8,17859,214,56,90,-1069,21.4,1652.1,6,6,3,1,0,1,0,16431,7.2,18928,243,52,-90,1069,24.3,1643.1,blue,2.17,1.5,17,18,blue
4526637754,9,11,14,0,0,0,0,18306,6.8,17828,207,56,737,50,20.7,1830.6,11,9,12,1,1,0,0,17569,7,17778,183,43,-737,-50,18.3,1756.9,blue,2.09,2.56,15,42,blue
4522273476,6,7,4,1,0,1,0,17248,7,19160,242,56,993,1759,24.2,1724.8,7,6,7,1,1,0,0,16255,6.8,17401,192,52,-993,-1759,19.2,1625.5,blue,1.43,2.33,20,22,red
4526094689,7,5,6,0,0,0,0,17327,7,18249,215,60,2281,292,21.5,1732.7,5,7,2,0,0,0,0,15046,7,17957,205,38,-2281,-292,20.5,1504.6,blue,2.6,1,19,49,blue
4525218047,9,9,16,0,0,0,0,17561,6.8,17359,208,40,-778,-1358,20.8,1756.1,9,9,10,1,0,1,0,18339,7.2,18717,231,59,778,1358,23.1,1833.9,blue,2.78,2.11,20,30,blue
4506598189,3,7,2,0,0,0,0,13964,6.6,16677,196,37,-4178,-3371,19.6,1396.4,7,3,7,1,1,0,0,18142,7.4,20048,231,66,4178,3371,23.1,1814.2,red,0.71,4.67,42,58,red
4526845864,4,13,2,0,0,0,0,13337,6,14126,141,43,-6092,-4820,14.1,1333.7,13,4,9,1,1,0,0,19429,7.2,18946,216,53,6092,4820,21.6,1942.9,red,0.46,5.5,16,23,red
4516123957,8,6,16,1,1,0,0,17252,7,18419,197,48,-22,-801,19.7,1725.2,6,8,10,1,0,1,0,17274,7.2,19220,228,64,22,801,22.8,1727.4,red,4,2,22,23,blue
4522182843,8,11,9,0,0,0,0,17735,7.4,18655,203,56,-1421,-1547,20.3,1773.5,11,8,11,0,0,0,0,19156,7.4,20202,246,52,1421,1547,24.6,1915.6,blue,1.55,2.75,16,15,red
4526160406,10,4,12,0,0,0,0,19621,7.6,20681,261,60,4091,2830,26.1,1962.1,4,10,6,1,1,0,0,15530,6.8,17851,202,68,-4091,-2830,20.2,1553,blue,5.5,1,15,16,red
4510825805,8,2,13,1,1,0,0,17226,7.2,18501,224,52,3923,3613,22.4,1722.6,2,8,3,0,0,0,0,13303,6,14888,183,23,-3923,-3613,18.3,1330.3,blue,10.5,0.62,20,16,blue
4526469771,14,5,22,0,0,0,0,19551,7.2,18331,198,43,2896,2001,19.8,1955.1,5,14,6,0,0,0,0,16655,6.6,16330,228,35,-2896,-2001,22.8,1665.5,blue,7.2,0.79,49,18,blue
4527306829,5,10,4,1,1,0,0,16107,6.8,17630,229,54,-2534,-1019,22.9,1610.7,10,5,14,1,0,1,0,18641,7.2,18649,204,41,2534,1019,20.4,1864.1,red,0.9,4.8,13,17,red
4508892154,10,10,10,1,1,0,1,17418,6.2,14242,175,22,774,-188,17.5,1741.8,10,10,12,0,0,0,0,16644,6,14430,143,43,-774,188,14.3,1664.4,red,2,2.2,20,19,blue
4527268691,13,8,12,0,0,0,0,18116,6.8,18447,187,40,838,914,18.7,1811.6,8,13,9,2,1,1,0,17278,7.2,17533,204,44,-838,-914,20.4,1727.8,red,3.12,1.31,19,37,blue
4527664086,7,5,7,2,1,1,0,16058,6.6,16690,158,59,-683,-2098,15.8,1605.8,5,7,3,0,0,0,0,16741,7.4,18788,214,54,683,2098,21.4,1674.1,red,2.8,1.14,39,17,red
4525625460,3,7,4,1,1,0,0,15418,7,17598,232,56,-1540,-313,23.2,1541.8,7,3,10,0,0,0,0,16958,6.8,17911,214,48,1540,313,21.4,1695.8,red,1,5.67,147,20,red
4519757776,4,3,3,1,1,0,0,15988,7,18515,251,52,623,640,25.1,1598.8,3,4,2,1,0,1,0,15365,7,17875,234,56,-623,-640,23.4,1536.5,blue,2.33,1.25,16,16,red
4517767326,1,8,2,0,0,0,0,14012,6.4,15628,211,44,-2447,-1476,21.1,1401.2,8,1,10,0,0,0,0,16459,6.6,17104,198,39,2447,1476,19.8,1645.9,red,0.38,18,12,17,red
4513002559,5,14,9,1,1,0,0,15423,6.8,16791,175,53,-6324,-3885,17.5,1542.3,14,5,14,1,0,1,1,21747,7.6,20676,233,44,6324,3885,23.3,2174.7,blue,1,5.6,19,15,red
4515382430,5,8,7,1,0,1,0,16250,6.8,17847,233,52,-964,-202,23.3,1625,8,5,7,1,1,0,0,17214,6.8,18049,221,44,964,202,22.1,1721.4,blue,1.5,3,28,26,red
4517653649,16,8,27,0,0,0,0,21663,7.4,19484,226,48,3825,2747,22.6,2166.3,8,16,15,0,0,0,0,17838,6.4,16737,216,55,-3825,-2747,21.6,1783.8,blue,5.38,1.44,95,19,red
4525964486,8,9,8,1,1,0,0,17770,7.2,18781,223,76,-379,-662,22.3,1777,9,8,9,1,0,1,0,18149,7,19443,228,52,379,662,22.8,1814.9,red,1.78,2.25,16,15,blue
4520639515,7,10,5,1,0,1,0,17119,6.8,18614,216,44,-977,271,21.6,1711.9,10,7,12,1,1,0,0,18096,7,18343,215,55,977,-271,21.5,1809.6,red,1.2,3.14,22,21,red
4521779426,7,5,12,1,1,0,0,17042,7,18045,223,60,1004,559,22.3,1704.2,5,7,9,0,0,0,0,16038,6.8,17486,182,48,-1004,-559,18.2,1603.8,blue,3.8,2,15,14,blue
4516975993,11,8,9,0,0,0,0,19627,7.4,20041,237,56,2760,3641,23.7,1962.7,8,11,11,1,1,0,0,16867,6.6,16400,167,52,-2760,-3641,16.7,1686.7,red,2.5,1.73,11,15,red
4523041821,5,5,3,2,1,1,0,16344,7.2,19071,227,64,1168,2292,22.7,1634.4,5,5,3,0,0,0,0,15176,6.8,16779,206,38,-1168,-2292,20.6,1517.6,blue,1.6,1.6,21,19,red
4510706463,4,1,2,1,1,0,0,17378,7.2,18286,262,60,3046,442,26.2,1737.8,1,4,2,0,0,0,0,14332,6.8,17844,211,64,-3046,-442,21.1,1433.2,blue,6,0.75,19,15,blue
4519645967,7,6,9,0,0,0,0,17537,7,18384,232,44,1752,830,23.2,1753.7,6,7,4,1,1,0,0,15785,6.8,17554,201,56,-1752,-830,20.1,1578.5,blue,2.67,1.43,15,30,blue
4497727067,3,5,2,0,0,0,0,15195,7,17434,226,61,-713,-653,22.6,1519.5,5,3,6,1,1,0,0,15908,7,18087,232,54,713,653,23.2,1590.8,red,1,3.67,20,20,red
4511928610,5,9,4,0,0,0,0,14987,6.6,15728,199,43,-1913,-1233,19.9,1498.7,9,5,16,1,1,0,0,16900,6.6,16961,202,44,1913,1233,20.2,1690,red,1,5,19,18,blue
4510202032,6,8,5,0,0,0,0,15476,6.8,17206,187,36,-2403,-2787,18.7,1547.6,8,6,9,1,1,0,0,17879,7.4,19993,243,53,2403,2787,24.3,1787.9,red,1.38,2.83,22,144,red
4521225738,2,2,3,1,0,1,0,15714,7,19458,243,68,821,2119,24.3,1571.4,2,2,3,1,1,0,0,14893,6.8,17339,226,56,-821,-2119,22.6,1489.3,red,2.5,2.5,51,68,red
4527584119,9,7,7,1,0,1,0,18026,7.2,18892,229,48,1805,941,22.9,1802.6,7,9,8,1,1,0,0,16221,7,17951,210,49,-1805,-941,21,1622.1,blue,2.29,1.67,12,14,blue
4512893188,8,10,8,0,0,0,0,17180,6.8,17696,216,42,-1249,-1518,21.6,1718,10,8,10,1,1,0,0,18429,7.4,19214,183,54,1249,1518,18.3,1842.9,red,1.6,2.5,17,23,blue
4515598035,4,4,7,1,1,0,0,15550,7,18512,221,64,-44,73,22.1,1555,4,4,5,0,0,0,0,15594,7,18439,216,48,44,-73,21.6,1559.4,blue,2.75,2.25,24,45,blue
4515709123,1,4,1,1,0,1,0,15710,6.8,18022,247,72,1151,1870,24.7,1571,4,1,3,0,0,0,0,14559,6,16152,170,60,-1151,-1870,17,1455.9,blue,0.5,7,14,38,red
4525765947,4,9,6,0,0,0,0,14902,6.8,17309,198,57,-2168,-2144,19.8,1490.2,9,4,9,1,1,0,0,17070,7.2,19453,204,52,2168,2144,20.4,1707,red,1.11,4.5,15,56,blue
4526068721,3,2,4,1,1,0,0,16099,7,18334,227,60,348,-662,22.7,1609.9,2,3,1,0,0,0,0,15751,7.2,18996,247,64,-348,662,24.7,1575.1,blue,3.5,1,18,19,blue
4500361216,3,3,8,0,0,0,0,15667,7,17801,212,64,644,427,21.2,1566.7,3,3,5,1,1,0,0,15023,7,17374,194,64,-644,-427,19.4,1502.3,blue,3.67,2.67,20,65,blue
4520801995,2,10,1,0,0,0,0,15239,7,18073,232,52,-3449,-1995,23.2,1523.9,10,2,13,1,1,0,0,18688,7.6,20068,231,57,3449,1995,23.1,1868.8,red,0.3,11.5,19,17,red
4518540865,12,7,13,0,0,0,0,19049,7.6,20348,225,48,2900,2308,22.5,1904.9,7,12,5,1,1,0,0,16149,6.8,18040,172,52,-2900,-2308,17.2,1614.9,blue,3.57,1,15,15,blue
4508763924,10,12,17,1,1,0,0,17872,7,18662,206,68,-2696,70,20.6,1787.2,12,10,17,1,0,1,1,20568,7.2,18592,245,36,2696,-70,24.5,2056.8,blue,2.25,2.9,23,24,red
4527645576,16,2,15,2,1,1,0,20943,7.4,19895,241,52,7847,5766,24.1,2094.3,2,16,2,0,0,0,0,13096,6,14129,142,52,-7847,-5766,14.2,1309.6,blue,15.5,0.25,16,18,blue
4521551989,1,6,0,0,0,0,0,13167,6,15884,213,31,-3400,-3115,21.3,1316.7,6,1,7,2,1,1,0,16567,7,18999,229,56,3400,3115,22.9,1656.7,red,0.17,13,21,40,red
4509748129,2,5,1,1,1,0,0,14653,6.6,16215,218,52,-1387,-1802,21.8,1465.3,5,2,8,1,0,1,0,16040,6.8,18017,188,61,1387,1802,18.8,1604,red,0.6,6.5,21,58,red
4515220685,6,6,3,0,0,0,0,16780,6.8,18032,244,54,253,-529,24.4,1678,6,6,6,2,1,1,0,16527,7.2,18561,222,58,-253,529,22.2,1652.7,blue,1.5,2,20,23,red
4522393633,4,5,5,1,1,0,0,15453,6.8,17463,191,55,-839,-623,19.1,1545.3,5,4,6,0,0,0,0,16292,6.8,18086,201,49,839,623,20.1,1629.2,red,1.8,2.75,26,52,red
4527030870,9,6,10,2,1,1,1,18768,7,19351,200,48,2945,2977,20,1876.8,6,9,8,0,0,0,0,15823,6.6,16374,215,43,-2945,-2977,21.5,1582.3,blue,3.17,1.56,39,21,blue
4511211862,4,6,6,0,0,0,0,15246,6.6,16921,224,51,-1346,-2280,22.4,1524.6,6,4,10,1,1,0,0,16592,7,19201,221,56,1346,2280,22.1,1659.2,red,1.67,4,21,19,blue
4516109227,6,3,3,1,1,0,0,16658,7,18573,251,42,1951,1640,25.1,1665.8,3,6,3,0,0,0,0,14707,6.6,16933,203,50,-1951,-1640,20.3,1470.7,red,3,1,14,12,red
4511964473,5,7,7,1,1,0,0,15399,6.4,16243,196,48,-2164,-2554,19.6,1539.9,7,5,8,0,0,0,0,17563,7,18797,214,63,2164,2554,21.4,1756.3,red,1.71,3,19,21,blue
4527036536,7,6,9,0,0,0,0,15685,6.6,16091,179,34,-817,-968,17.9,1568.5,6,7,9,0,0,0,0,16502,6.6,17059,209,45,817,968,20.9,1650.2,blue,2.67,2.14,83,18,red
4506848642,6,2,6,1,1,0,0,17303,7,18810,234,64,3643,3695,23.4,1730.3,2,6,3,0,0,0,0,13660,6.2,15115,179,52,-3643,-3695,17.9,1366,blue,6,0.83,24,16,blue
4520661562,10,3,8,1,0,1,0,17555,7.2,19037,242,36,3066,2297,24.2,1755.5,3,10,5,0,0,0,0,14489,6.8,16740,203,43,-3066,-2297,20.3,1448.9,blue,6,0.8,24,21,blue
4511428245,11,9,14,0,0,0,0,19645,7,18468,246,35,2241,1219,24.6,1964.5,9,11,9,1,1,0,0,17404,6.6,17249,203,60,-2241,-1219,20.3,1740.4,blue,2.78,1.64,21,23,blue
4520628924,5,5,5,0,0,0,0,15068,6.6,16740,208,26,-1933,-1659,20.8,1506.8,5,5,10,1,1,0,0,17001,7.2,18399,212,66,1933,1659,21.2,1700.1,red,2,3,17,17,red
4527454700,5,1,7,0,0,0,0,16025,7.4,19176,208,63,1886,2653,20.8,1602.5,1,5,1,1,1,0,0,14139,6.6,16523,219,54,-1886,-2653,21.9,1413.9,blue,12,0.4,17,17,red
4508425453,10,12,5,0,0,0,0,17849,7.2,18632,184,52,-287,255,18.4,1784.9,12,10,9,0,0,0,0,18136,6.8,18377,210,36,287,-255,21,1813.6,blue,1.25,2.1,187,30,red
4524145810,10,8,12,1,1,0,0,17756,7,18320,201,40,-145,-28,20.1,1775.6,8,10,5,0,0,0,0,17901,7,18348,219,59,145,28,21.9,1790.1,blue,2.75,1.3,23,24,blue
4512831945,10,2,11,0,0,0,0,19151,7.4,19146,220,52,5241,3129,22,1915.1,2,10,3,2,1,1,0,13910,6.4,16017,196,51,-5241,-3129,19.6,1391,blue,10.5,0.5,17,17,blue
4494314514,8,2,7,2,1,1,0,17298,7.2,18556,225,48,2975,2627,22.5,1729.8,2,8,3,0,0,0,0,14323,6.4,15929,211,44,-2975,-2627,21.1,1432.3,red,7.5,0.62,49,20,blue
4526910124,7,6,9,0,0,0,0,17740,7,18658,252,37,1419,1036,25.2,1774,6,7,7,2,1,1,0,16321,6.8,17622,215,56,-1419,-1036,21.5,1632.1,red,2.67,1.86,14,18,blue
4513514053,4,6,3,1,1,0,0,14826,6.8,17334,206,59,-2286,-926,20.6,1482.6,6,4,6,0,0,0,0,17112,6.8,18260,232,50,2286,926,23.2,1711.2,red,1.17,3,17,16,red
4521571856,5,3,6,1,1,0,0,16695,7.2,19112,257,56,1551,1481,25.7,1669.5,3,5,3,0,0,0,0,15144,6.8,17631,224,52,-1551,-1481,22.4,1514.4,red,3.67,1.2,21,16,blue
4527448169,3,8,5,0,0,0,0,15259,6.6,17346,206,64,-2738,-1759,20.6,1525.9,8,3,10,1,1,0,0,17997,7.2,19105,251,56,2738,1759,25.1,1799.7,red,1,6,19,24,blue
4518075539,7,8,5,1,0,1,0,16294,6.8,17489,182,58,-1318,-627,18.2,1629.4,8,7,7,0,0,0,0,17612,6.8,18116,237,44,1318,627,23.7,1761.2,blue,1.5,2.14,23,20,red
4516789805,9,4,8,1,0,1,1,19484,7.2,20010,267,52,3538,2904,26.7,1948.4,4,9,4,1,1,0,0,15946,6.6,17106,230,52,-3538,-2904,23,1594.6,blue,4.25,0.89,19,20,red
4513035037,3,10,3,0,0,0,0,14983,7,17248,203,44,-3217,-1601,20.3,1498.3,10,3,12,2,1,1,0,18200,7,18849,223,51,3217,1601,22.3,1820,red,0.6,7.33,28,16,red
4525587151,14,7,11,1,1,0,0,20433,7.4,19171,219,45,4836,2713,21.9,2043.3,7,14,7,0,0,0,0,15597,6.4,16458,165,43,-4836,-2713,16.5,1559.7,blue,3.57,1,19,16,blue
4525245077,10,7,11,2,1,1,0,18256,7,18201,186,58,1489,-192,18.6,1825.6,7,10,7,0,0,0,0,16767,7,18393,247,28,-1489,192,24.7,1676.7,blue,3,1.4,28,20,blue
4501845720,10,4,7,0,0,0,0,18402,7.4,20050,258,48,3311,3166,25.8,1840.2,4,10,5,1,1,0,0,15091,6.6,16884,197,56,-3311,-3166,19.7,1509.1,blue,4.25,0.9,18,18,blue
4525590476,8,6,10,2,1,1,0,17537,7.2,19766,236,60,2008,2714,23.6,1753.7,6,8,5,0,0,0,0,15529,6.8,17052,210,42,-2008,-2714,21,1552.9,blue,3,1.38,25,31,blue
4526831999,4,7,3,1,0,1,1,16359,6.8,17785,229,43,-1112,-41,22.9,1635.9,7,4,7,1,1,0,0,17471,6.8,17826,208,56,1112,41,20.8,1747.1,blue,1,3.5,15,31,red
4499960219,10,6,13,2,1,1,1,19263,7.4,19347,197,50,3840,3165,19.7,1926.3,6,10,8,0,0,0,0,15423,6.4,16182,204,38,-3840,-3165,20.4,1542.3,blue,3.83,1.4,20,24,blue
4519657611,3,12,2,0,0,0,0,15140,6.8,16118,217,60,-5458,-3613,21.7,1514,12,3,13,1,0,1,1,20598,7.4,19731,215,52,5458,3613,21.5,2059.8,red,0.42,8.33,13,85,red
4525356677,5,2,9,1,0,1,0,15574,6.8,16955,206,44,506,-142,20.6,1557.4,2,5,2,1,1,0,0,15068,6.6,17097,229,52,-506,142,22.9,1506.8,blue,7,0.8,56,23,blue
4520912575,9,9,6,0,0,0,0,17299,7,18742,200,43,176,789,20,1729.9,9,9,8,0,0,0,0,17123,7,17953,221,52,-176,-789,22.1,1712.3,red,1.67,1.89,18,19,blue
4525980184,9,5,13,0,0,0,0,18402,7.4,19507,223,68,2582,2732,22.3,1840.2,5,9,5,2,1,1,0,15820,6.8,16775,202,40,-2582,-2732,20.2,1582,blue,4.4,1.11,24,18,red
4517519722,6,5,6,0,0,0,0,16896,7.2,18779,258,46,459,1326,25.8,1689.6,5,6,5,1,1,0,0,16437,7,17453,244,44,-459,-1326,24.4,1643.7,blue,2.4,1.67,61,22,red
4520773672,13,4,17,0,0,0,0,19145,7.2,19160,218,40,4947,3211,21.8,1914.5,4,13,2,1,1,0,0,14198,6.2,15949,203,36,-4947,-3211,20.3,1419.8,red,7.5,0.46,22,19,blue
4520335431,8,2,8,1,1,0,0,18433,7.2,19855,237,54,4759,3279,23.7,1843.3,2,8,3,1,0,1,0,13674,6.6,16576,183,44,-4759,-3279,18.3,1367.4,blue,8,0.62,19,11,blue
4516294607,7,8,7,0,0,0,0,15707,6.8,16724,206,38,-968,-1029,20.6,1570.7,8,7,7,2,1,1,0,16675,6.8,17753,218,43,968,1029,21.8,1667.5,red,1.75,2.14,16,20,red
4518078785,15,7,16,1,0,1,0,20880,7.4,21004,231,41,4294,2560,23.1,2088,7,15,7,1,1,0,0,16586,7,18444,216,61,-4294,-2560,21.6,1658.6,blue,4.43,0.93,15,12,red
4506503377,8,9,8,1,1,0,0,17800,7.2,19759,223,72,-95,194,22.3,1780,9,8,9,0,0,0,0,17895,7,19565,232,52,95,-194,23.2,1789.5,blue,1.78,2.25,17,15,blue
4527581162,9,6,8,1,1,0,1,19585,7.2,19143,244,51,3781,1033,24.4,1958.5,6,9,7,0,0,0,0,15804,7,18110,201,64,-3781,-1033,20.1,1580.4,red,2.83,1.44,99,18,blue
4526239133,2,6,2,0,0,0,0,14836,6.8,17216,210,56,-1704,-1787,21,1483.6,6,2,5,0,0,0,0,16540,7.4,19003,226,64,1704,1787,22.6,1654,blue,0.67,5.5,18,30,red
4517709660,8,9,9,0,0,0,0,17334,6.8,16960,213,45,-729,-192,21.3,1733.4,9,8,12,1,1,0,0,18063,6.8,17152,219,43,729,192,21.9,1806.3,blue,1.89,2.62,23,22,red
4526991608,2,5,2,0,0,0,0,14981,7.2,17943,247,57,-274,-192,24.7,1498.1,5,2,7,0,0,0,0,15255,6.8,18135,214,44,274,192,21.4,1525.5,blue,0.8,6,25,17,red
4526004756,8,6,7,0,0,0,0,16684,6.6,17360,205,40,277,252,20.5,1668.4,6,8,9,1,1,0,0,16407,6.8,17108,202,52,-277,-252,20.2,1640.7,blue,2.5,1.88,21,26,red
4521018486,7,5,2,0,0,0,0,15533,7,17431,186,48,147,582,18.6,1553.3,5,7,9,2,1,1,0,15386,6.6,16849,180,44,-147,-582,18,1538.6,red,1.8,2,19,52,red
4526408967,6,9,7,0,0,0,0,16288,6.8,18071,209,56,-1162,-1007,20.9,1628.8,9,6,7,1,0,1,0,17450,7,19078,204,56,1162,1007,20.4,1745,red,1.44,2.67,18,17,red
4515582537,10,6,9,1,0,1,1,19276,7.2,19395,218,62,3942,2820,21.8,1927.6,6,10,6,0,0,0,0,15334,6.6,16575,189,29,-3942,-2820,18.9,1533.4,blue,3.17,1.2,63,21,blue
4495697514,8,9,15,0,0,0,0,16730,6.6,16831,221,38,-810,-1226,22.1,1673,9,8,10,0,0,0,0,17540,7.2,18057,204,59,810,1226,20.4,1754,blue,2.56,2.38,21,19,blue
4498200376,4,4,4,0,0,0,0,15184,6.8,17480,201,52,-825,-616,20.1,1518.4,4,4,4,0,0,0,0,16009,7.2,18096,210,52,825,616,21,1600.9,blue,2,2,120,24,blue
4516543999,4,5,2,0,0,0,0,15523,7,17886,228,53,-2472,174,22.8,1552.3,5,4,5,1,1,0,1,17995,7,17712,243,49,2472,-174,24.3,1799.5,blue,1.2,2.5,17,21,red
4499739655,6,4,6,0,0,0,0,18072,7.2,19281,281,46,3018,1320,28.1,1807.2,4,6,2,1,1,0,0,15054,7,17961,223,58,-3018,-1320,22.3,1505.4,blue,3,1,21,21,blue
4492581602,9,8,11,2,1,1,0,16839,7,17851,192,51,-125,-962,19.2,1683.9,8,9,5,0,0,0,0,16964,7,18813,211,58,125,962,21.1,1696.4,red,2.5,1.44,15,19,blue
4525333513,6,6,2,0,0,0,0,16047,6.8,17256,218,43,-132,-330,21.8,1604.7,6,6,4,2,1,1,0,16179,6.6,17586,218,64,132,330,21.8,1617.9,blue,1.33,1.67,20,20,red
4521965103,1,2,1,1,0,1,0,13840,6.8,17099,225,44,-2131,-2173,22.5,1384,2,1,1,1,1,0,0,15971,7.2,19272,264,64,2131,2173,26.4,1597.1,red,1,3,21,23,red
4526240730,10,11,18,1,1,0,0,18588,7.4,18787,205,65,432,1389,20.5,1858.8,11,10,12,0,0,0,0,18156,6.8,17398,186,45,-432,-1389,18.6,1815.6,blue,2.55,2.3,18,23,blue
4506509939,7,5,5,1,1,0,0,17301,7.4,19661,251,51,1000,885,25.1,1730.1,5,7,9,0,0,0,0,16301,7.2,18776,220,59,-1000,-885,22,1630.1,blue,2.4,2,20,21,blue
4520302933,7,3,9,2,1,1,1,17669,7,18012,221,47,2925,1304,22.1,1766.9,3,7,5,0,0,0,0,14744,6.6,16708,219,52,-2925,-1304,21.9,1474.4,red,5.33,1.14,52,16,blue
4525341772,8,7,9,1,1,0,0,16786,7.2,19026,244,42,-117,815,24.4,1678.6,7,8,13,1,0,1,0,16903,6.8,18211,223,60,117,-815,22.3,1690.3,red,2.43,2.5,21,22,red
4518276531,1,9,0,0,0,0,0,13806,6.4,15551,216,47,-4145,-3714,21.6,1380.6,9,1,12,2,1,1,0,17951,7.6,19265,232,50,4145,3714,23.2,1795.1,red,0.11,21,21,25,red
4502871772,3,7,1,0,0,0,0,14735,7,18050,213,64,-2483,-1356,21.3,1473.5,7,3,10,1,1,0,0,17218,7.4,19406,228,62,2483,1356,22.8,1721.8,blue,0.57,5.67,14,16,blue
4507588254,10,0,16,0,0,0,0,18059,7,18165,218,44,5224,2715,21.8,1805.9,0,10,0,1,1,0,0,12835,6.4,15450,200,41,-5224,-2715,20,1283.5,blue,12.03,0,20,16,blue
4510185025,3,4,4,1,0,1,0,14759,6.6,17168,229,44,-929,-1819,22.9,1475.9,4,3,4,1,1,0,0,15688,7,18987,223,66,929,1819,22.3,1568.8,red,1.75,2.67,19,19,blue
4515310852,4,1,4,0,0,0,0,15809,7,19160,245,51,1219,1641,24.5,1580.9,1,4,0,1,1,0,0,14590,7,17519,244,62,-1219,-1641,24.4,1459,blue,8,0.25,19,19,red
4504951170,6,7,6,0,0,0,0,16889,6.6,17619,194,68,533,1451,19.4,1688.9,7,6,10,1,0,1,0,16356,6.6,16168,220,48,-533,-1451,22,1635.6,blue,1.71,2.83,14,12,red
4516335736,12,8,11,0,0,0,0,18713,7.2,19848,226,48,1355,1403,22.6,1871.3,8,12,7,1,1,0,0,17358,7.2,18445,196,64,-1355,-1403,19.6,1735.8,blue,2.88,1.25,23,18,blue
4513070256,5,12,4,0,0,0,0,15819,7,18015,199,54,-3176,-2235,19.9,1581.9,12,5,17,1,1,0,0,18995,7.6,20250,222,50,3176,2235,22.2,1899.5,red,0.75,5.8,87,16,red
4516281243,13,4,15,1,0,1,1,19547,6.6,17353,207,44,3967,593,20.7,1954.7,4,13,5,0,0,0,0,15580,6.8,16760,212,51,-3967,-593,21.2,1558,blue,7,0.69,18,19,blue
4526108162,6,4,7,0,0,0,0,16827,7,18478,252,44,2091,2537,25.2,1682.7,4,6,5,1,1,0,0,14736,6.4,15941,201,37,-2091,-2537,20.1,1473.6,blue,3.25,1.5,24,22,red
4526634972,12,3,15,2,1,1,1,20668,7.6,20383,234,52,5767,3366,23.4,2066.8,3,12,6,0,0,0,0,14901,6.8,17017,183,71,-5767,-3366,18.3,1490.1,red,9,0.75,15,16,blue
4527532742,12,6,16,0,0,0,0,18460,7,18568,229,27,2974,2777,22.9,1846,6,12,11,0,0,0,0,15486,6.4,15791,185,43,-2974,-2777,18.5,1548.6,blue,4.67,1.42,42,18,blue
4525580330,5,10,5,1,0,1,0,16063,6.8,17891,195,60,-2368,-1240,19.5,1606.3,10,5,9,1,1,0,0,18431,7.2,19131,233,47,2368,1240,23.3,1843.1,blue,1,3.8,12,15,red
4527420354,8,5,8,1,0,1,1,19558,7.6,20155,223,64,3438,2418,22.3,1955.8,5,8,4,1,1,0,0,16120,6.8,17737,197,60,-3438,-2418,19.7,1612,blue,3.2,1.12,19,54,blue
4527087775,10,5,13,1,0,1,0,18868,7.2,19111,259,44,2461,956,25.9,1886.8,5,10,5,1,1,0,0,16407,6.8,18155,237,52,-2461,-956,23.7,1640.7,blue,4.6,1,19,21,blue
4508799837,6,4,6,1,0,1,1,18625,7.4,19348,240,50,3163,1231,24,1862.5,4,6,6,1,1,0,0,15462,7,18117,230,46,-3163,-1231,23,1546.2,blue,3,1.67,17,18,red
4525956484,5,5,8,0,0,0,0,15930,6.4,15779,210,56,-95,-1474,21,1593,5,5,9,1,1,0,0,16025,6.8,17253,195,52,95,1474,19.5,1602.5,red,2.6,2.8,14,19,blue
4519739017,1,9,0,0,0,0,0,13401,6.4,16144,222,44,-5654,-2236,22.2,1340.1,9,1,11,2,1,1,1,19055,7.2,18380,253,48,5654,2236,25.3,1905.5,red,0.11,20,19,31,red
4526558273,8,9,6,1,1,0,0,16889,6.6,16862,198,52,-696,-1472,19.8,1688.9,9,8,6,0,0,0,0,17585,7,18334,201,54,696,1472,20.1,1758.5,red,1.56,1.88,15,16,blue
4492188937,5,3,6,1,1,0,0,16871,7.4,19422,213,71,1308,1371,21.3,1687.1,3,5,5,0,0,0,0,15563,7,18051,210,64,-1308,-1371,21,1556.3,blue,3.67,1.6,38,14,blue
4525546355,4,8,5,0,0,0,0,15470,7,17547,226,64,-2376,-1482,22.6,1547,8,4,13,1,1,0,0,17846,7.4,19029,248,48,2376,1482,24.8,1784.6,red,1.12,5.25,20,20,red
4526832160,6,7,8,0,0,0,0,15909,6.8,16835,203,44,-3179,-2074,20.3,1590.9,7,6,9,1,0,1,2,19088,7,18909,253,41,3179,2074,25.3,1908.8,blue,2,2.67,17,16,blue
4526226027,3,4,7,1,0,1,0,14996,6.6,16984,221,47,-444,240,22.1,1499.6,4,3,8,1,1,0,0,15440,6.6,16744,197,42,444,-240,19.7,1544,red,2.5,4,62,25,red
4525767247,8,6,7,1,1,0,1,18791,6.8,18424,254,52,2989,1250,25.4,1879.1,6,8,10,0,0,0,0,15802,6.8,17174,188,40,-2989,-1250,18.8,1580.2,blue,2.5,2,19,65,blue
4520412909,6,6,7,0,0,0,0,15805,7.2,18656,216,56,-1134,940,21.6,1580.5,6,6,9,1,1,0,0,16939,7,17716,239,48,1134,-940,23.9,1693.9,red,2.17,2.5,12,18,red
4525762276,8,10,11,1,1,0,0,17541,7,18201,216,52,-862,931,21.6,1754.1,10,8,16,0,0,0,0,18403,7,17270,219,46,862,-931,21.9,1840.3,blue,1.9,3.25,21,130,red
4500969202,0,6,0,1,1,0,0,14439,6.8,17416,264,45,-2696,-2455,26.4,1443.9,6,0,9,0,0,0,0,17135,7.4,19871,250,48,2696,2455,25,1713.5,blue,0,12.65,60,41,red
4517773743,4,9,1,0,0,0,0,14939,6.8,17241,195,68,-4843,-2306,19.5,1493.9,9,4,17,2,1,1,1,19782,7,19547,227,63,4843,2306,22.7,1978.2,red,0.56,6.5,16,41,blue
4519597739,13,8,15,1,0,1,0,19399,6.8,17635,226,34,2348,2115,22.6,1939.9,8,13,4,1,1,0,0,17051,6.4,15520,192,45,-2348,-2115,19.2,1705.1,blue,3.5,0.92,14,19,blue
4526560137,2,6,2,0,0,0,0,14667,6.6,16353,230,44,-2939,-2323,23,1466.7,6,2,7,0,0,0,0,17606,7.2,18676,246,72,2939,2323,24.6,1760.6,red,0.67,6.5,25,24,red
4492511838,10,3,8,1,0,1,0,17802,7.2,19007,222,34,3168,2910,22.2,1780.2,3,10,5,0,0,0,0,14634,6.6,16097,198,52,-3168,-2910,19.8,1463.4,blue,6,0.8,18,17,blue
4521300478,9,6,7,0,0,0,0,18446,7.4,19613,216,60,2200,1607,21.6,1844.6,6,9,8,1,1,0,0,16246,6.8,18006,218,56,-2200,-1607,21.8,1624.6,red,2.67,1.56,46,15,blue
4526481704,6,7,8,0,0,0,0,15779,6.8,17436,186,31,-1219,-737,18.6,1577.9,7,6,10,2,1,1,0,16998,7.2,18173,242,52,1219,737,24.2,1699.8,red,2,2.83,16,17,red
4527328845,2,7,3,0,0,0,0,14695,6.8,16615,222,49,-2240,-4314,22.2,1469.5,7,2,2,1,1,0,0,16935,7.4,20929,249,77,2240,4314,24.9,1693.5,red,0.71,4.5,22,19,blue
4498809510,1,8,0,1,0,1,0,14206,7,17314,218,64,-2855,-1603,21.8,1420.6,8,1,8,1,1,0,0,17061,7,18917,228,56,2855,1603,22.8,1706.1,blue,0.12,16,47,30,red
4523682981,11,2,12,1,1,0,0,19967,7,19474,246,68,5887,4222,24.6,1996.7,2,11,2,0,0,0,0,14080,6.2,15252,209,44,-5887,-4222,20.9,1408,blue,11.5,0.36,18,17,blue
4527579733,5,4,5,2,1,1,1,17284,6.4,16215,185,56,2115,-207,18.5,1728.4,4,5,4,0,0,0,0,15169,6.4,16422,215,38,-2115,207,21.5,1516.9,blue,2.5,1.6,17,15,blue
4526824134,5,8,2,1,1,0,0,15424,6.6,16777,218,48,-1668,-866,21.8,1542.4,8,5,10,0,0,0,0,17092,7.2,17643,191,52,1668,866,19.1,1709.2,blue,0.88,3.6,14,16,red
4522384678,8,12,3,0,0,0,0,16729,6.4,16290,198,44,-1829,-1132,19.8,1672.9,12,8,16,1,1,0,0,18558,7,17422,202,40,1829,1132,20.2,1855.8,red,0.92,3.5,14,16,blue
4526051141,6,9,3,0,0,0,0,15450,6.8,17448,207,31,-1989,-1299,20.7,1545,9,6,9,0,0,0,0,17439,7.2,18747,213,36,1989,1299,21.3,1743.9,red,1,3,18,16,red
4500962702,6,2,8,2,1,1,0,16814,7.2,18759,231,59,1519,1104,23.1,1681.4,2,6,2,0,0,0,0,15295,7,17655,234,52,-1519,-1104,23.4,1529.5,blue,7,0.67,20,17,red
4526104672,8,4,8,2,1,1,0,18230,7.4,20125,246,65,2627,1759,24.6,1823,4,8,4,0,0,0,0,15603,7,18366,241,52,-2627,-1759,24.1,1560.3,blue,4,1,25,23,blue
4526623923,8,4,8,1,1,0,0,16843,6.6,17489,204,40,2198,10,20.4,1684.3,4,8,3,1,0,1,0,14645,6.8,17479,206,43,-2198,-10,20.6,1464.5,blue,4,0.88,19,19,blue
4513041823,10,14,7,1,1,0,0,17916,6.8,17579,182,61,-2437,-1355,18.2,1791.6,14,10,16,0,0,0,0,20353,7.4,18934,175,54,2437,1355,17.5,2035.3,red,1.21,3,17,22,blue
4525358270,10,15,11,0,0,0,0,17318,7,17449,212,52,-3075,-2008,21.2,1731.8,15,10,16,2,1,1,0,20393,7.4,19457,214,52,3075,2008,21.4,2039.3,red,1.4,3.1,17,16,red
4527431280,12,7,17,1,1,0,0,18608,7.4,19209,215,56,1824,1556,21.5,1860.8,7,12,6,0,0,0,0,16784,7,17653,222,43,-1824,-1556,22.2,1678.4,blue,4.14,1.08,17,16,red
4518143538,6,3,8,0,0,0,0,16240,6.6,16345,200,51,2171,960,20,1624,3,6,5,0,0,0,0,14069,6.2,15385,193,47,-2171,-960,19.3,1406.9,blue,4.67,1.33,40,22,blue
4527478355,11,8,17,1,0,1,1,20109,7.2,18733,211,51,2700,1463,21.1,2010.9,8,11,9,0,0,0,0,17409,6.8,17270,231,40,-2700,-1463,23.1,1740.9,blue,3.5,1.55,22,17,red
4518274507,6,8,8,1,1,0,0,15977,6.8,16880,206,47,-588,-1142,20.6,1597.7,8,6,10,0,0,0,0,16565,7,18022,220,44,588,1142,22,1656.5,red,1.75,3,20,57,red
4516106075,3,16,5,1,0,1,0,14511,6.2,14800,158,59,-6887,-5573,15.8,1451.1,16,3,19,1,1,0,0,21398,7.4,20373,248,57,6887,5573,24.8,2139.8,red,0.5,11.67,18,40,red
4526260157,5,4,5,1,1,0,0,16250,7.2,18390,208,68,1170,1415,20.8,1625,4,5,5,0,0,0,0,15080,6.6,16975,205,36,-1170,-1415,20.5,1508,blue,2.5,1.8,22,21,red
4503018701,4,5,5,2,1,1,0,16427,7,18982,250,59,-342,-623,25,1642.7,5,4,5,0,0,0,0,16769,7.2,19605,247,63,342,623,24.7,1676.9,red,1.8,2.5,27,23,blue
4500139038,9,11,16,0,0,0,0,18398,6.8,17918,202,47,1235,-270,20.2,1839.8,11,9,15,1,1,0,0,17163,7,18188,197,48,-1235,270,19.7,1716.3,blue,2.27,2.89,24,48,blue
4520494460,4,7,7,1,1,0,0,15240,6.8,17092,196,60,-1080,-1362,19.6,1524,7,4,6,0,0,0,0,16320,7,18454,220,47,1080,1362,22,1632,blue,1.57,3.25,42,14,red
4510124287,6,6,5,0,0,0,0,17262,7,18939,222,64,1371,2221,22.2,1726.2,6,6,7,1,1,0,0,15891,6.6,16718,195,48,-1371,-2221,19.5,1589.1,blue,1.83,2.17,20,23,red
4522140557,2,4,1,1,1,0,0,14804,7,17557,233,48,-944,-1054,23.3,1480.4,4,2,5,0,0,0,0,15748,7,18611,222,68,944,1054,22.2,1574.8,blue,0.75,4.5,14,18,blue
4520804983,3,12,2,0,0,0,0,14921,6.4,15556,196,54,-3640,-3482,19.6,1492.1,12,3,16,1,1,0,0,18561,7.2,19038,210,58,3640,3482,21,1856.1,red,0.42,9.33,15,16,red
4517922938,7,12,8,1,0,1,0,15523,6.6,16556,179,46,-3825,-1386,17.9,1552.3,12,7,16,1,1,0,0,19348,7.2,17942,217,60,3825,1386,21.7,1934.8,red,1.25,4,16,19,red
4517035921,6,4,8,1,1,0,0,16623,7,18012,243,48,598,-456,24.3,1662.3,4,6,1,1,0,1,0,16025,7,18468,224,56,-598,456,22.4,1602.5,blue,3.5,0.83,19,19,red
4507113802,14,8,20,1,0,1,1,21070,7.2,19275,219,46,4266,2076,21.9,2107,8,14,10,1,1,0,0,16804,7,17199,191,49,-4266,-2076,19.1,1680.4,blue,4.25,1.29,18,17,blue
4509988764,7,8,8,1,1,0,0,16907,7.2,18706,213,46,-28,-28,21.3,1690.7,8,7,10,0,0,0,0,16935,7,18734,227,48,28,28,22.7,1693.5,red,1.88,2.57,19,15,blue
4517488676,11,6,16,1,1,0,0,18003,7,18657,213,51,2647,2948,21.3,1800.3,6,11,7,0,0,0,0,15356,6.6,15709,187,40,-2647,-2948,18.7,1535.6,blue,4.5,1.18,54,14,blue
4526315432,7,11,10,1,1,0,0,17124,6.8,17615,228,43,-1565,-173,22.8,1712.4,11,7,18,0,0,0,0,18689,7,17788,173,58,1565,173,17.3,1868.9,red,1.55,4.14,14,37,red
4506780804,16,5,18,2,1,1,0,19099,7,18143,183,40,3667,1610,18.3,1909.9,5,16,6,0,0,0,0,15432,6.4,16533,200,56,-3667,-1610,20,1543.2,blue,6.8,0.69,23,14,blue
4526865205,4,5,2,0,0,0,0,15538,6.8,18054,223,57,-450,-849,22.3,1553.8,5,4,6,0,0,0,0,15988,7.2,18903,189,56,450,849,18.9,1598.8,blue,1.2,2.75,22,36,blue
4526535381,4,7,3,1,0,1,0,15583,7,17671,210,56,-1108,-570,21,1558.3,7,4,13,1,1,0,0,16691,7,18241,215,56,1108,570,21.5,1669.1,red,1,5,14,23,red
4527260532,10,6,17,0,0,0,0,16982,6.8,17597,187,46,1093,770,18.7,1698.2,6,10,4,0,0,0,0,15889,6.6,16827,222,44,-1093,-770,22.2,1588.9,blue,4.5,1,23,19,red
4527598275,7,8,10,0,0,0,0,16238,6.8,17694,202,50,-982,1441,20.2,1623.8,8,7,10,1,1,0,0,17220,6.6,16253,185,64,982,-1441,18.5,1722,red,2.12,2.57,57,15,red
4525615697,6,5,9,0,0,0,0,16641,7.2,19419,202,75,109,1368,20.2,1664.1,5,6,7,1,1,0,0,16532,6.8,18051,217,59,-109,-1368,21.7,1653.2,red,3,2,62,15,blue
4526041586,9,5,11,0,0,0,0,17318,7.4,19732,221,52,1166,1899,22.1,1731.8,5,9,4,0,0,0,0,16152,7,17833,225,46,-1166,-1899,22.5,1615.2,blue,4,1,20,16,red
4500841248,7,6,7,1,1,0,0,16438,7,17815,214,37,-370,-1681,21.4,1643.8,6,7,7,1,0,1,0,16808,7.4,19496,234,51,370,1681,23.4,1680.8,red,2.33,1.86,39,15,red
4525546902,6,4,3,1,1,0,0,16081,7,18269,232,36,656,553,23.2,1608.1,4,6,5,0,0,0,0,15425,7,17716,205,52,-656,-553,20.5,1542.5,blue,2.25,1.5,16,39,blue
4511640654,5,2,8,0,0,0,0,16385,7,18788,222,68,1421,1097,22.2,1638.5,2,5,4,1,1,0,0,14964,7,17691,215,61,-1421,-1097,21.5,1496.4,blue,6.5,1.2,65,31,red
4526856265,8,5,7,0,0,0,0,17113,7.4,18861,245,47,1176,1300,24.5,1711.3,5,8,6,1,1,0,0,15937,7,17561,225,52,-1176,-1300,22.5,1593.7,red,3,1.38,21,22,blue
4527528290,2,7,3,0,0,0,0,13016,5.6,13166,167,44,-6869,-6365,16.7,1301.6,7,2,6,2,1,1,2,19885,7.2,19531,243,48,6869,6365,24.3,1988.5,red,0.71,6.5,10,14,red
4527487393,5,9,6,0,0,0,0,15863,7,17499,228,46,-1117,-764,22.8,1586.3,9,5,13,1,1,0,0,16980,7,18263,213,42,1117,764,21.3,1698,red,1.22,4.4,41,22,blue
4515393981,5,6,6,2,1,1,1,17843,7,17948,243,48,1895,-224,24.3,1784.3,6,5,6,0,0,0,0,15948,7,18172,207,47,-1895,224,20.7,1594.8,blue,1.83,2.4,22,17,blue
4525540898,6,3,7,1,0,1,0,16421,6.4,16972,207,52,936,-497,20.7,1642.1,3,6,3,1,1,0,0,15485,7.2,17469,231,60,-936,497,23.1,1548.5,blue,4.33,1,16,42,blue
4526163863,2,7,2,0,0,0,0,15739,7,18212,256,53,-1257,-91,25.6,1573.9,7,2,10,1,1,0,0,16996,6.8,18303,234,48,1257,91,23.4,1699.6,red,0.57,8.5,34,17,red
4525239262,7,7,8,0,0,0,0,17181,6.8,18170,231,51,267,162,23.1,1718.1,7,7,9,2,1,1,0,16914,6.8,18008,220,56,-267,-162,22,1691.4,red,2.14,2.29,14,18,blue
4511072676,5,4,6,1,1,0,0,16534,7.2,18294,260,44,131,-613,26,1653.4,4,5,5,0,0,0,0,16403,7,18907,233,64,-131,613,23.3,1640.3,red,2.75,1.8,25,34,red
4526769239,6,6,7,1,1,0,1,18084,7.2,19140,228,48,2139,547,22.8,1808.4,6,6,5,1,0,1,0,15945,7,18593,201,59,-2139,-547,20.1,1594.5,red,2.17,1.83,80,15,red
4524060982,7,6,11,1,1,0,0,17094,6.8,17903,205,44,525,44,20.5,1709.4,6,7,6,0,0,0,0,16569,7,17859,225,48,-525,-44,22.5,1656.9,blue,3,1.71,46,24,red
4527694492,10,3,14,1,1,0,1,18911,6.8,18311,205,48,4335,1377,20.5,1891.1,3,10,4,1,0,1,0,14576,6.6,16934,192,50,-4335,-1377,19.2,1457.6,red,8,0.7,17,16,blue
4506149588,13,3,13,1,0,1,0,18928,7.4,19725,227,55,4184,3694,22.7,1892.8,3,13,2,0,0,0,0,14744,6.6,16031,180,57,-4184,-3694,18,1474.4,blue,8.67,0.38,21,43,blue
4517740459,12,5,13,1,0,1,0,19266,7.4,19920,236,44,3362,2634,23.6,1926.6,5,12,6,0,0,0,0,15904,6.8,17286,204,44,-3362,-2634,20.4,1590.4,blue,5,0.92,16,20,blue
4519211105,1,7,1,0,0,0,0,14415,6.8,17028,238,47,-2534,-3031,23.8,1441.5,7,1,7,0,0,0,0,16949,7.4,20059,233,60,2534,3031,23.3,1694.9,red,0.29,14,125,26,red
4506382089,15,4,12,1,0,1,0,19987,7.2,19679,194,44,4805,3808,19.4,1998.7,4,15,4,1,1,0,0,15182,6.4,15871,194,45,-4805,-3808,19.4,1518.2,blue,6.75,0.53,19,17,blue
4527589405,11,9,11,1,1,0,0,18464,7,18681,234,54,1259,1454,23.4,1846.4,9,11,10,0,0,0,0,17205,6.8,17227,192,47,-1259,-1454,19.2,1720.5,blue,2.44,1.73,32,18,blue
4514848234,7,5,11,0,0,0,0,17467,7.2,19153,244,48,1299,879,24.4,1746.7,5,7,5,0,0,0,0,16168,7,18274,241,43,-1299,-879,24.1,1616.8,red,3.6,1.43,18,39,blue
4526016335,3,5,2,1,0,1,0,14686,7,17187,228,44,-1592,-2117,22.8,1468.6,5,3,3,1,1,0,0,16278,7.2,19304,247,47,1592,2117,24.7,1627.8,red,1,2.67,13,18,red
4517721130,6,3,6,1,1,0,0,17202,7.4,19917,229,64,1360,2274,22.9,1720.2,3,6,3,0,0,0,0,15842,7,17643,220,52,-1360,-2274,22,1584.2,blue,4,1,18,83,blue
4502088283,5,5,5,0,0,0,0,15810,7.2,18914,208,56,-866,388,20.8,1581,5,5,3,1,1,0,0,16676,6.8,18526,253,51,866,-388,25.3,1667.6,blue,2,1.6,48,31,red
4499650964,8,5,9,0,0,0,0,18886,7.2,20642,240,72,3634,3559,24,1888.6,5,8,7,0,0,0,0,15252,6.8,17083,175,50,-3634,-3559,17.5,1525.2,blue,3.4,1.5,16,17,red
4515468468,4,3,5,0,0,0,0,16668,7.2,18572,261,51,1401,85,26.1,1666.8,3,4,4,0,0,0,0,15267,7.2,18487,203,70,-1401,-85,20.3,1526.7,blue,3,1.75,19,39,blue
4527547442,2,11,2,0,0,0,0,13794,6.4,15813,190,55,-4192,-3984,19,1379.4,11,2,9,1,1,0,0,17986,7.2,19797,220,56,4192,3984,22,1798.6,red,0.36,10,18,43,red
4509051206,12,5,13,0,0,0,0,19292,7.2,18153,210,34,4641,2291,21,1929.2,5,12,5,1,1,0,0,14651,6.6,15862,172,52,-4641,-2291,17.2,1465.1,blue,5,0.83,16,18,blue
4526131231,9,6,9,1,1,0,0,17004,6.4,17216,185,44,2253,772,18.5,1700.4,6,9,3,0,0,0,0,14751,6.6,16444,163,44,-2253,-772,16.3,1475.1,red,3,1,18,15,blue
4525777305,7,2,9,2,1,1,0,17231,6.6,17207,240,47,3203,1830,24,1723.1,2,7,2,0,0,0,0,14028,6.2,15377,186,52,-3203,-1830,18.6,1402.8,blue,8,0.57,27,13,blue
4499534916,8,1,5,2,1,1,1,19383,7.6,21403,271,59,4656,3776,27.1,1938.3,1,8,0,0,0,0,0,14727,6.8,17627,249,58,-4656,-3776,24.9,1472.7,blue,13,0.12,22,14,blue
4518121275,7,6,8,1,1,0,0,16417,6.8,17202,205,56,161,130,20.5,1641.7,6,7,11,0,0,0,0,16256,6.8,17072,209,60,-161,-130,20.9,1625.6,blue,2.5,2.43,21,13,blue
4525827145,6,6,10,0,0,0,0,17281,7.2,18317,228,53,-65,-433,22.8,1728.1,6,6,6,1,1,0,0,17346,7.2,18750,246,55,65,433,24.6,1734.6,blue,2.67,2,41,19,red
4525582904,5,7,5,0,0,0,0,15195,6.6,16429,187,59,-2539,-1637,18.7,1519.5,7,5,5,0,0,0,1,17734,6.6,18066,223,40,2539,1637,22.3,1773.4,red,1.43,2.4,20,33,red
4502370552,6,10,8,0,0,0,0,15091,6.2,14181,172,48,-2623,-3436,17.2,1509.1,10,6,15,1,1,0,0,17714,6.8,17617,211,49,2623,3436,21.1,1771.4,blue,1.4,4.17,14,11,blue
4510692119,11,4,17,1,1,0,0,18456,7.2,19034,214,60,2724,2170,21.4,1845.6,4,11,7,0,0,0,0,15732,6.6,16864,218,61,-2724,-2170,21.8,1573.2,blue,7,1,16,49,blue
4519757123,7,2,12,1,1,0,0,17196,7,18109,204,60,2177,186,20.4,1719.6,2,7,0,0,0,0,0,15019,7,17923,237,68,-2177,-186,23.7,1501.9,blue,9.5,0.29,14,16,blue
4500853153,5,11,4,0,0,0,0,15534,6.2,15681,209,43,-2840,-1360,20.9,1553.4,11,5,11,0,0,0,0,18374,7,17041,198,57,2840,1360,19.8,1837.4,red,0.82,4.4,18,19,red
4510897345,5,6,6,1,0,1,0,15067,6.8,17908,201,49,-2718,-1000,20.1,1506.7,6,5,8,1,1,0,0,17785,7,18908,238,64,2718,1000,23.8,1778.5,red,1.83,2.8,22,26,red
4518666053,6,8,6,1,1,0,0,15295,6.4,15416,157,40,-2783,-2017,15.7,1529.5,8,6,5,1,0,1,2,18078,6.6,17433,213,40,2783,2017,21.3,1807.8,red,1.5,2.17,40,23,blue
4519577076,8,12,12,0,0,0,0,18501,6.8,17881,207,60,-939,-2597,20.7,1850.1,12,8,15,1,1,0,0,19440,7.2,20478,214,52,939,2597,21.4,1944,red,1.67,3.38,22,76,red
4526187847,4,10,3,0,0,0,0,15119,6.4,16068,201,28,-3770,-2959,20.1,1511.9,10,4,12,0,0,0,0,18889,7,19027,213,59,3770,2959,21.3,1888.9,red,0.7,5.5,21,15,red
4525555487,4,11,3,0,0,0,0,15294,6.4,16497,202,63,-3442,-2915,20.2,1529.4,11,4,16,0,0,0,0,18736,7.2,19412,221,56,3442,2915,22.1,1873.6,red,0.64,6.75,14,13,blue
4526923386,10,6,10,1,0,1,0,18099,7.4,18678,203,44,3236,3464,20.3,1809.9,6,10,3,0,0,0,0,14863,6.2,15214,163,36,-3236,-3464,16.3,1486.3,blue,3.33,0.9,28,46,blue
4518354034,7,8,9,0,0,0,0,16790,7,17505,193,60,382,-64,19.3,1679,8,7,12,0,0,0,0,16408,7,17569,208,44,-382,64,20.8,1640.8,blue,2,2.86,19,14,blue
4525767323,6,5,6,0,0,0,0,17467,7,18794,238,60,2135,1898,23.8,1746.7,5,6,6,0,0,0,0,15332,6.8,16896,194,56,-2135,-1898,19.4,1533.2,blue,2.4,1.83,21,18,blue
4509468172,6,7,0,1,0,1,0,16338,7,18577,223,64,-524,468,22.3,1633.8,7,6,11,1,1,0,0,16862,7,18109,209,41,524,-468,20.9,1686.2,red,0.86,3,38,20,red
4510799215,4,10,7,1,1,0,0,15471,6.4,15785,192,53,-3033,-3775,19.2,1547.1,10,4,13,0,0,0,0,18504,7.4,19560,207,64,3033,3775,20.7,1850.4,blue,1.1,5.75,17,20,blue
4526667175,3,7,3,1,1,0,0,14322,6.4,16812,186,60,-3441,-1732,18.6,1432.2,7,3,9,1,0,1,0,17763,7,18544,227,48,3441,1732,22.7,1776.3,red,0.86,5.33,22,25,red
4513135937,9,3,10,1,1,0,0,18266,7.2,19178,254,54,3360,1693,25.4,1826.6,3,9,2,0,0,0,0,14906,6.8,17485,235,48,-3360,-1693,23.5,1490.6,blue,6.33,0.56,18,18,blue
4527528512,16,3,15,1,1,0,1,22697,7.6,21092,254,51,8553,4873,25.4,2269.7,3,16,2,0,0,0,0,14144,6.4,16219,166,48,-8553,-4873,16.6,1414.4,blue,10.33,0.31,19,13,blue
4513397052,7,9,9,0,0,0,0,16538,6.8,17488,204,55,-571,-401,20.4,1653.8,9,7,12,1,1,0,0,17109,6.8,17889,222,40,571,401,22.2,1710.9,blue,1.78,3,13,18,blue
4518113467,6,8,5,0,0,0,0,16373,7.2,18479,221,40,-2027,-114,22.1,1637.3,8,6,9,2,1,1,0,18400,7,18593,235,36,2027,114,23.5,1840,red,1.38,2.83,9,16,red
4525823181,3,4,7,0,0,0,0,15029,6.6,16462,244,41,-29,-781,24.4,1502.9,4,3,4,1,1,0,0,15058,6.8,17243,207,55,29,781,20.7,1505.8,blue,2.5,2.67,65,29,blue
4501235801,5,5,6,1,1,0,0,15412,6.6,17055,180,51,-709,-658,18,1541.2,5,5,3,1,0,1,0,16121,6.8,17713,231,43,709,658,23.1,1612.1,red,2.2,1.6,14,23,red
4515825606,7,5,4,0,0,0,0,16478,7,18363,224,71,707,-788,22.4,1647.8,5,7,3,1,1,0,0,15771,7.2,19151,225,60,-707,788,22.5,1577.1,blue,2.2,1.14,14,17,blue
4526982264,6,3,4,0,0,0,0,17488,7.2,19282,243,65,2435,1239,24.3,1748.8,3,6,3,0,0,0,0,15053,7,18043,237,50,-2435,-1239,23.7,1505.3,red,3.33,1,42,19,blue
4509889673,9,4,12,0,0,0,0,18105,7,18937,254,51,2627,1326,25.4,1810.5,4,9,2,0,0,0,0,15478,6.8,17611,216,56,-2627,-1326,21.6,1547.8,red,5.25,0.67,17,41,blue
4526590515,12,5,11,1,1,0,0,17465,7.2,18926,176,53,1968,1173,17.6,1746.5,5,12,3,0,0,0,0,15497,6.8,17753,197,57,-1968,-1173,19.7,1549.7,blue,4.6,0.67,13,19,blue
4523506086,1,3,1,0,0,0,0,14735,7,18220,234,63,-665,-337,23.4,1473.5,3,1,3,1,1,0,0,15400,7,18557,227,65,665,337,22.7,1540,red,0.67,6,19,52,red
4527366202,1,10,1,1,0,1,0,14529,6.6,17127,218,56,-2930,-1894,21.8,1452.9,10,1,17,0,0,0,0,17459,7.2,19021,207,44,2930,1894,20.7,1745.9,blue,0.2,27,40,87,red
4511977578,2,10,0,1,0,1,0,14311,6.8,17028,217,56,-5821,-3230,21.7,1431.1,10,2,11,1,1,0,1,20132,7.2,20258,251,68,5821,3230,25.1,2013.2,red,0.2,10.5,18,48,red
4509846773,2,7,4,2,1,1,0,14820,7,17885,211,64,-2497,-2400,21.1,1482,7,2,12,0,0,0,0,17317,7.6,20285,260,56,2497,2400,26,1731.7,blue,0.86,9.5,20,19,blue
4525911373,15,3,24,2,1,1,2,23701,7.8,21188,239,70,8863,5411,23.9,2370.1,3,15,2,0,0,0,0,14838,6.4,15777,197,44,-8863,-5411,19.7,1483.8,blue,13,0.33,27,13,blue
4526279271,3,7,1,0,0,0,0,15078,7,17979,219,48,-1823,-810,21.9,1507.8,7,3,9,1,1,0,0,16901,7,18789,225,57,1823,810,22.5,1690.1,red,0.57,5.33,15,32,red
4527257633,4,3,3,1,0,1,0,15844,6.8,17574,225,52,1147,254,22.5,1584.4,3,4,3,1,1,0,0,14697,6.8,17320,186,68,-1147,-254,18.6,1469.7,blue,2.33,1.5,67,20,red
4518135056,4,11,2,2,1,1,0,14285,6.6,16387,182,52,-4177,-1640,18.2,1428.5,11,4,21,0,0,0,0,18462,7,18027,209,45,4177,1640,20.9,1846.2,red,0.55,8,21,21,red
4505728122,6,9,7,1,1,0,0,15596,6.2,15360,197,26,-2600,-2112,19.7,1559.6,9,6,7,1,0,1,1,18196,6.6,17472,185,52,2600,2112,18.5,1819.6,blue,1.44,2.67,18,19,red
4510662629,10,4,7,1,1,0,0,18089,7,19431,235,43,2696,2452,23.5,1808.9,4,10,4,0,0,0,0,15393,6.6,16979,196,51,-2696,-2452,19.6,1539.3,blue,4.25,0.8,20,12,blue
4518772710,8,5,2,2,1,1,0,18320,7,19311,268,55,3413,2303,26.8,1832,5,8,7,0,0,0,0,14907,6.6,17008,151,44,-3413,-2303,15.1,1490.7,blue,2,1.5,18,17,blue
4516068485,0,10,0,0,0,0,0,12837,6.2,15086,196,36,-5369,-5193,19.6,1283.7,10,0,10,2,1,1,0,18206,7.2,20279,242,47,5369,5193,24.2,1820.6,red,0,12.65,41,23,red
4527567652,7,6,11,1,1,0,0,16135,6.6,17299,216,43,-153,-1105,21.6,1613.5,6,7,7,0,0,0,0,16288,7,18404,241,52,153,1105,24.1,1628.8,red,3,1.86,20,19,blue
4517996305,1,9,1,0,0,0,0,13599,6.4,15596,229,32,-5031,-5211,22.9,1359.9,9,1,6,0,0,0,0,18630,7.6,20807,241,71,5031,5211,24.1,1863,red,0.22,15,21,19,red
4527332360,2,5,3,0,0,0,0,14732,6.8,17531,210,52,-1461,-799,21,1473.2,5,2,6,1,1,0,0,16193,7.2,18330,240,55,1461,799,24,1619.3,blue,1,5.5,60,23,red
4518577931,3,5,5,0,0,0,0,15529,6.6,17787,237,46,-522,-1373,23.7,1552.9,5,3,2,1,1,0,0,16051,7,19160,222,60,522,1373,22.2,1605.1,red,1.6,2.33,17,20,red
4527513157,6,3,6,1,1,0,0,15909,6.8,17578,208,43,257,-1125,20.8,1590.9,3,6,0,0,0,0,0,15652,6.8,18703,233,80,-257,1125,23.3,1565.2,red,4,0.5,19,16,blue
4506309128,6,2,6,0,0,0,0,15953,6.8,18137,207,60,1496,1458,20.7,1595.3,2,6,5,1,1,0,0,14457,6.8,16679,201,51,-1496,-1458,20.1,1445.7,red,6,1.17,22,15,blue
4521179969,9,12,13,0,0,0,0,17867,6.6,17671,218,49,-1354,-798,21.8,1786.7,12,9,23,0,0,0,0,19221,7.2,18469,214,42,1354,798,21.4,1922.1,red,1.83,3.89,17,21,red
4513121653,5,6,8,0,0,0,0,16324,7,17343,216,44,-683,-676,21.6,1632.4,6,5,5,0,0,0,0,17007,7,18019,248,52,683,676,24.8,1700.7,red,2.17,2.2,20,16,blue
4527127873,1,8,1,0,0,0,0,13006,6,14750,201,44,-6892,-5371,20.1,1300.6,8,1,12,2,1,1,1,19898,7.2,20121,233,76,6892,5371,23.3,1989.8,red,0.25,20,21,19,red
4520396985,4,9,7,0,0,0,0,16165,6.6,17638,220,44,-2163,-739,22,1616.5,9,4,18,1,1,0,0,18328,7,18377,213,56,2163,739,21.3,1832.8,red,1.22,6.75,28,45,red
4515934415,4,7,5,1,1,0,0,14205,6.4,15571,204,19,-4462,-3453,20.4,1420.5,7,4,7,0,0,0,0,18667,7,19024,269,57,4462,3453,26.9,1866.7,red,1.29,3.5,37,19,red
4526466806,6,11,8,0,0,0,0,16882,6.8,17922,204,43,-2059,-2345,20.4,1688.2,11,6,14,0,0,0,0,18941,7.4,20267,220,56,2059,2345,22,1894.1,blue,1.27,4.17,26,46,blue
4516367790,5,7,2,0,0,0,0,14871,6.8,16941,180,47,-1682,-563,18,1487.1,7,5,9,1,1,0,0,16553,6.8,17504,191,36,1682,563,19.1,1655.3,blue,1,3.2,49,21,red
4524024822,12,2,10,2,1,1,1,20860,7.4,21006,268,65,8027,7621,26.8,2086,2,12,3,0,0,0,0,12833,5.8,13385,165,36,-8027,-7621,16.5,1283.3,blue,11,0.42,21,19,blue
4502643526,2,1,4,0,0,0,0,15379,7,18530,238,57,995,1649,23.8,1537.9,1,2,1,0,0,0,0,14384,6.6,16881,232,49,-995,-1649,23.2,1438.4,blue,6,1,39,19,blue
4413462978,5,2,6,1,1,0,0,15814,7,17846,240,52,1012,191,24,1581.4,2,5,1,0,0,0,0,14802,6.8,17655,229,51,-1012,-191,22.9,1480.2,blue,5.5,0.6,20,36,blue
4520744316,9,10,12,0,0,0,0,17252,7,18777,205,48,-1287,-6,20.5,1725.2,10,9,9,0,0,0,0,18539,7.2,18783,217,47,1287,6,21.7,1853.9,red,2.1,2.11,44,33,red
4497467967,8,6,7,0,0,0,0,16451,6.6,16842,191,34,359,-772,19.1,1645.1,6,8,6,0,0,0,0,16092,7,17614,195,51,-359,772,19.5,1609.2,red,2.5,1.5,17,40,blue
4517032052,10,8,13,0,0,0,0,16991,6.6,16213,180,36,803,490,18,1699.1,8,10,13,0,0,0,0,16188,6.4,15723,177,40,-803,-490,17.7,1618.8,blue,2.88,2.1,118,16,red
4516672650,2,9,2,1,1,0,0,14695,6.8,17395,223,63,-3426,-2539,22.3,1469.5,9,2,10,0,0,0,0,18121,7.4,19934,236,44,3426,2539,23.6,1812.1,red,0.44,9.5,14,17,red
4517819782,4,4,4,0,0,0,0,16333,7.2,18597,244,64,1315,1402,24.4,1633.3,4,4,4,1,0,1,0,15018,7,17195,206,50,-1315,-1402,20.6,1501.8,blue,2,2,19,16,blue
4511924460,9,8,10,0,0,0,0,17875,6.8,17347,212,45,1171,-841,21.2,1787.5,8,9,11,0,0,0,0,16704,7.2,18188,190,49,-1171,841,19,1670.4,blue,2.38,2.11,20,18,blue
4525783295,9,5,6,1,1,0,0,18912,7.4,20086,244,70,3970,2818,24.4,1891.2,5,9,5,0,0,0,0,14942,6.6,17268,210,29,-3970,-2818,21,1494.2,blue,3,1.11,14,10,red
4508287669,5,7,4,0,0,0,1,16791,7,17929,225,48,482,617,22.5,1679.1,7,5,5,1,1,0,0,16309,6.8,17312,207,58,-482,-617,20.7,1630.9,blue,1.29,2.4,25,10,red
4511940066,4,7,1,1,0,1,0,15198,6.8,17307,214,50,-2090,-2188,21.4,1519.8,7,4,7,1,1,0,0,17288,7.2,19495,222,71,2090,2188,22.2,1728.8,red,0.71,3.5,42,20,blue
4521606449,10,6,11,0,0,0,0,18156,7.4,19293,238,48,2052,1084,23.8,1815.6,6,10,4,0,0,0,0,16104,6.8,18209,240,40,-2052,-1084,24,1610.4,blue,3.5,1,16,23,blue
4526171046,8,3,9,0,0,0,0,18334,7,19209,232,40,3770,1556,23.2,1833.4,3,8,2,1,1,0,0,14564,6.8,17653,195,59,-3770,-1556,19.5,1456.4,blue,5.67,0.62,18,38,red
4527487988,6,7,9,0,0,0,0,16054,6.6,17023,202,52,-849,-603,20.2,1605.4,7,6,7,1,1,0,0,16903,6.8,17626,215,46,849,603,21.5,1690.3,red,2.14,2.33,66,19,blue
4507103661,8,7,6,1,0,1,1,18271,6.8,18004,223,46,1656,95,22.3,1827.1,7,8,6,1,1,0,0,16615,7,17909,226,54,-1656,-95,22.6,1661.5,blue,2,1.62,14,13,blue
4525539438,5,11,3,0,0,0,0,15645,6.8,16821,203,42,-2328,-1524,20.3,1564.5,11,5,13,1,1,0,0,17973,6.8,18345,209,40,2328,1524,20.9,1797.3,red,0.73,4.8,19,21,red
4518364742,6,0,3,1,1,0,0,17816,7.2,20228,244,61,4677,4588,24.4,1781.6,0,6,0,0,0,0,0,13139,6.6,15640,216,39,-4677,-4588,21.6,1313.9,blue,12.03,0,20,14,blue
4521223652,4,3,4,1,1,0,0,15237,7,17965,205,60,724,2025,20.5,1523.7,3,4,4,1,0,1,0,14513,6.2,15940,206,32,-724,-2025,20.6,1451.3,blue,2.67,1.75,16,52,red
4519300992,5,3,5,1,0,1,0,15740,7,17908,220,48,1154,971,22,1574,3,5,3,1,1,0,0,14586,6.8,16937,225,56,-1154,-971,22.5,1458.6,blue,3.33,1.2,19,19,blue
4513996246,6,2,7,1,1,0,0,15949,6.6,17392,198,42,919,-36,19.8,1594.9,2,6,2,0,0,0,0,15030,6.8,17428,211,57,-919,36,21.1,1503,red,6.5,0.67,21,14,red
4500155782,7,7,7,0,0,0,0,17250,7.2,18870,255,55,160,999,25.5,1725,7,7,5,0,0,0,0,17090,6.8,17871,231,52,-160,-999,23.1,1709,blue,2,1.71,20,17,red
4513103851,7,7,8,1,1,0,0,17191,6.8,17267,206,48,-347,-2753,20.6,1719.1,7,7,11,0,0,0,0,17538,7.6,20020,212,68,347,2753,21.2,1753.8,red,2.14,2.57,19,15,blue
4513689722,5,1,5,0,0,0,0,17512,7.4,20540,283,67,3122,3276,28.3,1751.2,1,5,1,1,1,0,0,14390,6.6,17264,244,40,-3122,-3276,24.4,1439,blue,10,0.4,16,13,red
4523384060,3,4,1,0,0,0,0,15336,7,17953,253,43,-761,-10,25.3,1533.6,4,3,5,1,0,1,0,16097,6.8,17963,219,52,761,10,21.9,1609.7,red,1,3,12,15,blue
4515307437,3,14,1,1,1,0,0,14143,6.2,15352,205,46,-6445,-4329,20.5,1414.3,14,3,14,1,0,1,0,20588,7.4,19681,209,66,6445,4329,20.9,2058.8,red,0.29,9.33,16,17,red
4512466061,5,5,4,0,0,0,0,16092,6.8,18020,222,47,262,611,22.2,1609.2,5,5,7,1,1,0,0,15830,6.8,17409,191,62,-262,-611,19.1,1583,blue,1.8,2.4,19,15,blue
4512161240,8,7,4,1,0,1,0,17505,7.2,19027,236,48,1014,850,23.6,1750.5,7,8,5,1,1,0,0,16491,7,18177,201,60,-1014,-850,20.1,1649.1,blue,1.71,1.5,22,20,blue
4525777991,4,6,4,0,0,0,0,15005,6.8,17143,213,47,-1022,-1253,21.3,1500.5,6,4,7,2,1,1,0,16027,7,18396,230,43,1022,1253,23,1602.7,red,1.33,3.25,18,14,blue
4525813376,5,11,5,0,0,0,0,15189,7,17359,195,48,-4907,-2701,19.5,1518.9,11,5,8,1,1,0,1,20096,7.4,20060,250,51,4907,2701,25,2009.6,red,0.91,3.8,58,21,red
4521070100,8,5,8,0,0,0,0,16945,7.4,18652,218,53,1978,1936,21.8,1694.5,5,8,7,0,0,0,0,14967,6.6,16716,188,44,-1978,-1936,18.8,1496.7,red,3.2,1.5,15,27,red
4512098685,12,10,20,0,0,0,0,18269,6.4,16542,198,35,1032,-617,19.8,1826.9,10,12,9,0,0,0,0,17237,6.8,17159,202,36,-1032,617,20.2,1723.7,red,3.2,1.58,23,20,blue
4517707806,4,2,3,1,0,1,0,16697,7.4,19455,235,60,2799,2965,23.5,1669.7,2,4,3,1,1,0,0,13898,6.8,16490,200,44,-2799,-2965,20,1389.8,blue,3.5,1.25,23,94,red
4514363015,4,8,5,1,1,0,0,15179,6.8,16562,220,49,-2967,-4209,22,1517.9,8,4,7,0,0,0,0,18146,7.6,20771,266,54,2967,4209,26.6,1814.6,red,1.12,3.75,18,45,blue
4522113197,3,4,1,1,1,0,0,14664,6.8,16863,218,41,-1770,-1276,21.8,1466.4,4,3,4,1,0,1,0,16434,7,18139,219,63,1770,1276,21.9,1643.4,red,1,2.67,15,20,blue
4527400475,6,5,5,1,1,0,0,17375,7,17881,225,55,1825,243,22.5,1737.5,5,6,8,0,0,0,0,15550,7,17638,199,44,-1825,-243,19.9,1555,blue,2.2,2.17,16,54,blue
4510971927,9,4,8,1,1,0,0,17524,7,18825,258,30,2764,2121,25.8,1752.4,4,9,3,0,0,0,0,14760,6.4,16704,208,34,-2764,-2121,20.8,1476,blue,4.25,0.78,16,17,red
4524838137,10,8,9,0,0,0,0,18033,7.2,18634,201,52,1324,1692,20.1,1803.3,8,10,8,1,0,1,0,16709,6.8,16942,185,56,-1324,-1692,18.5,1670.9,blue,2.38,1.6,16,16,red
4525545485,9,7,9,0,0,0,0,18880,7,19278,235,54,2690,2514,23.5,1888,7,9,9,1,1,0,0,16190,6.6,16764,193,43,-2690,-2514,19.3,1619,blue,2.57,1.78,15,19,blue
4506913159,10,6,17,1,1,0,0,18751,7.2,19155,232,52,1520,1168,23.2,1875.1,6,10,8,0,0,0,0,17231,6.8,17987,232,51,-1520,-1168,23.2,1723.1,blue,4.5,1.4,45,20,red
4526845553,6,7,4,1,0,1,0,16150,6.8,18167,213,57,-830,-448,21.3,1615,7,6,5,0,0,0,0,16980,7,18615,226,52,830,448,22.6,1698,blue,1.43,2,39,15,red
4492577817,3,9,2,1,1,0,0,13769,6.2,15094,174,54,-4147,-3023,17.4,1376.9,9,3,7,0,0,0,0,17916,7,18117,217,48,4147,3023,21.7,1791.6,red,0.56,5.33,18,20,blue
4525337352,4,5,1,1,1,0,0,15202,7,18246,240,56,-947,1016,24,1520.2,5,4,7,0,0,0,0,16149,6.8,17230,231,46,947,-1016,23.1,1614.9,blue,1,3,18,19,red
4513306375,5,10,7,1,1,0,0,14885,6.4,15463,170,41,-3695,-4018,17,1488.5,10,5,8,1,0,1,0,18580,7.2,19481,241,59,3695,4018,24.1,1858,red,1.2,3.6,13,20,red
4515543803,7,6,6,0,0,0,0,15847,6.6,16305,199,36,-1252,-1190,19.9,1584.7,6,7,6,1,0,1,0,17099,6.6,17495,231,51,1252,1190,23.1,1709.9,red,2.17,1.71,21,21,red
4498537692,7,4,8,0,0,0,0,16708,7.2,19294,212,45,1371,1179,21.2,1670.8,4,7,4,0,0,0,0,15337,6.8,18115,238,39,-1371,-1179,23.8,1533.7,blue,3.75,1.14,45,15,blue
4509069463,7,5,8,2,1,1,0,17788,7,18965,248,53,1767,1408,24.8,1778.8,5,7,4,0,0,0,0,16021,7,17557,221,56,-1767,-1408,22.1,1602.1,blue,3,1.29,18,12,blue
4523826752,9,5,9,0,0,0,0,16988,6.6,17774,213,40,1605,755,21.3,1698.8,5,9,4,2,1,1,0,15383,6.6,17019,203,48,-1605,-755,20.3,1538.3,blue,3.6,1,21,17,blue
4523620825,13,3,13,1,1,0,2,22049,7.4,19632,243,51,8532,5876,24.3,2204.9,3,13,2,0,0,0,0,13517,5.8,13756,165,46,-8532,-5876,16.5,1351.7,blue,8.67,0.38,18,17,blue
4526437692,7,9,11,0,0,0,0,16752,7,18525,226,42,-753,-299,22.6,1675.2,9,7,6,0,0,0,0,17505,7,18824,225,51,753,299,22.5,1750.5,blue,2,2.14,17,15,blue
4523339040,9,2,8,2,1,1,0,18318,7.2,19194,228,46,4446,3448,22.8,1831.8,2,9,4,0,0,0,0,13872,6.4,15746,188,41,-4446,-3448,18.8,1387.2,blue,8.5,0.67,23,21,blue
4499984272,4,8,7,0,0,0,0,14655,6.6,16541,208,37,-3142,-2633,20.8,1465.5,8,4,17,1,0,1,0,17797,7.2,19174,216,56,3142,2633,21.6,1779.7,red,1.38,6.25,24,23,red
4506946392,5,8,4,0,0,0,0,14321,6,15077,167,43,-2695,-2572,16.7,1432.1,8,5,10,0,0,0,0,17016,7,17649,181,54,2695,2572,18.1,1701.6,blue,1.12,3.6,14,16,red
4526164537,4,8,4,0,0,0,0,14434,6.6,15829,183,40,-4603,-2667,18.3,1443.4,8,4,11,2,1,1,1,19037,7,18496,212,48,4603,2667,21.2,1903.7,red,1,4.75,19,21,red
4522083891,12,9,10,1,1,0,0,18910,7.2,18538,203,47,1454,1187,20.3,1891,9,12,14,0,0,0,0,17456,7,17351,185,40,-1454,-1187,18.5,1745.6,red,2.44,1.92,19,16,blue
4520891327,5,4,5,1,1,0,0,15740,7,17449,206,56,-312,-473,20.6,1574,4,5,5,0,0,0,0,16052,6.8,17922,229,47,312,473,22.9,1605.2,red,2.5,1.8,15,15,red
4503653541,6,5,5,0,0,0,0,15428,6.8,16724,201,46,-491,-1417,20.1,1542.8,5,6,4,1,1,0,0,15919,6.8,18141,211,62,491,1417,21.1,1591.9,red,2.2,1.5,20,40,blue
4510696866,5,4,7,0,0,0,0,15577,6.8,17244,207,48,124,-46,20.7,1557.7,4,5,5,2,1,1,0,15453,6.8,17290,220,52,-124,46,22,1545.3,red,3,1.8,18,26,red
4518337349,8,11,10,1,0,1,0,17282,7,17712,222,48,-1008,-810,22.2,1728.2,11,8,7,1,1,0,0,18290,7,18522,220,48,1008,810,22,1829,red,1.64,2.25,20,20,blue
4495284570,7,5,10,1,1,0,0,17009,6.8,17881,222,40,1121,836,22.2,1700.9,5,7,4,0,0,0,0,15888,6.8,17045,228,52,-1121,-836,22.8,1588.8,blue,3.4,1.29,21,19,red
4510083368,6,13,5,0,0,0,0,16345,6.8,17662,209,42,-2154,-2348,20.9,1634.5,13,6,13,0,0,0,0,18499,7.4,20010,225,36,2154,2348,22.5,1849.9,red,0.85,4.33,16,16,red
4511356248,5,9,7,0,0,0,0,16142,7.2,17532,237,44,-1711,-1086,23.7,1614.2,9,5,12,2,1,1,0,17853,7.2,18618,195,56,1711,1086,19.5,1785.3,blue,1.33,4.2,17,22,red
4527136239,13,7,14,1,1,0,0,18839,7.2,18977,189,53,1144,944,18.9,1883.9,7,13,7,0,0,0,0,17695,7,18033,228,40,-1144,-944,22.8,1769.5,red,3.86,1.08,25,19,blue
4515989660,11,4,10,1,1,0,0,17570,7.2,18349,226,43,2414,2407,22.6,1757,4,11,5,0,0,0,0,15156,6.4,15942,219,44,-2414,-2407,21.9,1515.6,blue,5.25,0.82,20,15,blue
4526750578,7,10,8,0,0,0,0,15265,6,14533,161,28,-2627,-2458,16.1,1526.5,10,7,16,0,0,0,0,17892,6.6,16991,218,37,2627,2458,21.8,1789.2,red,1.5,3.71,40,20,red
4527479817,3,5,2,2,1,1,0,15581,7,18847,233,72,-353,-280,23.3,1558.1,5,3,4,0,0,0,0,15934,7.4,19127,228,48,353,280,22.8,1593.4,blue,1,3,39,27,red
4492487479,7,5,7,0,0,0,0,16514,7.2,18198,211,52,1232,1358,21.1,1651.4,5,7,3,1,1,0,0,15282,6.6,16840,215,48,-1232,-1358,21.5,1528.2,red,2.8,1.14,16,16,red
4526435139,4,4,3,2,1,1,0,16127,6.8,18248,235,64,1071,644,23.5,1612.7,4,4,4,0,0,0,0,15056,6.6,17604,212,41,-1071,-644,21.2,1505.6,blue,1.75,2,26,25,blue
4513426543,10,6,10,1,1,0,0,17831,7.2,19052,198,48,2233,3109,19.8,1783.1,6,10,9,0,0,0,0,15598,6.6,15943,204,40,-2233,-3109,20.4,1559.8,blue,3.33,1.5,42,16,red
4521364269,6,0,5,1,1,0,0,17002,7.2,19584,227,59,4376,4106,22.7,1700.2,0,6,0,0,0,0,0,12626,6.2,15478,184,48,-4376,-4106,18.4,1262.6,blue,12.03,0,17,20,blue
4508816408,6,1,4,0,0,0,0,16931,7.2,19352,222,50,1931,2084,22.2,1693.1,1,6,1,0,0,0,0,15000,6.8,17268,222,67,-1931,-2084,22.2,1500,blue,10,0.33,17,31,red
4515217487,11,5,11,0,0,0,0,19267,7.2,19780,257,50,2669,2743,25.7,1926.7,5,11,4,2,1,1,0,16598,6.6,17037,205,41,-2669,-2743,20.5,1659.8,blue,4.4,0.82,18,10,blue
4526078316,10,4,11,1,1,0,0,17593,7,17874,190,41,2596,1052,19,1759.3,4,10,5,0,0,0,0,14997,6.6,16822,207,52,-2596,-1052,20.7,1499.7,blue,5.25,0.9,38,24,blue
4525547505,9,6,6,0,0,0,0,16950,7,18151,218,32,1081,1757,21.8,1695,6,9,8,1,1,0,0,15869,6.4,16394,183,59,-1081,-1757,18.3,1586.9,blue,2.5,1.56,15,19,red
4526560120,4,6,2,0,0,0,0,13829,6.4,16293,171,48,-2523,-2080,17.1,1382.9,6,4,6,1,1,0,0,16352,6.8,18373,222,52,2523,2080,22.2,1635.2,red,1,3,16,16,blue
4504872920,5,3,6,0,0,0,0,16478,6.8,17590,254,44,1207,-488,25.4,1647.8,3,5,6,2,1,1,0,15271,7.2,18078,212,72,-1207,488,21.2,1527.1,red,3.67,1.8,17,41,blue
4522519363,5,3,4,1,1,0,0,16338,7.2,19137,234,60,1106,1309,23.4,1633.8,3,5,1,0,0,0,0,15232,6.8,17828,228,60,-1106,-1309,22.8,1523.2,blue,3,0.8,20,19,red
4515867016,4,3,6,1,1,0,0,14972,6.8,17357,201,49,-266,-613,20.1,1497.2,3,4,4,1,0,1,0,15238,7,17970,233,46,266,613,23.3,1523.8,blue,3.33,1.75,15,38,red
4517776994,6,2,6,1,1,0,0,16152,7,18649,228,53,1069,1104,22.8,1615.2,2,6,2,0,0,0,0,15083,6.8,17545,238,46,-1069,-1104,23.8,1508.3,blue,6,0.67,67,30,red
4518869333,7,8,4,1,1,0,0,17209,6.8,17808,229,37,1710,1298,22.9,1720.9,8,7,5,0,0,0,0,15499,6.4,16510,166,46,-1710,-1298,16.6,1549.9,red,1.38,1.86,15,14,red
4517882103,7,8,7,0,0,0,0,17084,7,17884,224,52,-100,-120,22.4,1708.4,8,7,10,1,1,0,0,17184,7,18004,207,59,100,120,20.7,1718.4,red,1.75,2.57,16,19,red
4520027392,3,5,2,0,0,0,0,15073,7.2,17942,198,56,-556,-442,19.8,1507.3,5,3,3,1,1,0,0,15629,7.2,18384,226,48,556,442,22.6,1562.9,blue,1,2.67,37,25,blue
4520736346,11,9,9,0,0,0,0,17795,7.4,18920,164,63,-274,304,16.4,1779.5,9,11,9,0,0,0,0,18069,7,18616,237,46,274,-304,23.7,1806.9,blue,2.22,1.64,15,15,blue
4519835151,6,9,3,0,0,0,0,16404,6.8,18053,231,40,-554,174,23.1,1640.4,9,6,9,2,1,1,0,16958,6.8,17879,204,41,554,-174,20.4,1695.8,red,1,3,22,21,red
4513147023,4,6,3,0,0,0,0,15119,6.8,18065,211,56,-542,-1235,21.1,1511.9,6,4,4,1,1,0,0,15661,7.4,19300,224,54,542,1235,22.4,1566.1,red,1.17,2.5,24,25,blue
4526246289,8,5,11,0,0,0,0,17770,7,17974,228,55,1753,963,22.8,1777,5,8,6,0,0,0,0,16017,6.8,17011,233,40,-1753,-963,23.3,1601.7,blue,3.8,1.38,20,91,red
4525627724,3,6,2,0,0,0,0,15212,6.8,17204,202,59,-1718,-1922,20.2,1521.2,6,3,8,1,0,1,0,16930,7,19126,201,64,1718,1922,20.1,1693,red,0.83,4.67,14,18,blue
4515856568,5,9,3,1,1,0,0,15781,6.8,17614,203,60,-1980,-1595,20.3,1578.1,9,5,11,0,0,0,0,17761,7.2,19209,228,44,1980,1595,22.8,1776.1,red,0.89,4,17,47,blue
4505704302,3,6,2,1,0,1,0,15524,6.6,17326,217,58,-645,-1495,21.7,1552.4,6,3,5,1,1,0,0,16169,7.2,18821,200,70,645,1495,20,1616.9,red,0.83,3.67,20,42,red
4526971230,7,6,4,0,0,0,0,15473,6.8,17556,195,48,-1174,-778,19.5,1547.3,6,7,5,0,0,0,0,16647,7.2,18334,221,38,1174,778,22.1,1664.7,blue,1.83,1.57,18,17,red
4526423830,10,9,10,0,0,0,0,18034,6.8,17170,211,43,1179,-675,21.1,1803.4,9,10,11,0,0,0,0,16855,7,17845,222,32,-1179,675,22.2,1685.5,red,2.22,2,16,18,blue
4524504083,8,5,9,1,1,0,0,16646,7,17451,188,51,1308,1296,18.8,1664.6,5,8,7,1,0,1,0,15338,6.4,16155,227,40,-1308,-1296,22.7,1533.8,blue,3.4,1.5,42,17,blue
4523959308,10,7,7,1,1,0,0,18185,7,19320,213,56,1340,1318,21.3,1818.5,7,10,4,0,0,0,0,16845,6.8,18002,216,56,-1340,-1318,21.6,1684.5,red,2.43,1.1,22,33,blue
4514415093,3,6,3,0,0,0,0,15761,7,18094,239,43,-983,-1574,23.9,1576.1,6,3,11,1,1,0,0,16744,7.2,19668,218,73,983,1574,21.8,1674.4,red,1,5.67,17,17,blue
4515360430,5,3,2,2,1,1,0,16243,7.4,19006,245,59,855,2880,24.5,1624.3,3,5,4,0,0,0,0,15388,6.4,16126,204,50,-855,-2880,20.4,1538.8,blue,2.33,1.4,16,20,blue
4519995734,8,6,10,1,0,1,1,18909,7.2,18843,237,40,3023,2115,23.7,1890.9,6,8,7,1,1,0,0,15886,6.6,16728,211,44,-3023,-2115,21.1,1588.6,red,3,1.62,26,21,red
4527422917,8,8,8,0,0,0,0,17014,6.6,17257,221,33,-426,-1055,22.1,1701.4,8,8,8,0,0,0,0,17440,6.8,18312,204,46,426,1055,20.4,1744,red,2,2,20,19,red
4526942362,12,7,10,2,1,1,0,18820,7.4,19789,207,71,1991,2474,20.7,1882,7,12,7,0,0,0,0,16829,6.8,17315,207,40,-1991,-2474,20.7,1682.9,blue,3.14,1.17,14,12,blue
4527078331,8,4,7,1,1,0,0,18257,7,19371,246,60,3149,1513,24.6,1825.7,4,8,1,0,0,0,0,15108,6.8,17858,227,61,-3149,-1513,22.7,1510.8,blue,3.75,0.62,9,16,blue
4413342803,1,9,0,0,0,0,0,13860,6.4,16122,203,49,-5214,-3160,20.3,1386,9,1,10,1,0,1,1,19074,7.2,19282,233,43,5214,3160,23.3,1907.4,red,0.11,19,37,17,blue
4500695387,4,4,4,0,0,0,0,14942,6.6,17678,200,51,-763,395,20,1494.2,4,4,9,1,1,0,0,15705,6.8,17283,241,50,763,-395,24.1,1570.5,blue,2,3.25,27,45,red
4525536243,3,7,3,0,0,0,0,14056,6.6,16342,193,50,-2129,-1542,19.3,1405.6,7,3,12,1,1,0,0,16185,7,17884,217,34,2129,1542,21.7,1618.5,red,0.86,6.33,18,20,red
4526297055,11,4,10,1,1,0,0,18534,7.2,19784,208,56,2361,2489,20.8,1853.4,4,11,6,0,0,0,0,16173,6.8,17295,233,48,-2361,-2489,23.3,1617.3,blue,5.25,0.91,21,18,red
4511137268,6,8,4,1,1,0,0,16118,6.8,17602,200,48,-1209,-1556,20,1611.8,8,6,7,0,0,0,0,17327,7.4,19158,251,42,1209,1556,25.1,1732.7,red,1.25,2.5,17,20,blue
4493753428,5,5,7,1,0,1,0,17135,7.4,19139,242,52,1046,815,24.2,1713.5,5,5,6,1,1,0,0,16089,7,18324,233,48,-1046,-815,23.3,1608.9,blue,2.4,2.2,21,22,red
4507950009,4,7,4,1,0,1,0,15293,6.8,17145,192,64,-1809,-1431,19.2,1529.3,7,4,11,1,1,0,0,17102,7,18576,215,52,1809,1431,21.5,1710.2,red,1.14,4.5,20,43,red
4511142535,5,9,5,0,0,0,0,15555,6.4,15866,200,35,-2286,-3935,20,1555.5,9,5,7,1,1,0,0,17841,7.6,19801,220,82,2286,3935,22,1784.1,red,1.11,3.2,22,19,blue
4498547883,13,7,11,0,0,0,0,19907,7.6,20865,231,52,3079,2098,23.1,1990.7,7,13,7,1,1,0,0,16828,7,18767,186,75,-3079,-2098,18.6,1682.8,blue,3.43,1.08,21,18,red
4515708683,4,10,4,1,1,0,0,15593,6.8,16199,204,4,-3101,-2897,20.4,1559.3,10,4,8,0,0,0,0,18694,7,19096,223,48,3101,2897,22.3,1869.4,blue,0.8,4.5,47,14,red
4521203741,5,3,7,1,1,0,0,16305,7,18828,191,80,713,851,19.1,1630.5,3,5,2,0,0,0,0,15592,6.8,17977,229,47,-713,-851,22.9,1559.2,blue,4,1,30,34,blue
4522150515,5,3,7,0,0,0,0,16344,7.2,19039,238,52,1108,19,23.8,1634.4,3,5,1,2,1,1,0,15236,7,19020,244,54,-1108,-19,24.4,1523.6,blue,4,0.8,26,40,blue
4518246910,10,3,5,1,1,0,0,18863,7.2,19070,228,68,4747,2924,22.8,1886.3,3,10,5,0,0,0,0,14116,6.6,16146,189,43,-4747,-2924,18.9,1411.6,blue,5,0.8,17,11,red
4526450175,10,4,11,1,1,0,0,18266,7.2,19333,239,40,3160,2461,23.9,1826.6,4,10,6,0,0,0,0,15106,6.8,16872,206,47,-3160,-2461,20.6,1510.6,blue,5.25,1,23,21,blue
4503218320,2,6,2,0,0,0,0,14528,6.8,16573,203,57,-2377,-2338,20.3,1452.8,6,2,5,1,1,0,0,16905,7.2,18911,251,53,2377,2338,25.1,1690.5,red,0.67,5.5,19,24,blue
4527031551,7,6,6,1,0,1,0,17131,6.6,17701,229,36,1254,-81,22.9,1713.1,6,7,3,1,1,0,0,15877,6.8,17782,199,62,-1254,81,19.9,1587.7,blue,2.17,1.29,22,15,blue
4520016243,12,2,18,1,1,0,0,19273,7.2,18465,226,60,5784,4755,22.6,1927.3,2,12,2,0,0,0,0,13489,6,13710,168,52,-5784,-4755,16.8,1348.9,blue,15,0.33,17,12,red
4512514727,4,2,1,0,0,0,0,15555,7.2,19127,254,51,1019,1368,25.4,1555.5,2,4,2,1,1,0,0,14536,7,17759,217,60,-1019,-1368,21.7,1453.6,blue,2.5,1,18,24,red
4522402068,10,8,9,1,1,0,0,18265,7.2,19323,204,53,2520,3200,20.4,1826.5,8,10,7,1,0,1,0,15745,6.4,16123,163,32,-2520,-3200,16.3,1574.5,blue,2.38,1.5,19,18,blue
4512603224,5,3,6,1,1,0,0,15343,7,17430,210,56,1184,848,21,1534.3,3,5,3,0,0,0,0,14159,6.4,16582,213,33,-1184,-848,21.3,1415.9,blue,3.67,1.2,17,27,blue
4527280212,12,3,14,0,0,0,0,18631,7.4,19460,245,42,4089,3372,24.5,1863.1,3,12,4,1,1,0,0,14542,6.4,16088,193,60,-4089,-3372,19.3,1454.2,blue,8.67,0.58,48,21,blue
4520501575,8,8,9,0,0,0,0,17245,6.8,17559,207,32,-1300,-1355,20.7,1724.5,8,8,8,1,1,0,0,18545,7,18914,244,52,1300,1355,24.4,1854.5,red,2.12,2,18,13,blue
4515601769,9,8,7,0,0,0,0,17670,7,18217,201,72,32,-952,20.1,1767,8,9,9,0,0,0,0,17638,7.4,19169,247,52,-32,952,24.7,1763.8,blue,2,1.89,17,21,blue
4519840104,7,3,6,0,0,0,1,18100,7,18030,197,48,2690,236,19.7,1810,3,7,3,1,0,1,0,15410,6.8,17794,211,60,-2690,-236,21.1,1541,blue,4.33,0.86,22,18,blue
4516179607,8,2,11,1,1,0,0,17499,7.4,18873,217,56,2282,1265,21.7,1749.9,2,8,2,0,0,0,0,15217,7,17608,237,56,-2282,-1265,23.7,1521.7,blue,9.5,0.5,17,16,red
4488755815,9,8,11,1,1,0,0,16940,7,18041,191,40,-896,-393,19.1,1694,8,9,8,0,0,0,0,17836,7,18434,235,45,896,393,23.5,1783.6,red,2.5,1.78,19,22,blue
4527028313,7,5,9,0,0,0,0,17960,7,17948,226,71,2873,1850,22.6,1796,5,7,9,1,1,0,0,15087,6.4,16098,193,51,-2873,-1850,19.3,1508.7,blue,3.2,2,20,59,blue
4527555265,5,7,4,0,0,0,0,15637,6.6,16547,205,46,-1960,-709,20.5,1563.7,7,5,8,1,1,0,1,17597,6.8,17256,223,43,1960,709,22.3,1759.7,red,1.29,3,19,23,red
4522224845,9,6,4,1,1,0,0,18726,7.4,20142,257,51,2673,2723,25.7,1872.6,6,9,11,0,0,0,0,16053,6.8,17419,196,52,-2673,-2723,19.6,1605.3,blue,2.17,1.89,87,40,blue
4495278718,6,6,11,0,0,0,0,17244,7.2,18750,221,51,1091,1084,22.1,1724.4,6,6,12,2,1,1,0,16153,6.8,17666,235,48,-1091,-1084,23.5,1615.3,blue,2.83,3,41,17,blue
4519869638,5,9,2,1,1,0,0,15038,6.8,17122,194,45,-2755,-869,19.4,1503.8,9,5,11,0,0,0,0,17793,6.8,17991,218,46,2755,869,21.8,1779.3,blue,0.78,4,20,24,red
4527516499,8,10,8,0,0,0,0,17490,7.2,18680,198,52,-905,-29,19.8,1749,10,8,12,1,1,0,0,18395,7.2,18709,196,64,905,29,19.6,1839.5,red,1.6,2.75,16,12,red
4525943268,7,10,4,0,0,0,0,15970,6.8,17608,196,55,-2046,-691,19.6,1597,10,7,10,0,0,0,0,18016,7,18299,226,40,2046,691,22.6,1801.6,red,1.1,2.86,20,17,red
4513955643,4,1,3,1,1,0,0,16435,7.4,19956,250,63,1527,1629,25,1643.5,1,4,0,0,0,0,0,14908,7,18327,228,56,-1527,-1629,22.8,1490.8,blue,7,0.25,18,15,red
4526073509,9,5,8,0,0,0,0,17562,6.6,17442,203,50,1975,812,20.3,1756.2,5,9,5,1,1,0,0,15587,6.6,16630,208,42,-1975,-812,20.8,1558.7,blue,3.4,1.11,26,22,red
4526441626,7,11,8,0,0,0,0,16786,6.6,16781,189,60,-1739,-838,18.9,1678.6,11,7,16,1,1,0,0,18525,7,17619,196,52,1739,838,19.6,1852.5,red,1.36,3.86,16,18,red
4519715253,7,1,5,0,0,0,1,18193,7,18289,225,52,4939,2073,22.5,1819.3,1,7,0,0,0,0,0,13254,6.6,16216,175,66,-4939,-2073,17.5,1325.4,red,12,0.14,51,193,blue
4526452438,4,7,2,0,0,0,0,16061,7,17642,230,52,-717,-997,23,1606.1,7,4,8,1,1,0,0,16778,7,18639,236,56,717,997,23.6,1677.8,red,0.86,3.75,19,21,blue
4513537604,10,12,10,0,0,0,0,17517,7.4,19291,179,56,-1567,505,17.9,1751.7,12,10,13,0,0,0,0,19084,7,18786,219,32,1567,-505,21.9,1908.4,red,1.67,2.5,20,18,red
4525837702,7,1,12,1,1,0,0,17696,7.2,18389,223,55,3650,2712,22.3,1769.6,1,7,1,0,0,0,0,14046,6.2,15677,237,32,-3650,-2712,23.7,1404.6,blue,19,0.29,31,25,blue
4514102317,6,11,5,0,0,0,0,15777,7,17772,215,37,-2930,136,21.5,1577.7,11,6,8,1,1,0,0,18707,6.8,17636,215,42,2930,-136,21.5,1870.7,red,1,3.17,16,15,blue
4526030769,5,17,3,0,0,0,0,14494,6.6,15666,181,36,-5290,-3110,18.1,1449.4,17,5,14,1,1,0,0,19784,7.2,18776,192,48,5290,3110,19.2,1978.4,red,0.47,6.2,15,14,red
4512376408,8,4,8,1,1,0,0,18385,7.2,19050,244,57,2957,1677,24.4,1838.5,4,8,6,0,0,0,0,15428,6.8,17373,210,46,-2957,-1677,21,1542.8,red,4,1.25,14,17,blue
4518050394,3,3,3,0,0,0,0,15081,6.8,17777,206,50,-66,815,20.6,1508.1,3,3,6,0,0,0,0,15147,7,16962,215,45,66,-815,21.5,1514.7,red,2,3,47,19,blue
4505778188,7,3,8,0,0,0,0,16702,6.8,17865,203,54,1713,1391,20.3,1670.2,3,7,6,0,0,0,0,14989,6.6,16474,228,42,-1713,-1391,22.8,1498.9,blue,5,1.29,15,19,blue
4516341582,6,4,5,1,0,1,0,17481,7.4,19040,248,39,1784,1193,24.8,1748.1,4,6,3,1,1,0,0,15697,7,17847,216,60,-1784,-1193,21.6,1569.7,blue,2.75,1.17,25,23,red
4513004661,7,6,7,0,0,0,0,16445,7,18995,224,40,214,1568,22.4,1644.5,6,7,5,0,0,0,0,16231,6.8,17427,215,53,-214,-1568,21.5,1623.1,blue,2.33,1.57,21,22,blue
4498027358,5,7,4,0,0,0,0,14387,6.4,15777,158,48,-3214,-2195,15.8,1438.7,7,5,10,2,1,1,0,17601,7,17972,226,42,3214,2195,22.6,1760.1,red,1.29,3.4,18,18,red
4511953640,5,0,5,2,1,1,1,18261,7.4,19979,248,67,4062,2618,24.8,1826.1,0,5,0,0,0,0,0,14199,6.8,17361,228,60,-4062,-2618,22.8,1419.9,blue,12.03,0,39,57,blue
4512246178,11,5,6,2,1,1,1,20151,7.4,20475,261,72,4296,3034,26.1,2015.1,5,11,9,0,0,0,0,15855,6.8,17441,173,75,-4296,-3034,17.3,1585.5,blue,3.4,1.27,26,17,blue
4508499882,7,5,7,1,0,1,0,16232,7,18631,200,52,319,1559,20,1623.2,5,7,4,1,1,0,0,15913,6.8,17072,224,51,-319,-1559,22.4,1591.3,blue,2.8,1.29,40,26,blue
4520508656,1,6,0,0,0,0,0,13775,7,17208,206,61,-2217,-715,20.6,1377.5,6,1,6,1,1,0,0,15992,6.8,17923,242,40,2217,715,24.2,1599.2,blue,0.17,12,19,22,red
4515450314,3,3,4,1,1,0,0,14771,6.8,17669,234,52,-916,190,23.4,1477.1,3,3,5,0,0,0,0,15687,6.8,17479,242,42,916,-190,24.2,1568.7,red,2.33,2.67,25,24,red
4526573036,2,1,2,1,0,1,0,15538,6.8,18222,264,57,982,682,26.4,1553.8,1,2,1,1,1,0,0,14556,6.8,17540,258,48,-982,-682,25.8,1455.6,blue,4,1,19,22,blue
4526662681,12,10,22,0,0,0,0,19390,7.2,18011,200,40,993,425,20,1939,10,12,12,0,0,0,0,18397,7,17586,190,36,-993,-425,19,1839.7,red,3.4,1.83,20,24,red
4525919614,6,6,8,1,1,0,0,16474,6.8,17494,209,36,-912,-739,20.9,1647.4,6,6,12,1,0,1,0,17386,7,18233,244,60,912,739,24.4,1738.6,blue,2.33,3,23,25,red
4497788373,11,3,13,1,1,0,0,19267,7.6,20141,230,58,4538,3583,23,1926.7,3,11,3,0,0,0,0,14729,6.4,16558,201,57,-4538,-3583,20.1,1472.9,blue,8,0.55,17,13,blue
4525974749,6,6,5,0,0,0,0,16367,7,17910,218,56,-1761,-226,21.8,1636.7,6,6,4,2,1,1,1,18128,7,18136,233,54,1761,226,23.3,1812.8,red,1.83,1.67,29,15,blue
4527584332,7,9,8,1,0,1,0,16066,6.8,18218,195,48,-1826,-3,19.5,1606.6,9,7,11,1,1,0,0,17892,7,18221,183,52,1826,3,18.3,1789.2,blue,1.67,2.86,18,63,red
4520983823,3,8,3,0,0,0,0,14790,6.4,16619,217,37,-1967,-1292,21.7,1479,8,3,11,1,1,0,0,16757,7,17911,204,52,1967,1292,20.4,1675.7,red,0.75,6.33,23,21,red
4527399718,1,6,1,0,0,0,0,14417,7,17488,237,61,-2984,-1466,23.7,1441.7,6,1,10,1,1,0,0,17401,7,18954,248,54,2984,1466,24.8,1740.1,red,0.33,16,15,14,red
4526421447,6,8,3,0,0,0,0,16365,6.8,18280,195,71,94,1896,19.5,1636.5,8,6,8,1,1,0,0,16271,6.6,16384,191,50,-94,-1896,19.1,1627.1,red,1.12,2.67,24,21,red
4525586479,7,6,9,1,0,1,0,16647,6.6,17867,214,60,-206,-363,21.4,1664.7,6,7,10,1,1,0,0,16853,7,18230,238,39,206,363,23.8,1685.3,blue,2.67,2.29,62,21,blue
4493982450,3,7,3,1,1,0,0,15058,6.8,17113,223,55,-2588,-497,22.3,1505.8,7,3,3,0,0,0,1,17646,6.8,17610,223,44,2588,497,22.3,1764.6,red,0.86,3.33,83,14,red
4526960902,10,5,9,1,0,1,1,20419,7.6,20428,246,53,5113,4028,24.6,2041.9,5,10,5,1,1,0,0,15306,6.6,16400,186,40,-5113,-4028,18.6,1530.6,red,3.8,1,21,51,red
4494136830,5,3,6,1,1,0,0,16224,6.8,18284,254,53,586,348,25.4,1622.4,3,5,3,0,0,0,0,15638,6.8,17936,245,50,-586,-348,24.5,1563.8,red,3.67,1.2,16,17,blue
4527368382,8,6,9,1,1,0,0,16338,6.4,16019,191,32,-577,-2221,19.1,1633.8,6,8,5,0,0,0,0,16915,7.2,18240,204,64,577,2221,20.4,1691.5,red,2.83,1.38,21,17,blue
4527621723,10,2,7,2,1,1,3,19557,7,18070,191,51,4380,3242,19.1,1955.7,2,10,4,0,0,0,1,15177,6,14828,184,49,-4380,-3242,18.4,1517.7,blue,8.5,0.6,46,11,blue
4515763607,4,7,1,0,0,0,0,14125,6.6,16758,170,44,-2858,-520,17,1412.5,7,4,9,1,1,0,0,16983,7,17278,224,48,2858,520,22.4,1698.3,red,0.71,4,17,17,red
4527673599,3,5,2,0,0,0,0,15125,6.6,17843,197,80,-712,977,19.7,1512.5,5,3,9,1,1,0,0,15837,6.8,16866,216,42,712,-977,21.6,1583.7,blue,1,4.67,19,19,red
4525226479,7,10,11,0,0,0,0,17297,7,18422,228,51,-2526,-1811,22.8,1729.7,10,7,11,2,1,1,1,19823,7.4,20233,221,47,2526,1811,22.1,1982.3,red,1.8,3,21,20,blue
4525936315,7,9,6,1,1,0,0,16437,6.8,16958,195,48,-222,17,19.5,1643.7,9,7,12,0,0,0,0,16659,6.8,16941,208,34,222,-17,20.8,1665.9,blue,1.44,3,58,24,blue
4527437019,5,7,5,0,0,0,0,15689,6.6,16026,187,48,-1544,-792,18.7,1568.9,7,5,6,1,1,0,1,17233,6.6,16818,180,53,1544,792,18,1723.3,blue,1.43,2.6,38,42,red
4526335845,5,7,7,0,0,0,0,16281,6.8,17598,216,46,127,-941,21.6,1628.1,7,5,10,2,1,1,0,16154,7,18539,194,48,-127,941,19.4,1615.4,blue,1.71,3.4,20,22,red
4492568558,10,4,11,0,0,0,0,17464,7,18187,217,35,1579,-171,21.7,1746.4,4,10,5,1,1,0,0,15885,6.8,18358,205,68,-1579,171,20.5,1588.5,blue,5.25,0.9,18,14,blue
4518459736,9,4,8,1,0,1,1,19978,7.4,19500,251,54,5201,1656,25.1,1997.8,4,9,2,1,1,0,0,14777,7,17844,179,52,-5201,-1656,17.9,1477.7,blue,4.25,0.67,13,38,blue
4511340293,10,2,15,1,1,0,0,18142,7.2,18432,224,53,3680,2530,22.4,1814.2,2,10,1,0,0,0,0,14462,6.6,15902,190,53,-3680,-2530,19,1446.2,blue,12.5,0.3,17,17,blue
4498725511,8,1,6,2,1,1,1,18375,7.2,19454,222,51,4941,3427,22.2,1837.5,1,8,2,0,0,0,0,13434,6.6,16027,200,48,-4941,-3427,20,1343.4,blue,14,0.38,44,17,blue
4515480447,6,6,5,0,0,0,0,16507,7,18941,216,65,479,350,21.6,1650.7,6,6,6,0,0,0,0,16028,7.2,18591,212,52,-479,-350,21.2,1602.8,blue,1.83,2,15,40,red
4516935258,3,4,6,1,1,0,0,14988,6.4,15830,214,52,-1093,-1958,21.4,1498.8,4,3,4,0,0,0,0,16081,6.8,17788,237,44,1093,1958,23.7,1608.1,blue,2.25,2.67,18,18,red
4523809434,5,5,4,1,1,0,0,16203,7,18321,228,51,2,-365,22.8,1620.3,5,5,6,0,0,0,0,16201,7,18686,228,53,-2,365,22.8,1620.1,red,1.8,2.2,82,24,red
4517594548,5,4,5,0,0,0,0,16522,7,18641,236,57,1958,2380,23.6,1652.2,4,5,5,0,0,0,0,14564,6.6,16261,195,44,-1958,-2380,19.5,1456.4,blue,2.5,1.8,23,17,red
4513943216,12,7,11,0,0,0,0,18306,6.6,16973,214,34,1898,274,21.4,1830.6,7,12,10,1,1,0,0,16408,6.4,16699,197,49,-1898,-274,19.7,1640.8,red,3.29,1.42,18,21,blue
4513493153,10,8,10,0,0,0,0,17573,7,17180,205,42,-81,-1466,20.5,1757.3,8,10,6,1,1,0,0,17654,7,18646,227,57,81,1466,22.7,1765.4,red,2.5,1.4,58,22,blue
4527431708,8,3,4,2,1,1,1,17827,7.2,19215,229,44,3073,1928,22.9,1782.7,3,8,2,0,0,0,0,14754,6.8,17287,182,54,-3073,-1928,18.2,1475.4,blue,4,0.62,15,8,blue
4507304964,5,9,3,1,1,0,0,16182,7,17560,204,46,-320,-120,20.4,1618.2,9,5,11,0,0,0,0,16502,7,17680,195,36,320,120,19.5,1650.2,red,0.89,4,18,17,blue
4527385482,3,5,3,1,1,0,0,15309,6.8,17455,245,49,-1069,-298,24.5,1530.9,5,3,5,0,0,0,0,16378,6.8,17753,241,51,1069,298,24.1,1637.8,red,1.2,3.33,24,25,red
4518920963,4,5,8,0,0,0,0,15594,7,17492,233,52,366,1230,23.3,1559.4,5,4,4,1,1,0,0,15228,6.8,16262,205,40,-366,-1230,20.5,1522.8,red,2.4,2.25,70,47,red
4513224745,10,9,12,0,0,0,0,18340,7,18533,201,54,1899,896,20.1,1834,9,10,9,0,0,0,0,16441,6.8,17637,198,40,-1899,-896,19.8,1644.1,blue,2.44,1.8,18,18,blue
4527589984,6,5,7,2,1,1,1,17486,7.2,17915,215,52,1389,490,21.5,1748.6,5,6,5,0,0,0,0,16097,6.8,17425,198,71,-1389,-490,19.8,1609.7,blue,2.6,1.67,40,20,red
4517955952,8,9,8,0,0,0,0,16911,6.6,17768,207,52,-1165,729,20.7,1691.1,9,8,11,0,0,0,0,18076,6.6,17039,201,52,1165,-729,20.1,1807.6,blue,1.78,2.5,23,15,blue
4525782560,7,5,5,1,0,1,1,18107,7,18102,236,46,2002,301,23.6,1810.7,5,7,6,0,0,0,0,16105,6.6,17801,217,68,-2002,-301,21.7,1610.5,red,2.4,1.57,24,36,blue
4526697632,7,9,4,0,0,0,0,16649,7.2,18909,230,48,-360,658,23,1664.9,9,7,13,0,0,0,0,17009,6.8,18251,203,37,360,-658,20.3,1700.9,red,1.22,3.14,22,36,red
4524799428,9,3,7,0,0,0,0,18322,7.4,20963,258,68,4100,4903,25.8,1832.2,3,9,1,0,0,0,0,14222,6.4,16060,204,41,-4100,-4903,20.4,1422.2,blue,5.33,0.44,41,49,blue
4525167083,9,5,6,1,1,0,0,17366,6.8,17609,213,51,629,-887,21.3,1736.6,5,9,4,0,0,0,0,16737,7,18496,223,60,-629,887,22.3,1673.7,red,3,1,16,36,blue
4525999060,3,6,0,1,0,1,0,14984,7,18050,235,64,-1287,-746,23.5,1498.4,6,3,3,1,1,0,0,16271,7,18796,237,58,1287,746,23.7,1627.1,red,0.5,3,48,22,red
4512479841,11,5,15,0,0,0,0,18945,7,18908,241,35,3107,2132,24.1,1894.5,5,11,9,0,0,0,0,15838,6.8,16776,199,52,-3107,-2132,19.9,1583.8,blue,5.2,1.27,25,69,red
4516031571,8,5,6,0,0,0,0,17851,7.4,19947,257,44,1051,1224,25.7,1785.1,5,8,4,1,1,0,0,16800,7.2,18723,247,68,-1051,-1224,24.7,1680,red,2.8,1.12,20,21,red
4525797575,7,10,8,0,0,0,0,16900,6.8,16827,161,47,-1920,-3055,16.1,1690,10,7,8,1,1,0,0,18820,7.2,19882,225,70,1920,3055,22.5,1882,red,1.5,2.57,17,22,red
4505466847,3,4,4,0,0,0,0,14923,7,17661,229,48,-1899,-2290,22.9,1492.3,4,3,4,0,0,0,0,16822,7.2,19951,244,64,1899,2290,24.4,1682.2,red,1.75,2.67,45,53,red
4514465799,5,11,3,0,0,0,0,14790,6.6,16593,185,42,-3951,-2608,18.5,1479,11,5,15,1,1,0,0,18741,7.2,19201,225,51,3951,2608,22.5,1874.1,red,0.73,5.2,18,34,blue
4526366514,7,6,7,0,0,0,0,18035,7,18668,250,48,1977,1635,25,1803.5,6,7,13,0,0,0,0,16058,6.8,17033,183,47,-1977,-1635,18.3,1605.8,blue,2.33,2.71,18,15,blue
4527530188,6,7,7,1,1,0,0,17193,7.4,18554,257,55,577,1371,25.7,1719.3,7,6,8,0,0,0,0,16616,6.8,17183,228,47,-577,-1371,22.8,1661.6,blue,1.86,2.5,106,25,blue
4527408690,13,3,11,0,0,0,0,19536,7.6,20584,217,58,5452,4510,21.7,1953.6,3,13,3,0,0,0,0,14084,6.4,16074,178,44,-5452,-4510,17.8,1408.4,blue,8,0.46,19,19,blue
4508769864,5,2,7,2,1,1,0,16444,7.4,18995,229,63,1415,1951,22.9,1644.4,2,5,3,0,0,0,0,15029,6.8,17044,225,53,-1415,-1951,22.5,1502.9,red,6,1,54,19,red
4526802762,1,11,2,0,0,0,0,13177,6.2,15610,177,48,-7314,-6034,17.7,1317.7,11,1,13,1,1,0,0,20491,7.8,21644,258,68,7314,6034,25.8,2049.1,red,0.27,24,22,27,red
4527439661,13,8,20,1,1,0,0,17564,6.6,15596,167,28,2032,1193,16.7,1756.4,8,13,10,0,0,0,0,15532,6,14403,170,34,-2032,-1193,17,1553.2,blue,4.12,1.38,20,20,blue
4526405624,10,8,12,1,1,0,0,17281,7,17509,203,39,-1125,-1326,20.3,1728.1,8,10,6,1,0,1,1,18406,7,18835,229,40,1125,1326,22.9,1840.6,red,2.75,1.4,16,14,blue
4519461793,4,7,7,0,0,0,0,15818,6.8,17864,233,47,-60,1347,23.3,1581.8,7,4,13,1,1,0,0,15878,6.6,16517,186,36,60,-1347,18.6,1587.8,red,1.57,5,19,65,red
4525339465,5,7,8,0,0,0,0,16208,7,18110,218,54,-1656,-1363,21.8,1620.8,7,5,7,1,1,0,0,17864,7.2,19473,242,73,1656,1363,24.2,1786.4,red,1.86,2.8,19,15,red
4515440018,6,5,3,1,0,1,1,17174,7,18458,231,49,507,510,23.1,1717.4,5,6,5,1,1,0,0,16667,7,17948,233,57,-507,-510,23.3,1666.7,red,1.8,1.67,143,40,blue
4521530556,10,5,11,1,1,0,0,17920,7,18730,224,51,2536,746,22.4,1792,5,10,5,0,0,0,0,15384,7,17984,220,48,-2536,-746,22,1538.4,blue,4.2,1,18,41,red
4517920600,6,7,5,1,1,0,0,15882,7.2,18675,198,68,-1019,-361,19.8,1588.2,7,6,5,0,0,0,0,16901,7,19036,240,56,1019,361,24,1690.1,blue,1.57,2,20,18,red
4527391946,6,11,6,0,0,0,0,15801,6.6,17010,209,49,-1603,-809,20.9,1580.1,11,6,12,2,1,1,0,17404,7,17819,204,34,1603,809,20.4,1740.4,red,1.09,3.83,15,17,red
4516105924,10,5,13,0,0,0,0,18866,7.4,19651,252,51,3412,2086,25.2,1886.6,5,10,8,0,0,0,0,15454,7,17565,207,49,-3412,-2086,20.7,1545.4,red,4.6,1.3,44,21,blue
4518005964,1,4,1,2,1,1,0,14056,6.6,16260,223,50,-1903,-2537,22.3,1405.6,4,1,3,0,0,0,0,15959,7,18797,231,55,1903,2537,23.1,1595.9,red,0.5,7,25,27,blue
4521217468,5,10,4,1,1,0,0,15876,6.8,17206,224,39,-2266,-2047,22.4,1587.6,10,5,9,1,0,1,0,18142,7.2,19253,221,60,2266,2047,22.1,1814.2,red,0.9,3.8,50,25,red
4526264359,3,3,2,1,0,1,0,15567,7,18798,232,52,62,1348,23.2,1556.7,3,3,5,0,0,0,0,15505,7,17450,237,56,-62,-1348,23.7,1550.5,red,1.67,2.67,15,12,blue
4515338624,5,11,8,0,0,0,0,15979,6.8,16648,190,39,-3456,-1429,19,1597.9,11,5,15,2,1,1,0,19435,7,18077,189,44,3456,1429,18.9,1943.5,red,1.18,5.2,14,16,red
4524245111,6,5,4,1,1,0,0,16398,6.6,17974,236,53,768,505,23.6,1639.8,5,6,5,0,0,0,0,15630,7,17469,218,49,-768,-505,21.8,1563,red,2,1.67,18,61,red
4464331919,4,4,3,1,0,1,0,15721,7.2,18756,213,64,-1050,89,21.3,1572.1,4,4,6,1,1,0,0,16771,7.2,18667,238,56,1050,-89,23.8,1677.1,red,1.75,2.5,50,18,blue
4520317076,2,8,1,0,0,0,0,14206,6.6,16793,200,50,-3427,-1792,20,1420.6,8,2,7,1,1,0,0,17633,7,18585,253,48,3427,1792,25.3,1763.3,red,0.38,7.5,19,20,red
4517907839,15,5,18,1,1,0,1,20844,7.2,18777,250,39,6672,3761,25,2084.4,5,15,4,1,0,1,0,14172,6,15016,171,44,-6672,-3761,17.1,1417.2,blue,6.6,0.6,15,23,blue
4521327659,8,3,9,1,1,0,0,17428,7.2,19729,220,50,2087,2578,22,1742.8,3,8,2,0,0,0,0,15341,6.8,17151,229,65,-2087,-2578,22.9,1534.1,blue,5.67,0.62,15,21,blue
4527366707,7,2,10,0,0,0,0,16879,7.2,18526,211,52,2053,1126,21.1,1687.9,2,7,3,1,1,0,0,14826,6.8,17400,232,64,-2053,-1126,23.2,1482.6,blue,8.5,0.71,20,18,red
4526361954,8,2,9,1,1,0,1,17422,6.8,17192,211,24,2394,-1292,21.1,1742.2,2,8,3,0,0,0,0,15028,7,18484,210,76,-2394,1292,21,1502.8,blue,8.5,0.62,24,41,blue
4500489540,3,3,3,0,0,0,0,15255,7,18312,228,45,-112,233,22.8,1525.5,3,3,3,0,0,0,0,15367,7,18079,234,56,112,-233,23.4,1536.7,red,2,2,15,40,red
4513422670,6,9,8,1,1,0,0,16978,7.2,19145,205,55,-1712,-394,20.5,1697.8,9,6,16,0,0,0,0,18690,7.4,19539,208,56,1712,394,20.8,1869,red,1.56,4.17,38,22,red
4526746921,6,9,9,1,1,0,0,15738,6.6,16512,188,53,-2550,-1985,18.8,1573.8,9,6,6,0,0,0,0,18288,7,18497,224,57,2550,1985,22.4,1828.8,red,1.67,2.5,17,16,red
4526966381,9,6,8,0,0,0,0,17079,7,18150,203,47,899,295,20.3,1707.9,6,9,7,1,1,0,0,16180,7,17855,225,36,-899,-295,22.5,1618,red,2.83,1.44,16,105,red
4526838026,1,4,1,0,0,0,0,14761,7,17655,230,56,-294,-1277,23,1476.1,4,1,4,0,0,0,0,15055,7.2,18932,193,52,294,1277,19.3,1505.5,blue,0.5,8,18,54,blue
4520747802,12,4,10,1,1,0,0,19724,7.8,20621,263,49,4999,3308,26.3,1972.4,4,12,4,1,0,1,0,14725,6.6,17313,148,73,-4999,-3308,14.8,1472.5,blue,5.5,0.67,20,23,blue
4526781753,8,3,12,1,1,0,0,17479,7.2,19021,243,48,2143,1315,24.3,1747.9,3,8,4,0,0,0,0,15336,7,17706,203,44,-2143,-1315,20.3,1533.6,red,6.67,0.88,20,22,blue
4523917327,16,10,17,2,1,1,0,20344,7,18646,193,48,3175,1975,19.3,2034.4,10,16,11,0,0,0,0,17169,6.6,16671,162,32,-3175,-1975,16.2,1716.9,blue,3.3,1.31,17,44,red
4497655000,2,6,2,0,0,0,0,15141,7.2,18537,230,62,-2506,-1979,23,1514.1,6,2,9,1,1,0,0,17647,7.6,20516,250,70,2506,1979,25,1764.7,red,0.67,7.5,20,45,red
4526194900,4,3,5,0,0,0,0,15793,6.8,17950,246,40,848,463,24.6,1579.3,3,4,3,1,1,0,0,14945,7,17487,210,52,-848,-463,21,1494.5,red,3,1.5,19,51,red
4512044253,6,9,4,0,0,0,0,15653,6.6,16241,203,40,-2026,-1235,20.3,1565.3,9,6,14,1,1,0,0,17679,7,17476,216,51,2026,1235,21.6,1767.9,blue,1.11,3.83,21,25,blue
4519376202,5,3,4,1,1,0,0,15836,7,18174,223,44,813,487,22.3,1583.6,3,5,3,0,0,0,0,15023,6.8,17687,219,64,-813,-487,21.9,1502.3,blue,3,1.2,16,15,blue
4503713069,4,2,4,0,0,0,0,14673,6.4,16034,183,47,-110,-1469,18.3,1467.3,2,4,3,2,1,1,0,14783,6.8,17503,214,56,110,1469,21.4,1478.3,blue,4,1.25,17,17,blue
4527158569,10,4,11,0,0,0,0,18270,7,18656,249,41,3134,1069,24.9,1827,4,10,1,1,1,0,0,15136,7,17587,217,52,-3134,-1069,21.7,1513.6,blue,5.25,0.5,23,44,blue
4527454154,13,12,19,0,0,0,0,19362,6.6,17316,195,28,965,1856,19.5,1936.2,12,13,20,1,0,1,0,18397,6.4,15460,180,40,-965,-1856,18,1839.7,red,2.67,2.46,24,18,blue
4525563784,5,6,6,1,1,0,0,15820,6.8,17954,200,59,40,1340,20,1582,6,5,8,0,0,0,0,15780,6.6,16614,212,48,-40,-1340,21.2,1578,red,1.83,2.8,18,34,blue
4492374255,5,3,5,1,1,0,0,16583,6.8,17825,219,60,961,-900,21.9,1658.3,3,5,2,1,0,1,0,15622,7,18725,234,64,-961,900,23.4,1562.2,blue,3.33,1,20,14,blue
4509228650,9,3,6,1,1,0,0,18558,7.2,19625,269,51,3958,3881,26.9,1855.8,3,9,4,1,0,1,0,14600,6.4,15744,194,43,-3958,-3881,19.4,1460,blue,5,0.78,17,13,blue
4499967324,6,4,7,0,0,0,0,17477,7,19006,232,64,1814,73,23.2,1747.7,4,6,4,1,1,0,0,15663,7,18933,210,72,-1814,-73,21,1566.3,blue,3.25,1.33,20,14,blue
4498918077,3,7,2,0,0,0,0,14935,7,18365,198,59,-3469,-1687,19.8,1493.5,7,3,9,2,1,1,0,18404,7.2,20052,263,72,3469,1687,26.3,1840.4,blue,0.71,5.33,16,16,blue
4526188851,14,6,10,1,0,1,0,19203,7.4,20047,220,49,3548,3559,22,1920.3,6,14,7,1,1,0,0,15655,6.6,16488,204,30,-3548,-3559,20.4,1565.5,blue,4,0.93,20,17,blue
4521641532,6,6,3,0,0,0,0,16701,6.8,17820,237,40,882,450,23.7,1670.1,6,6,5,0,0,0,0,15819,6.8,17370,192,56,-882,-450,19.2,1581.9,blue,1.5,1.83,16,20,blue
4502676809,13,3,19,1,0,1,0,17529,6.8,17038,138,40,1530,-1195,13.8,1752.9,3,13,2,1,1,0,0,15999,6.8,18233,243,63,-1530,1195,24.3,1599.9,red,10.67,0.38,70,22,blue
4517665139,4,8,5,0,0,0,0,15264,6.4,16327,208,44,-3212,-1661,20.8,1526.4,8,4,10,0,0,0,0,18476,7,17988,217,42,3212,1661,21.7,1847.6,red,1.12,4.5,23,24,red
4526573339,8,6,7,1,1,0,0,17403,7.4,19112,215,47,1518,1874,21.5,1740.3,6,8,9,0,0,0,0,15885,6.6,17238,192,40,-1518,-1874,19.2,1588.5,red,2.5,1.88,57,18,blue
4526195389,4,6,2,1,0,1,0,15500,6.8,17374,218,56,-1006,-1606,21.8,1550,6,4,5,1,1,0,0,16506,7.2,18980,221,48,1006,1606,22.1,1650.6,blue,1,2.75,21,48,blue
4510184598,2,5,5,0,0,0,0,12886,6,14091,165,32,-3117,-3799,16.5,1288.6,5,2,4,1,1,0,0,16003,6.8,17890,206,60,3117,3799,20.6,1600.3,red,1.4,4.5,28,17,red
4527284987,6,3,7,1,1,0,1,17780,7.2,18440,221,48,3170,2080,22.1,1778,3,6,4,0,0,0,0,14610,6.4,16360,213,41,-3170,-2080,21.3,1461,blue,4.33,1.17,19,14,blue
4509444763,3,7,2,0,0,0,0,15632,7,18400,232,72,-1822,-1467,23.2,1563.2,7,3,6,2,1,1,0,17454,7.4,19867,244,52,1822,1467,24.4,1745.4,blue,0.71,4.33,18,20,red
4525200443,6,7,5,1,1,0,0,16230,6.8,17203,190,59,-726,-1249,19,1623,7,6,12,0,0,0,0,16956,7.2,18452,230,53,726,1249,23,1695.6,blue,1.57,3.17,19,17,blue
4506796397,4,2,4,1,1,0,0,15346,7,18388,232,52,1342,1886,23.2,1534.6,2,4,2,0,0,0,0,14004,6.6,16502,206,40,-1342,-1886,20.6,1400.4,blue,4,1,15,14,red
4515299761,3,2,4,1,1,0,0,15718,7,17991,250,53,1464,925,25,1571.8,2,3,4,0,0,0,0,14254,6.6,17066,215,52,-1464,-925,21.5,1425.4,red,3.5,2,24,97,blue
4511146118,6,4,9,1,1,0,0,17620,7,19434,233,64,2387,1411,23.3,1762,4,6,7,0,0,0,0,15233,6.8,18023,201,67,-2387,-1411,20.1,1523.3,blue,3.75,1.83,79,19,blue
4515302737,4,13,4,0,0,0,0,14958,6.8,16993,207,47,-4629,-3393,20.7,1495.8,13,4,16,1,1,0,0,19587,7.4,20386,239,46,4629,3393,23.9,1958.7,red,0.62,7.25,18,59,red
4495228612,2,6,2,0,0,0,0,14025,6.6,16510,205,51,-2846,-1964,20.5,1402.5,6,2,4,1,1,0,0,16871,6.8,18474,218,64,2846,1964,21.8,1687.1,red,0.67,5,18,24,red
4496483368,4,3,3,2,1,1,0,15656,7,17844,227,48,85,-706,22.7,1565.6,3,4,3,0,0,0,0,15571,7,18550,217,63,-85,706,21.7,1557.1,blue,2.33,1.5,51,21,blue
4515415640,9,14,10,0,0,0,0,17155,6.6,16245,183,32,-4473,-2976,18.3,1715.5,14,9,16,2,1,1,1,21628,7,19221,214,51,4473,2976,21.4,2162.8,red,1.36,3.33,21,19,blue
4523576298,8,3,7,1,1,0,0,16595,7.2,18940,210,55,859,2681,21,1659.5,3,8,7,0,0,0,0,15736,6.4,16259,203,39,-859,-2681,20.3,1573.6,blue,5,1.25,18,22,blue
4524577169,9,8,13,1,1,0,0,17283,6.6,16810,205,28,-428,5,20.5,1728.3,8,9,7,1,0,1,0,17711,6.6,16805,213,36,428,-5,21.3,1771.1,blue,2.75,1.67,25,21,blue
4518919101,5,8,9,0,0,0,0,15388,6.4,15598,179,39,-4104,-3458,17.9,1538.8,8,5,8,0,0,0,1,19492,7.2,19056,264,55,4104,3458,26.4,1949.2,red,1.75,3.2,14,19,red
4527605062,11,10,9,1,0,1,0,17797,7,17892,191,36,354,248,19.1,1779.7,10,11,11,0,0,0,0,17443,6.8,17644,198,44,-354,-248,19.8,1744.3,red,2,1.91,19,20,blue
4511899232,6,7,6,0,0,0,0,17170,7,18110,243,60,959,2183,24.3,1717,7,6,10,0,0,0,0,16211,6.4,15927,194,36,-959,-2183,19.4,1621.1,blue,1.71,2.83,28,23,red
4522413426,4,2,5,0,0,0,0,16729,7,18725,227,48,1970,804,22.7,1672.9,2,4,2,0,0,0,0,14759,6.8,17921,228,73,-1970,-804,22.8,1475.9,blue,4.5,1,15,17,blue
4515922365,8,9,6,0,0,0,0,17424,7.2,18146,224,37,-618,-669,22.4,1742.4,9,8,8,0,0,0,0,18042,7,18815,223,57,618,669,22.3,1804.2,red,1.56,2.12,12,19,blue
4507608751,8,7,12,2,1,1,0,16912,6.8,17022,213,57,106,-1098,21.3,1691.2,7,8,6,0,0,0,0,16806,7,18120,179,60,-106,1098,17.9,1680.6,red,2.86,1.62,21,30,blue
4524488615,12,6,18,1,0,1,1,19426,6.8,18749,218,37,4146,3141,21.8,1942.6,6,12,8,1,1,0,0,15280,6.4,15608,191,44,-4146,-3141,19.1,1528,red,5,1.17,68,25,blue
4521968003,5,4,5,0,0,0,0,16062,6.8,17907,195,61,39,-1075,19.5,1606.2,4,5,3,1,1,0,0,16023,7.2,18982,237,61,-39,1075,23.7,1602.3,red,2.5,1.4,15,51,blue
4508126209,7,4,4,1,0,1,1,17440,7,18208,197,55,2367,1946,19.7,1744,4,7,3,1,1,0,0,15073,6.6,16262,178,63,-2367,-1946,17.8,1507.3,blue,2.75,1,14,20,red
4525991755,3,11,3,0,0,0,0,15273,6.6,16831,227,41,-2111,-1607,22.7,1527.3,11,3,11,1,1,0,0,17384,6.8,18438,218,48,2111,1607,21.8,1738.4,red,0.55,7.33,20,24,blue
4510144910,5,6,5,0,0,0,0,16571,7.2,19112,212,66,-528,1756,21.2,1657.1,6,5,7,2,1,1,0,17099,6.6,17356,210,49,528,-1756,21,1709.9,blue,1.67,2.6,22,22,red
4510116594,10,5,9,1,0,1,1,19204,7.2,20182,228,59,4424,4969,22.8,1920.4,5,10,8,1,1,0,0,14780,6.4,15213,187,36,-4424,-4969,18.7,1478,blue,3.8,1.3,20,13,blue
4525296321,2,4,2,0,0,0,0,15210,6.8,17457,222,45,262,-414,22.2,1521,4,2,5,2,1,1,0,14948,7,17871,216,46,-262,414,21.6,1494.8,red,1,4.5,15,16,blue
4526741895,6,8,7,0,0,0,0,17190,6.8,17552,226,44,777,576,22.6,1719,8,6,9,0,0,0,0,16413,6.6,16976,190,30,-777,-576,19,1641.3,red,1.62,2.83,17,18,blue
4510821185,6,6,4,0,0,0,0,16839,7,18230,222,57,468,370,22.2,1683.9,6,6,8,1,1,0,0,16371,6.8,17860,211,58,-468,-370,21.1,1637.1,red,1.67,2.33,24,22,red
4516090718,3,7,2,0,0,0,0,14552,6.6,16760,222,49,-3408,-1490,22.2,1455.2,7,3,5,2,1,1,1,17960,7,18250,228,44,3408,1490,22.8,1796,red,0.71,4,22,21,red
4525553823,10,4,13,1,1,0,0,19359,7.2,19182,243,53,4424,2663,24.3,1935.9,4,10,5,0,0,0,0,14935,6.8,16519,189,62,-4424,-2663,18.9,1493.5,blue,5.75,0.9,14,57,red
4493623351,6,6,4,2,1,1,0,16043,7,18113,213,56,-76,1720,21.3,1604.3,6,6,8,0,0,0,0,16119,6.6,16393,206,40,76,-1720,20.6,1611.9,blue,1.67,2.33,24,15,blue
4506599710,5,16,4,0,0,0,0,15723,6.4,15978,196,64,-5601,-4942,19.6,1572.3,16,5,22,1,1,0,0,21324,7.6,20920,210,47,5601,4942,21,2132.4,red,0.56,7.6,14,16,red
4525005115,6,6,9,0,0,0,0,17924,7,18749,248,46,870,703,24.8,1792.4,6,6,9,0,0,0,0,17054,6.8,18046,241,39,-870,-703,24.1,1705.4,red,2.5,2.5,16,18,red
4516402388,4,3,2,1,0,1,0,15833,7.2,18396,250,52,904,1043,25,1583.3,3,4,3,1,1,0,0,14929,6.8,17353,213,64,-904,-1043,21.3,1492.9,blue,2,1.5,19,25,blue
4521730621,6,3,7,1,0,1,0,16691,7.4,19203,226,60,1814,1762,22.6,1669.1,3,6,3,0,0,0,0,14877,6.8,17441,214,55,-1814,-1762,21.4,1487.7,blue,4.33,1,18,14,blue
4526612665,1,1,3,0,0,0,0,15301,7,18098,249,72,166,-436,24.9,1530.1,1,1,0,1,1,0,0,15135,6.8,18534,230,60,-166,436,23,1513.5,red,4,1,24,21,blue
4527526766,7,8,6,0,0,0,0,16132,7,17360,207,48,-1211,-2257,20.7,1613.2,8,7,9,1,0,1,0,17343,7.2,19617,244,52,1211,2257,24.4,1734.3,red,1.62,2.43,21,37,blue
4515305761,7,6,7,0,0,0,0,17513,7.2,18336,228,51,1941,846,22.8,1751.3,6,7,5,1,0,1,0,15572,6.6,17490,188,48,-1941,-846,18.8,1557.2,red,2.33,1.57,15,124,blue
4526921944,7,6,9,1,1,0,0,17108,7,18548,230,59,990,1798,23,1710.8,6,7,6,0,0,0,0,16118,6.6,16750,218,48,-990,-1798,21.8,1611.8,blue,2.67,1.71,21,57,red
4510935065,6,5,8,2,1,1,0,17178,7,18411,234,74,2614,2285,23.4,1717.8,5,6,2,0,0,0,0,14564,6.4,16126,170,52,-2614,-2285,17,1456.4,blue,2.8,1.17,26,18,red
4505405974,3,4,3,0,0,0,0,14511,6.6,16462,212,42,-342,-2245,21.2,1451.1,4,3,1,1,1,0,0,14853,7.4,18707,212,43,342,2245,21.2,1485.3,red,1.5,1.67,22,20,red
4523899189,1,11,1,1,0,1,0,13199,6.2,15949,173,49,-6134,-4660,17.3,1319.9,11,1,13,0,0,0,0,19333,7.6,20609,255,54,6134,4660,25.5,1933.3,red,0.18,24,16,16,red
4507851254,6,5,12,0,0,0,1,17107,6.8,17665,215,43,-1661,-1259,21.5,1710.7,5,6,4,2,1,1,2,18768,7,18924,239,71,1661,1259,23.9,1876.8,blue,3.6,1.5,54,22,red
4526397117,6,16,3,0,0,0,0,14731,6.2,15155,154,44,-6086,-3112,15.4,1473.1,16,6,20,0,0,0,0,20817,7,18267,237,32,6086,3112,23.7,2081.7,red,0.56,6,58,26,red
4516262815,4,7,6,0,0,0,0,14937,6.8,16417,211,57,-2601,-3694,21.1,1493.7,7,4,8,2,1,1,0,17538,7.4,20111,232,60,2601,3694,23.2,1753.8,red,1.43,3.75,32,20,blue
4508188294,1,10,1,0,0,0,0,13340,6.2,15466,223,32,-3586,-2271,22.3,1334,10,1,16,1,1,0,0,16926,6.8,17737,189,32,3586,2271,18.9,1692.6,red,0.2,26,14,38,red
4516175381,9,4,11,1,0,1,1,19684,7.4,20073,217,60,3920,3302,21.7,1968.4,4,9,3,1,1,0,0,15764,6.6,16771,219,48,-3920,-3302,21.9,1576.4,blue,5,0.78,18,20,red
4504961741,2,7,2,0,0,0,0,15461,6.8,17683,206,60,-1912,-2257,20.6,1546.1,7,2,7,2,1,1,0,17373,7.2,19940,243,55,1912,2257,24.3,1737.3,red,0.57,7,17,18,red
4527013199,3,2,1,1,1,0,0,14700,6.8,17577,234,40,203,411,23.4,1470,2,3,0,0,0,0,0,14497,6.8,17166,253,40,-203,-411,25.3,1449.7,blue,2,0.67,22,16,blue
4523014807,5,7,5,1,1,0,0,17026,7,18231,213,76,17,-403,21.3,1702.6,7,5,6,1,0,1,0,17009,7,18634,218,68,-17,403,21.8,1700.9,red,1.43,2.6,80,17,red
4513262976,4,1,9,1,1,0,0,15357,6.8,17204,200,59,1273,1061,20,1535.7,1,4,2,0,0,0,0,14084,6.4,16143,239,40,-1273,-1061,23.9,1408.4,blue,13,0.75,23,21,red
4511560979,9,7,9,0,0,0,0,17498,7,17932,200,42,1023,19,20,1749.8,7,9,6,1,0,1,0,16475,6.8,17913,196,32,-1023,-19,19.6,1647.5,blue,2.57,1.44,21,18,blue
4520677506,5,12,3,0,0,0,0,15140,6.4,15745,198,39,-3371,-2094,19.8,1514,12,5,15,1,1,0,0,18511,7,17839,217,52,3371,2094,21.7,1851.1,red,0.67,5.4,20,23,red
4502187260,5,5,7,1,1,0,0,16398,7,17450,218,52,455,524,21.8,1639.8,5,5,10,0,0,0,0,15943,6.6,16926,184,56,-455,-524,18.4,1594.3,blue,2.4,3,17,37,red
4499958470,8,7,7,1,1,0,0,16972,7,18007,184,44,891,1054,18.4,1697.2,7,8,7,0,0,0,0,16081,6.6,16953,196,51,-891,-1054,19.6,1608.1,blue,2.14,1.75,15,15,blue
4515405283,9,2,5,0,0,0,0,17777,7.4,19414,238,48,3361,3545,23.8,1777.7,2,9,1,0,0,0,0,14416,6.4,15869,208,44,-3361,-3545,20.8,1441.6,blue,7,0.33,18,17,blue
4507361840,5,0,4,1,1,0,0,16184,7,18007,223,51,2813,1222,22.3,1618.4,0,5,0,0,0,0,0,13371,6.6,16785,210,48,-2813,-1222,21,1337.1,blue,12.03,0,15,11,blue
4524432145,2,9,2,0,0,0,0,14085,6.4,15408,220,38,-3803,-4020,22,1408.5,9,2,4,2,1,1,0,17888,7.2,19428,245,60,3803,4020,24.5,1788.8,red,0.44,6.5,19,19,red
4520393819,3,8,7,0,0,0,0,13944,6.6,15850,185,48,-3179,-2574,18.5,1394.4,8,3,7,1,1,0,0,17123,7,18424,230,48,3179,2574,23,1712.3,red,1.25,5,19,28,red
4526463551,5,5,9,1,0,1,0,16730,7,17875,246,52,913,14,24.6,1673,5,5,6,0,0,0,0,15817,6.8,17861,205,55,-913,-14,20.5,1581.7,blue,2.8,2.2,15,14,red
4509912325,2,7,4,1,1,0,0,14507,6.4,16400,215,52,-2328,-1153,21.5,1450.7,7,2,7,1,0,1,0,16835,6.8,17553,189,52,2328,1153,18.9,1683.5,red,0.86,7,97,43,red
4500758872,4,8,6,0,0,0,0,14327,6.6,16104,194,30,-3392,-2116,19.4,1432.7,8,4,7,1,1,0,0,17719,6.8,18220,223,41,3392,2116,22.3,1771.9,red,1.25,3.75,11,17,red
4527276272,8,10,8,1,1,0,0,17048,7,18361,230,61,171,1158,23,1704.8,10,8,10,0,0,0,0,16877,6.8,17203,185,35,-171,-1158,18.5,1687.7,red,1.6,2.5,23,48,red
4495265791,4,2,4,0,0,0,0,16103,7,17909,238,60,1119,-12,23.8,1610.3,2,4,0,0,0,0,0,14984,6.8,17921,245,48,-1119,12,24.5,1498.4,red,4,0.5,19,23,blue
4511710215,5,10,6,0,0,0,0,16413,6.8,18104,225,50,-3036,-2088,22.5,1641.3,10,5,8,1,1,0,0,19449,7.4,20192,251,69,3036,2088,25.1,1944.9,blue,1.1,3.6,21,19,red
4519161047,9,5,6,1,0,1,0,18122,7.2,19174,233,57,2195,554,23.3,1812.2,5,9,4,0,0,0,0,15927,7.2,18620,200,54,-2195,-554,20,1592.7,blue,3,1,17,15,blue
4527552331,11,13,11,0,0,0,0,17166,6.8,17136,165,36,-1030,-319,16.5,1716.6,13,11,8,1,0,1,0,18196,6.6,17455,203,44,1030,319,20.3,1819.6,blue,1.69,1.91,40,21,red
4527674741,3,3,5,1,0,1,0,15079,6.6,15930,212,44,607,-1168,21.2,1507.9,3,3,5,1,1,0,0,14472,6.8,17098,210,38,-607,1168,21,1447.2,red,2.67,2.67,22,58,blue
4526242202,8,7,6,1,0,1,1,18766,6.8,17630,216,50,2343,-1514,21.6,1876.6,7,8,13,1,1,0,0,16423,7.2,19144,202,55,-2343,1514,20.2,1642.3,blue,2,2.5,27,42,blue
4510087493,1,8,3,0,0,0,0,13802,6.4,15735,212,40,-4177,-2986,21.2,1380.2,8,1,9,1,1,0,0,17979,7,18721,247,43,4177,2986,24.7,1797.9,red,0.5,17,44,18,blue
4513447040,4,3,3,1,1,0,0,16044,7,18612,237,62,1223,2123,23.7,1604.4,3,4,3,1,0,1,0,14821,6.6,16489,231,47,-1223,-2123,23.1,1482.1,blue,2.33,1.5,19,24,red
4521428251,2,14,3,0,0,0,0,14535,6.6,16907,195,67,-6147,-1215,19.5,1453.5,14,2,21,2,1,1,1,20682,7,18122,189,48,6147,1215,18.9,2068.2,red,0.36,17.5,14,19,red
4506659167,8,11,7,2,1,1,0,16936,6.6,16881,209,56,-865,-480,20.9,1693.6,11,8,12,0,0,0,0,17801,7,17361,188,43,865,480,18.8,1780.1,red,1.36,2.88,17,18,red
4518419610,5,7,4,0,0,0,0,16082,6.6,17246,220,38,-974,-1306,22,1608.2,7,5,9,0,0,0,0,17056,6.8,18552,228,52,974,1306,22.8,1705.6,red,1.29,3.2,97,21,blue
4526228041,10,4,11,0,0,0,0,18346,7,18224,228,36,3454,1882,22.8,1834.6,4,10,5,2,1,1,0,14892,6.6,16342,192,52,-3454,-1882,19.2,1489.2,blue,5.25,0.9,18,19,blue
4526718235,16,13,16,2,1,1,0,19437,7,18500,188,32,546,680,18.8,1943.7,13,16,10,0,0,0,0,18891,7,17820,191,52,-546,-680,19.1,1889.1,blue,2.46,1.44,15,16,red
4525334878,8,8,8,1,0,1,0,16145,7.2,19030,192,47,-1580,358,19.2,1614.5,8,8,7,1,1,0,0,17725,7.2,18672,224,62,1580,-358,22.4,1772.5,red,2,1.88,28,20,red
4525766056,6,3,7,1,1,0,0,16600,7.2,18185,238,53,1825,996,23.8,1660,3,6,4,0,0,0,0,14775,6.8,17189,228,39,-1825,-996,22.8,1477.5,blue,4.33,1.17,25,20,blue
4518530813,11,6,12,0,0,0,0,17944,7,17835,214,30,901,144,21.4,1794.4,6,11,5,0,0,0,0,17043,6.8,17691,230,53,-901,-144,23,1704.3,red,3.83,1,26,28,red
4498407529,5,7,3,0,0,0,0,14439,6.4,16062,171,35,-3435,-1632,17.1,1443.9,7,5,6,1,1,0,0,17874,6.8,17694,230,68,3435,1632,23,1787.4,blue,1.14,2.6,13,17,red
4511237975,3,7,3,0,0,0,0,15008,6.8,17439,214,56,-3688,-2808,21.4,1500.8,7,3,9,1,1,0,0,18696,7.4,20247,258,64,3688,2808,25.8,1869.6,blue,0.86,5.33,19,17,red
4522154425,2,7,4,0,0,0,0,15262,6.6,17524,232,50,-1033,-104,23.2,1526.2,7,2,10,1,1,0,0,16295,7,17628,211,59,1033,104,21.1,1629.5,red,0.86,8.5,43,62,blue
4517945518,7,3,4,1,1,0,0,16305,7,18269,217,48,1947,1867,21.7,1630.5,3,7,2,0,0,0,0,14358,6.6,16402,180,56,-1947,-1867,18,1435.8,blue,3.67,0.71,45,27,blue
4519991691,3,13,4,0,0,0,0,13908,5.4,12798,167,38,-4561,-5031,16.7,1390.8,13,3,20,1,1,0,0,18469,7,17829,187,58,4561,5031,18.7,1846.9,red,0.54,11,61,18,blue
4499304151,8,2,11,1,1,0,0,17554,7.2,19243,204,51,3255,1724,20.4,1755.4,2,8,1,0,0,0,0,14299,6.8,17519,211,46,-3255,-1724,21.1,1429.9,red,9.5,0.38,48,18,blue
4464398381,7,10,8,0,0,0,0,15543,6.4,15357,193,44,-3333,-2568,19.3,1554.3,10,7,12,0,0,0,0,18876,7,17925,234,40,3333,2568,23.4,1887.6,red,1.5,3.14,19,18,red
4498032785,8,0,12,1,1,0,0,17519,7.2,19252,222,52,3272,1914,22.2,1751.9,0,8,0,0,0,0,0,14247,6.6,17338,232,52,-3272,-1914,23.2,1424.7,blue,12.03,0,20,17,blue
4519579618,11,7,11,2,1,1,0,17788,7,17625,178,50,1655,2014,17.8,1778.8,7,11,12,0,0,0,0,16133,6.4,15611,195,22,-1655,-2014,19.5,1613.3,blue,3.14,1.73,14,19,blue
4519214985,8,7,14,0,0,0,0,17261,6.8,17685,219,44,-112,-198,21.9,1726.1,7,8,8,1,1,0,0,17373,7,17883,221,52,112,198,22.1,1737.3,blue,3.14,1.88,20,14,red
4515178661,5,4,5,1,0,1,0,16313,6.8,17999,234,45,-220,67,23.4,1631.3,4,5,5,1,1,0,0,16533,7.2,17932,232,48,220,-67,23.2,1653.3,red,2.5,1.8,22,39,blue
4513554113,0,7,0,0,0,0,0,12774,6.6,15643,199,44,-4538,-2876,19.9,1277.4,7,0,13,1,1,0,0,17312,6.8,18519,250,57,4538,2876,25,1731.2,red,0,12.65,18,26,red
4526270984,4,9,3,0,0,0,0,16003,7.2,18376,229,61,-1515,-4,22.9,1600.3,9,4,11,2,1,1,0,17518,7.2,18380,219,56,1515,4,21.9,1751.8,red,0.78,5,28,17,red
4505401172,7,7,6,1,1,0,0,15472,6.8,17032,181,54,-1851,-1875,18.1,1547.2,7,7,4,0,0,0,0,17323,7.2,18907,211,56,1851,1875,21.1,1732.3,red,1.86,1.57,20,22,blue
4515376975,4,6,5,1,0,1,0,16697,7,19148,233,69,601,-303,23.3,1669.7,6,4,9,1,1,0,0,16096,7.2,19451,230,53,-601,303,23,1609.6,blue,1.5,3.75,14,47,red
4527079464,8,7,12,1,1,0,0,17065,7,18597,229,48,878,460,22.9,1706.5,7,8,8,0,0,0,0,16187,6.8,18137,204,52,-878,-460,20.4,1618.7,blue,2.86,1.88,22,19,blue
4511287504,4,4,5,0,0,0,0,15374,7,17614,221,48,405,11,22.1,1537.4,4,4,3,0,0,0,0,14969,6.8,17603,205,56,-405,-11,20.5,1496.9,red,2.25,1.75,20,16,red
4526126419,8,8,9,2,1,1,0,17882,6.8,17930,205,64,1667,1183,20.5,1788.2,8,8,9,0,0,0,0,16215,6.8,16747,194,36,-1667,-1183,19.4,1621.5,blue,2.12,2.12,21,19,red
4526346248,5,5,5,0,0,0,1,17803,7,18782,242,52,2197,1516,24.2,1780.3,5,5,8,0,0,0,0,15606,6.8,17266,228,37,-2197,-1516,22.8,1560.6,blue,2,2.6,11,14,blue
4499619236,7,12,12,1,0,1,0,16548,6.8,17321,192,56,-2775,-2872,19.2,1654.8,12,7,10,1,1,0,0,19323,7.4,20193,220,45,2775,2872,22,1932.3,red,1.58,3.14,45,29,red
4511513768,14,5,9,1,1,0,0,19433,7,18610,213,46,4483,3132,21.3,1943.3,5,14,5,0,0,0,0,14950,6.4,15478,176,49,-4483,-3132,17.6,1495,blue,4.6,0.71,11,14,blue
4516759278,8,4,7,1,1,0,1,17790,6.8,17688,190,56,1837,458,19,1779,4,8,4,1,0,1,0,15953,6.8,17230,176,68,-1837,-458,17.6,1595.3,blue,3.75,1,26,88,blue
4516124063,4,10,7,1,1,0,0,14719,6.6,16802,200,40,-2317,-1800,20,1471.9,10,4,10,1,0,1,0,17036,7,18602,194,45,2317,1800,19.4,1703.6,red,1.1,5,20,18,blue
4515573943,7,10,3,0,0,0,0,16418,6.8,17424,199,52,-1517,-62,19.9,1641.8,10,7,14,1,1,0,0,17935,6.8,17486,211,48,1517,62,21.1,1793.5,red,1,3.43,16,24,red
4524787748,5,7,9,0,0,0,0,16566,7.2,18441,216,44,-418,-611,21.6,1656.6,7,5,4,1,1,0,0,16984,7.2,19052,208,58,418,611,20.8,1698.4,red,2,2.2,19,17,red
4519024034,9,5,13,1,0,1,2,20356,7,17899,225,49,5305,382,22.5,2035.6,5,9,10,1,1,0,0,15051,7,17517,184,49,-5305,-382,18.4,1505.1,blue,4.4,1.67,23,45,blue
4527301356,10,10,8,1,0,1,0,18524,7,18597,194,58,85,1243,19.4,1852.4,10,10,14,1,1,0,0,18439,6.6,17354,182,47,-85,-1243,18.2,1843.9,red,1.8,2.4,15,21,red
4514548275,7,3,8,2,1,1,0,17507,7.2,19641,250,64,2790,3073,25,1750.7,3,7,3,0,0,0,0,14717,6.6,16568,209,47,-2790,-3073,20.9,1471.7,blue,5,0.86,24,171,blue
4523668637,8,4,6,2,1,1,0,16774,7.2,18465,240,48,300,-568,24,1677.4,4,8,5,0,0,0,0,16474,7.4,19033,231,68,-300,568,23.1,1647.4,red,3.5,1.12,56,14,blue
4500687748,3,4,2,1,0,1,0,15527,6.8,18231,223,48,-564,-298,22.3,1552.7,4,3,7,1,1,0,0,16091,7,18529,246,67,564,298,24.6,1609.1,red,1.25,3.67,22,23,red
4510701334,2,8,1,1,0,1,0,14154,6.8,17350,206,60,-3597,-2757,20.6,1415.4,8,2,5,1,1,0,0,17751,7.2,20107,243,56,3597,2757,24.3,1775.1,red,0.38,6.5,19,20,red
4526402561,1,4,2,0,0,0,0,14783,7,18120,248,54,-2003,-1370,24.8,1478.3,4,1,6,0,0,0,0,16786,7,19490,264,64,2003,1370,26.4,1678.6,blue,0.75,10,44,37,red
4511593517,8,6,7,1,1,0,0,18070,7.2,19549,237,53,1263,590,23.7,1807,6,8,9,0,0,0,0,16807,7.4,18959,205,72,-1263,-590,20.5,1680.7,blue,2.5,1.88,26,51,red
4518610443,6,7,9,1,1,0,0,15689,6.6,17178,171,63,-808,-266,17.1,1568.9,7,6,9,0,0,0,0,16497,6.8,17444,211,52,808,266,21.1,1649.7,red,2.14,2.67,22,16,red
4507440061,9,6,10,1,1,0,0,17090,7.2,18470,216,44,989,755,21.6,1709,6,9,5,0,0,0,0,16101,6.8,17715,213,56,-989,-755,21.3,1610.1,red,3.17,1.22,45,19,blue
4526858516,1,5,0,1,1,0,0,14524,6.4,16989,234,64,-2527,-1697,23.4,1452.4,5,1,7,1,0,1,0,17051,7,18686,238,42,2527,1697,23.8,1705.1,red,0.2,12,24,21,blue
4513222024,3,2,4,1,1,0,0,15496,6.6,16404,238,42,1559,131,23.8,1549.6,2,3,3,1,0,1,0,13937,6.6,16273,197,54,-1559,-131,19.7,1393.7,red,3.5,1.67,19,16,blue
4525614725,8,4,7,0,0,0,0,17972,7.4,19649,254,37,2455,2080,25.4,1797.2,4,8,3,0,0,0,0,15517,6.8,17569,214,57,-2455,-2080,21.4,1551.7,blue,3.75,0.88,16,14,blue
4526220423,4,8,5,0,0,0,0,15124,6.6,16323,185,50,-2588,-1355,18.5,1512.4,8,4,9,0,0,0,0,17712,6.8,17678,217,43,2588,1355,21.7,1771.2,red,1.12,4.25,43,22,red
4523424930,4,4,7,0,0,0,0,16784,7.2,18335,267,47,992,-861,26.7,1678.4,4,4,5,1,1,0,0,15792,7.2,19196,224,80,-992,861,22.4,1579.2,blue,2.75,2.25,21,16,blue
4525971352,4,13,3,1,0,1,0,14157,6,15002,158,44,-3948,-4655,15.8,1415.7,13,4,5,1,1,0,0,18105,7.4,19657,243,68,3948,4655,24.3,1810.5,red,0.54,4.5,14,16,red
4527157118,12,5,10,1,1,0,0,19296,7.4,18995,222,56,3611,2136,22.2,1929.6,5,12,7,0,0,0,0,15685,6.8,16859,180,46,-3611,-2136,18,1568.5,blue,4.4,1,16,16,red
4502220585,15,4,23,1,1,0,1,22134,7.6,20809,234,59,8151,5114,23.4,2213.4,4,15,6,0,0,0,0,13983,6.2,15695,176,34,-8151,-5114,17.6,1398.3,blue,9.5,0.67,23,17,blue
4521217676,13,9,12,0,0,0,0,18734,7.2,19093,187,55,2355,884,18.7,1873.4,9,13,8,1,1,0,0,16379,6.8,18209,200,56,-2355,-884,20,1637.9,blue,2.78,1.31,19,15,red
4523654573,7,4,6,1,1,0,0,17914,7,18528,240,62,3410,2524,24,1791.4,4,7,7,0,0,0,0,14504,6.4,16004,187,48,-3410,-2524,18.7,1450.4,blue,3.25,1.57,15,39,blue
4525939080,10,7,12,0,0,0,0,17892,7,18432,197,52,1017,547,19.7,1789.2,7,10,7,1,1,0,0,16875,7,17885,201,48,-1017,-547,20.1,1687.5,blue,3.14,1.4,18,17,red
4497564028,13,2,13,1,0,1,0,19969,7.2,19752,255,55,6763,6488,25.5,1996.9,2,13,2,0,0,0,0,13206,5.8,13264,192,32,-6763,-6488,19.2,1320.6,blue,13,0.31,26,17,red
4508363234,4,8,4,1,1,0,0,16250,6.8,17320,236,49,-1497,-1252,23.6,1625,8,4,13,0,0,0,0,17747,7.2,18572,225,64,1497,1252,22.5,1774.7,red,1,5.25,17,20,blue
4514798405,5,6,7,1,1,0,0,15850,6.2,15600,210,51,29,-1552,21,1585,6,5,8,0,0,0,0,15821,6.6,17152,222,31,-29,1552,22.2,1582.1,red,2,2.8,20,69,blue
4513522671,6,4,4,1,1,0,0,16505,6.8,18233,245,50,1110,-225,24.5,1650.5,4,6,3,0,0,0,0,15395,7.4,18458,212,58,-1110,225,21.2,1539.5,red,2.5,1.17,18,18,red
4524354626,9,3,16,1,0,1,0,18741,7.2,19102,243,44,3447,1976,24.3,1874.1,3,9,6,1,1,0,0,15294,6.8,17126,210,68,-3447,-1976,21,1529.4,red,8.33,1,23,18,blue
4522199667,8,10,10,0,0,0,0,17051,7,17619,208,42,-530,485,20.8,1705.1,10,8,9,1,1,0,0,17581,6.8,17134,191,40,530,-485,19.1,1758.1,red,1.8,2.38,10,16,red
4523011787,10,5,12,1,1,0,0,18936,7.2,19738,253,51,4798,5096,25.3,1893.6,5,10,5,0,0,0,0,14138,6,14642,176,36,-4798,-5096,17.6,1413.8,blue,4.4,1,16,19,blue
4524303948,7,6,7,0,0,0,0,15551,6.4,15956,176,42,-259,-576,17.6,1555.1,6,7,6,0,0,0,0,15810,6.6,16532,173,49,259,576,17.3,1581,red,2.33,1.71,40,16,red
4493672467,6,8,4,1,1,0,0,16455,7.2,18317,217,56,-411,374,21.7,1645.5,8,6,14,0,0,0,0,16866,7.2,17943,215,49,411,-374,21.5,1686.6,red,1.25,3.67,19,26,blue
4518444031,10,8,12,1,1,0,0,17357,7,18388,191,59,-310,570,19.1,1735.7,8,10,9,1,0,1,0,17667,7.2,17818,194,56,310,-570,19.4,1766.7,red,2.75,1.7,21,29,blue
4525839513,6,4,5,1,0,1,0,16293,7,18893,229,40,929,1008,22.9,1629.3,4,6,5,0,0,0,0,15364,7,17885,227,54,-929,-1008,22.7,1536.4,red,2.75,1.5,16,17,red
4506840559,6,4,5,1,1,0,0,16541,6.8,17961,211,51,1568,2039,21.1,1654.1,4,6,5,0,0,0,0,14973,6.6,15922,208,46,-1568,-2039,20.8,1497.3,blue,2.75,1.5,33,23,blue
4506029012,9,4,11,0,0,0,1,19477,7.2,18390,224,41,5099,2567,22.4,1947.7,4,9,3,1,1,0,0,14378,6.2,15823,176,49,-5099,-2567,17.6,1437.8,blue,5,0.78,21,17,blue
4520540286,4,5,5,1,1,0,0,16331,7.2,18927,246,60,-462,542,24.6,1633.1,5,4,8,0,0,0,0,16793,6.8,18385,273,49,462,-542,27.3,1679.3,blue,1.8,3.25,25,23,red
4510908073,7,12,4,0,0,0,0,16115,7,17647,193,52,-3032,-1859,19.3,1611.5,12,7,7,0,0,0,0,19147,7.2,19506,243,47,3032,1859,24.3,1914.7,red,0.92,2.71,20,18,red
4500852521,6,5,6,0,0,0,0,16575,7,18673,233,50,-134,-146,23.3,1657.5,5,6,6,1,1,0,0,16709,7.2,18819,242,68,134,146,24.2,1670.9,red,2.4,1.83,37,19,blue
4502456299,5,5,5,0,0,0,0,15161,6.6,17135,174,40,-106,-827,17.4,1516.1,5,5,5,1,1,0,0,15267,6.8,17962,207,51,106,827,20.7,1526.7,red,2,2,81,20,blue
4527675281,3,2,6,2,1,1,0,15097,7,17461,226,40,-971,-1447,22.6,1509.7,2,3,2,0,0,0,0,16068,7.2,18908,253,57,971,1447,25.3,1606.8,red,4.5,1.33,20,40,red
4518730681,7,6,8,2,1,1,0,16514,6.8,17281,216,50,-594,-1344,21.6,1651.4,6,7,11,0,0,0,0,17108,7,18625,242,55,594,1344,24.2,1710.8,red,2.5,2.43,14,11,red
4497864725,11,2,16,0,0,0,0,19770,7.2,19116,232,48,5120,3137,23.2,1977,2,11,2,2,1,1,0,14650,6.4,15979,191,64,-5120,-3137,19.1,1465,blue,13.5,0.36,27,19,blue
4525924001,9,4,8,1,1,0,0,17915,7,19615,225,56,1963,781,22.5,1791.5,4,9,1,0,0,0,0,15952,7.2,18834,258,56,-1963,-781,25.8,1595.2,blue,4.25,0.56,28,40,blue
4513512773,5,5,4,0,0,0,0,16450,7.2,18742,222,72,296,1046,22.2,1645,5,5,8,2,1,1,0,16154,7,17696,220,60,-296,-1046,22,1615.4,blue,1.8,2.6,17,16,red
4527613932,6,3,5,0,0,0,0,16007,6.8,17907,221,40,1201,695,22.1,1600.7,3,6,3,1,1,0,0,14806,6.8,17212,209,40,-1201,-695,20.9,1480.6,red,3.67,1,14,12,blue
4526408349,4,5,4,2,1,1,0,16552,7.2,18731,227,57,334,145,22.7,1655.2,5,4,9,0,0,0,0,16218,6.8,18586,225,56,-334,-145,22.5,1621.8,red,1.6,3.5,21,19,blue
4517559119,5,5,4,0,0,0,0,15750,6.8,16898,216,49,259,473,21.6,1575,5,5,6,0,0,0,0,15491,6.6,16425,200,43,-259,-473,20,1549.1,red,1.8,2.2,19,42,red
4527363053,7,4,6,2,1,1,0,17162,7.6,20178,249,44,3035,3792,24.9,1716.2,4,7,3,0,0,0,0,14127,6.6,16386,170,47,-3035,-3792,17,1412.7,blue,3.25,1,39,21,blue
4518856826,10,13,9,2,1,1,0,17743,7,17923,194,50,-1223,-1046,19.4,1774.3,13,10,10,0,0,0,0,18966,7.2,18969,198,61,1223,1046,19.8,1896.6,red,1.46,2.3,53,17,red
4527339142,5,4,5,1,1,0,0,15527,6.4,16705,185,44,625,-873,18.5,1552.7,4,5,2,0,0,0,0,14902,7,17578,226,44,-625,873,22.6,1490.2,red,2.5,1.2,49,16,blue
4510871194,4,9,4,0,0,0,0,15585,7.2,18357,216,55,-2017,-659,21.6,1558.5,9,4,12,0,0,0,0,17602,7.2,19016,220,49,2017,659,22,1760.2,red,0.89,5.25,41,15,red
4525983895,7,2,5,1,0,1,0,17026,6.8,18847,254,40,2439,2360,25.4,1702.6,2,7,2,0,0,0,0,14587,6.6,16487,230,41,-2439,-2360,23,1458.7,blue,6,0.57,19,18,red
4508360116,6,5,7,1,1,0,0,16149,7,18253,217,44,-549,-323,21.7,1614.9,5,6,5,0,0,0,0,16698,6.8,18576,233,59,549,323,23.3,1669.8,blue,2.6,1.67,40,18,blue
4511838244,1,6,2,0,0,0,0,13728,6.8,17193,204,48,-3675,-2454,20.4,1372.8,6,1,5,0,0,0,0,17403,7.2,19647,240,56,3675,2454,24,1740.3,red,0.5,11,13,84,red
4515607398,8,3,7,1,1,0,0,18003,7.4,20207,248,77,3034,1983,24.8,1800.3,3,8,2,0,0,0,0,14969,7,18224,211,52,-3034,-1983,21.1,1496.9,blue,5,0.62,21,19,red
4508344730,7,6,10,1,1,0,0,16497,7,17789,201,57,787,-575,20.1,1649.7,6,7,2,0,0,0,0,15710,7,18364,232,42,-787,575,23.2,1571,blue,2.83,1.14,17,20,blue
4519023406,9,6,10,0,0,0,0,17666,6.4,17054,195,50,846,-28,19.5,1766.6,6,9,8,0,0,0,0,16820,6.8,17082,247,40,-846,28,24.7,1682,red,3.17,1.56,29,39,red
4524668512,6,9,8,1,0,1,0,16711,7,17375,217,52,-927,-200,21.7,1671.1,9,6,10,1,1,0,0,17638,6.8,17575,229,46,927,200,22.9,1763.8,blue,1.56,3.17,24,21,blue
4526039823,5,6,5,1,1,0,0,15414,6.8,17454,208,48,-599,-288,20.8,1541.4,6,5,5,0,0,0,0,16013,6.8,17742,218,50,599,288,21.8,1601.3,red,1.67,2.2,18,17,blue
4518118061,13,10,17,0,0,0,0,19372,7,18078,201,47,1734,1173,20.1,1937.2,10,13,17,1,1,0,0,17638,6.6,16905,195,40,-1734,-1173,19.5,1763.8,red,3,2.08,21,17,red
4510115879,4,12,6,0,0,0,0,15207,6.6,16955,213,44,-5324,-2914,21.3,1520.7,12,4,12,2,1,1,1,20531,7.2,19869,205,64,5324,2914,20.5,2053.1,red,0.83,6,20,17,red
4518384119,7,15,11,0,0,0,0,16378,6.4,16097,189,48,-4552,-4208,18.9,1637.8,15,7,20,1,1,0,0,20930,7.4,20305,234,56,4552,4208,23.4,2093,blue,1.2,5,20,21,red
4508242433,7,2,9,1,1,0,0,16683,7.2,19168,223,60,1828,2134,22.3,1668.3,2,7,4,0,0,0,0,14855,6.8,17034,224,44,-1828,-2134,22.4,1485.5,blue,8,0.86,87,18,blue
4508781088,7,7,7,1,0,1,0,17215,7,18989,256,47,324,2076,25.6,1721.5,7,7,13,0,0,0,0,16891,6.6,16913,234,42,-324,-2076,23.4,1689.1,blue,2,2.86,18,24,red
4508196415,7,9,7,0,0,0,0,17177,6.8,18796,228,68,-1885,-210,22.8,1717.7,9,7,10,1,1,0,0,19062,7.2,19006,236,56,1885,210,23.6,1906.2,red,1.56,2.71,21,23,red
4520393840,9,7,13,1,1,0,0,17682,6.6,17214,195,51,724,241,19.5,1768.2,7,9,9,0,0,0,0,16958,6.6,16973,229,48,-724,-241,22.9,1695.8,red,3.14,1.78,21,43,blue
4520307330,10,6,10,0,0,0,0,16744,7,19007,183,42,-645,426,18.3,1674.4,6,10,3,0,0,0,0,17389,7,18581,224,52,645,-426,22.4,1738.9,red,3.33,0.9,14,14,red
4527034667,8,5,10,1,0,1,0,17812,7,19113,234,41,2554,2046,23.4,1781.2,5,8,4,1,1,0,0,15258,6.6,17067,212,35,-2554,-2046,21.2,1525.8,red,3.6,1.12,19,16,red
4526945027,1,6,1,0,0,0,0,14971,6.6,17477,255,55,-1390,-446,25.5,1497.1,6,1,4,2,1,1,0,16361,6.8,17923,226,52,1390,446,22.6,1636.1,red,0.33,10,18,18,red
4527398202,7,9,13,1,1,0,0,17432,7,17080,200,52,-399,-1348,20,1743.2,9,7,11,0,0,0,0,17831,7,18428,203,48,399,1348,20.3,1783.1,red,2.22,2.86,68,33,red
4527693683,3,5,3,1,0,1,0,15341,6.8,18065,215,59,-85,1665,21.5,1534.1,5,3,9,1,1,0,0,15426,6.6,16400,202,40,85,-1665,20.2,1542.6,blue,1.2,4.67,13,19,red
4518352378,6,1,6,0,0,0,0,17357,7.2,19151,234,51,4111,2823,23.4,1735.7,1,6,0,1,1,0,0,13246,6.6,16328,208,53,-4111,-2823,20.8,1324.6,blue,12,0.17,20,23,blue
4502759041,2,4,2,0,0,0,0,14747,6.8,18401,245,47,-1356,-501,24.5,1474.7,4,2,3,1,1,0,0,16103,7,18902,261,48,1356,501,26.1,1610.3,red,1,3.5,23,19,red
4525324183,6,5,9,1,1,0,0,15368,6.4,16039,169,55,71,-679,16.9,1536.8,5,6,2,0,0,0,0,15297,6.4,16718,198,51,-71,679,19.8,1529.7,red,3,1.17,18,18,red
4510783393,5,2,5,1,1,0,0,15931,7,17840,231,49,393,111,23.1,1593.1,2,5,3,0,0,0,0,15538,6.8,17729,255,51,-393,-111,25.5,1553.8,blue,5,1,20,18,blue
4508869130,8,8,5,0,0,0,0,17188,6.6,17474,229,35,809,645,22.9,1718.8,8,8,10,1,0,1,0,16379,6.6,16829,191,47,-809,-645,19.1,1637.9,red,1.62,2.25,16,12,red
4526830750,7,6,12,1,1,0,0,17737,7,18873,220,48,1126,549,22,1773.7,6,7,10,0,0,0,0,16611,7.2,18324,228,55,-1126,-549,22.8,1661.1,blue,3.17,2.29,22,51,red
4513659077,4,4,3,1,1,0,0,15024,7,17340,217,49,-1243,-1261,21.7,1502.4,4,4,6,1,0,1,0,16267,7,18601,221,62,1243,1261,22.1,1626.7,blue,1.75,2.5,19,18,red
4525999978,12,5,11,1,0,1,0,19659,7.2,19474,241,48,3745,1627,24.1,1965.9,5,12,6,0,0,0,0,15914,7,17847,230,53,-3745,-1627,23,1591.4,blue,4.6,0.92,30,30,red
4513108171,8,7,8,1,0,1,0,17562,6.8,18086,203,49,1269,739,20.3,1756.2,7,8,9,1,1,0,0,16293,6.8,17347,199,48,-1269,-739,19.9,1629.3,red,2.29,2,15,16,blue
4512127012,3,8,5,1,1,0,0,14527,6.4,16646,221,44,-4267,-2746,22.1,1452.7,8,3,8,1,0,1,1,18794,7.2,19392,238,68,4267,2746,23.8,1879.4,red,1,5.33,12,17,red
4525780504,3,2,6,0,0,0,0,14509,6.8,16800,191,52,-1749,-1247,19.1,1450.9,2,3,3,2,1,1,0,16258,6.8,18047,251,65,1749,1247,25.1,1625.8,red,4.5,1.67,15,19,red
4527089557,9,2,8,1,0,1,0,18650,7.4,20053,234,55,4128,3128,23.4,1865,2,9,2,0,0,0,0,14522,6.6,16925,243,45,-4128,-3128,24.3,1452.2,blue,8.5,0.44,18,19,blue
4524112117,7,4,8,0,0,0,0,15818,6.6,16786,205,36,656,-439,20.5,1581.8,4,7,3,0,0,0,0,15162,6.8,17225,200,53,-656,439,20,1516.2,blue,3.75,1,41,22,blue
4526621303,5,5,4,1,0,1,0,15550,6.8,17793,218,43,-1324,-615,21.8,1555,5,5,7,1,1,0,0,16874,6.8,18408,257,64,1324,615,25.7,1687.4,red,1.8,2.4,20,20,red
4519708625,7,5,9,0,0,0,0,16655,7.2,18948,208,50,791,1064,20.8,1665.5,5,7,6,2,1,1,0,15864,6.8,17884,212,58,-791,-1064,21.2,1586.4,red,3.2,1.57,17,35,blue
4515744642,2,6,2,0,0,0,0,14790,6.8,18612,223,71,-3075,-244,22.3,1479,6,2,7,1,1,0,0,17865,7,18856,266,47,3075,244,26.6,1786.5,blue,0.67,6.5,23,16,red
4527275742,7,3,10,0,0,0,0,17755,7.2,19403,254,48,2864,3193,25.4,1775.5,3,7,3,0,0,0,0,14891,6.4,16210,221,41,-2864,-3193,22.1,1489.1,blue,5.67,0.86,24,17,blue
4523315311,8,5,7,2,1,1,1,17973,7,17436,223,44,2038,1029,22.3,1797.3,5,8,6,0,0,0,0,15935,6.4,16407,207,44,-2038,-1029,20.7,1593.5,blue,3,1.38,17,13,blue
4527078434,5,6,10,1,0,1,0,14566,6.4,16031,182,37,-2061,-2046,18.2,1456.6,6,5,7,1,1,0,0,16627,7,18077,200,50,2061,2046,20,1662.7,red,2.5,2.6,19,11,blue
4526755207,5,4,8,1,1,0,0,15983,6.8,17134,219,50,544,-289,21.9,1598.3,4,5,6,0,0,0,0,15439,6.8,17423,218,49,-544,289,21.8,1543.9,blue,3.25,2,21,18,blue
4508028772,6,5,4,1,1,0,0,15655,6.8,17386,203,53,-693,-919,20.3,1565.5,5,6,5,0,0,0,0,16348,7,18305,234,56,693,919,23.4,1634.8,red,2,1.67,15,15,red
4521868981,8,3,7,0,0,0,0,17840,6.8,18356,233,40,3047,1616,23.3,1784,3,8,3,1,1,0,0,14793,6.6,16740,229,54,-3047,-1616,22.9,1479.3,blue,5,0.75,19,25,blue
4518559997,4,5,3,2,1,1,0,16018,7.2,18223,215,68,-599,192,21.5,1601.8,5,4,10,0,0,0,0,16617,6.8,18031,242,48,599,-192,24.2,1661.7,red,1.4,3.75,17,22,blue
4527592753,1,6,1,0,0,0,0,13719,6.4,15044,213,31,-3247,-3783,21.3,1371.9,6,1,5,2,1,1,0,16966,7.2,18827,237,58,3247,3783,23.7,1696.6,blue,0.33,11,20,16,red
4512245409,9,6,9,0,0,0,0,17633,7.2,18808,206,54,1703,1809,20.6,1763.3,6,9,7,0,0,0,0,15930,6.8,16999,210,40,-1703,-1809,21,1593,blue,3,1.44,15,17,red
4520348374,6,6,12,0,0,0,1,17552,6.8,16611,201,45,1189,-821,20.1,1755.2,6,6,5,1,0,1,0,16363,6.8,17432,191,55,-1189,821,19.1,1636.3,blue,3,1.83,27,102,blue
4525626729,16,7,14,1,1,0,0,20236,6.8,18074,203,40,3424,1464,20.3,2023.6,7,16,6,0,0,0,0,16812,6.6,16610,169,48,-3424,-1464,16.9,1681.2,blue,4.29,0.81,19,16,blue
4517721680,2,7,4,1,1,0,0,14558,6.8,17024,206,63,-2564,-1959,20.6,1455.8,7,2,8,1,0,1,0,17122,7.2,18983,222,48,2564,1959,22.2,1712.2,blue,0.86,7.5,19,21,red
4526401078,4,3,3,1,1,0,0,15080,7,18378,208,56,-401,-439,20.8,1508,3,4,3,0,0,0,0,15481,7.4,18817,232,53,401,439,23.2,1548.1,red,2.33,1.5,12,38,red
4510990676,10,2,12,1,0,1,0,19621,7.6,19733,209,56,6703,5604,20.9,1962.1,2,10,2,0,0,0,0,12918,5.8,14129,140,58,-6703,-5604,14,1291.8,blue,11,0.4,21,21,blue
4502473645,3,5,3,0,0,0,0,15970,7,18425,245,59,24,-286,24.5,1597,5,3,1,0,0,0,0,15946,6.8,18711,249,53,-24,286,24.9,1594.6,blue,1.2,2,25,19,red
4512380043,4,5,2,1,1,0,0,15581,7,18725,239,58,-460,935,23.9,1558.1,5,4,4,1,0,1,0,16041,7,17790,223,46,460,-935,22.3,1604.1,red,1.2,2.25,18,16,red
4524224668,13,3,14,0,0,0,1,21278,7.4,20007,253,38,6968,4379,25.3,2127.8,3,13,2,1,1,0,0,14310,6.6,15628,185,55,-6968,-4379,18.5,1431,blue,9,0.38,23,14,blue
4508478137,6,3,8,1,1,0,0,17352,6.8,18631,257,63,1963,804,25.7,1735.2,3,6,7,0,0,0,0,15389,6.8,17827,210,52,-1963,-804,21,1538.9,blue,4.67,1.67,19,47,blue
4526837862,4,7,6,1,0,1,0,15289,7,16623,210,52,-1041,-1114,21,1528.9,7,4,5,1,1,0,0,16330,6.8,17737,196,52,1041,1114,19.6,1633,blue,1.43,3,16,11,blue
4515418591,7,2,6,1,0,1,1,17819,7.2,19319,236,44,2979,1183,23.6,1781.9,2,7,1,1,1,0,0,14840,7,18136,223,72,-2979,-1183,22.3,1484,blue,6.5,0.43,19,19,blue
4517529654,7,3,9,1,0,1,0,16723,7,17883,233,34,1489,604,23.3,1672.3,3,7,3,0,0,0,0,15234,7,17279,228,65,-1489,-604,22.8,1523.4,blue,5.33,0.86,37,46,blue
4510180756,8,4,11,1,1,0,0,17857,7.2,19272,239,51,2374,1332,23.9,1785.7,4,8,3,0,0,0,0,15483,7,17940,239,52,-2374,-1332,23.9,1548.3,red,4.75,0.88,38,19,blue
4525584970,7,5,10,1,0,1,0,16940,6.8,16731,232,40,1523,-576,23.2,1694,5,7,6,1,1,0,0,15417,6.8,17307,185,58,-1523,576,18.5,1541.7,red,3.4,1.57,17,17,blue
4512105521,9,6,9,1,1,0,0,17059,7,18302,214,52,977,1247,21.4,1705.9,6,9,5,0,0,0,0,16082,6.6,17055,203,52,-977,-1247,20.3,1608.2,red,3,1.22,20,17,red
4517748188,4,6,5,0,0,0,0,15593,6.6,17750,225,46,-416,-1639,22.5,1559.3,6,4,6,1,1,0,0,16009,7.2,19389,221,51,416,1639,22.1,1600.9,red,1.5,3,79,57,blue
4523595695,6,5,12,0,0,0,0,17074,7.2,18861,242,64,519,1436,24.2,1707.4,5,6,7,1,1,0,0,16555,6.6,17425,232,52,-519,-1436,23.2,1655.5,blue,3.6,2,27,65,red
4525345831,7,6,4,0,0,0,0,16466,6.8,16798,185,52,59,-305,18.5,1646.6,6,7,10,2,1,1,0,16407,7,17103,210,53,-59,305,21,1640.7,blue,1.83,2.29,17,16,blue
4518273376,12,3,11,2,1,1,0,19082,7.2,18970,226,52,4305,2244,22.6,1908.2,3,12,2,0,0,0,0,14777,6.6,16726,216,44,-4305,-2244,21.6,1477.7,blue,7.67,0.42,16,39,red
4525792479,6,6,8,1,1,0,0,16961,6.8,17778,238,48,-33,-998,23.8,1696.1,6,6,4,1,0,1,0,16994,7,18776,213,58,33,998,21.3,1699.4,blue,2.33,1.67,43,28,blue
4511051956,5,5,4,0,0,0,0,16864,7,18195,247,51,874,-554,24.7,1686.4,5,5,5,2,1,1,0,15990,7.2,18749,232,56,-874,554,23.2,1599,red,1.8,2,21,19,blue
4502376872,5,9,6,0,0,0,0,14988,6.6,16513,200,40,-2824,-2021,20,1498.8,9,5,10,0,0,0,0,17812,6.8,18534,222,56,2824,2021,22.2,1781.2,red,1.22,3.8,19,20,red
4519132891,13,10,13,0,0,0,0,18886,7.2,18539,188,56,845,1049,18.8,1888.6,10,13,7,0,0,0,0,18041,7,17490,214,39,-845,-1049,21.4,1804.1,blue,2.6,1.31,41,14,red
4518083698,2,6,6,0,0,0,0,15223,6.8,17348,213,64,-713,-897,21.3,1522.3,6,2,3,0,0,0,0,15936,6.8,18245,228,44,713,897,22.8,1593.6,blue,1.33,4.5,18,14,blue
4523827809,5,3,6,2,1,1,0,15947,7,18280,219,64,402,890,21.9,1594.7,3,5,3,0,0,0,0,15545,7,17390,237,55,-402,-890,23.7,1554.5,blue,3.67,1.2,30,19,red
4509664534,4,5,1,0,0,0,0,14473,6.8,17358,185,53,-2485,-1570,18.5,1447.3,5,4,2,1,1,0,0,16958,7.2,18928,263,54,2485,1570,26.3,1695.8,red,1,1.75,17,33,blue
4516781152,7,4,5,1,1,0,0,17214,7,19173,235,48,1746,2273,23.5,1721.4,4,7,6,0,0,0,0,15468,6.8,16900,205,56,-1746,-2273,20.5,1546.8,red,3,1.43,16,18,blue
4498270130,3,9,6,0,0,0,0,14515,6.6,16542,175,64,-4152,-1948,17.5,1451.5,9,3,14,1,1,0,0,18667,7,18490,253,40,4152,1948,25.3,1866.7,red,1,7.67,40,27,red
4526135589,7,6,8,1,1,0,0,15463,6.8,16652,161,72,-1846,-1362,16.1,1546.3,6,7,3,1,0,1,1,17309,7,18014,194,48,1846,1362,19.4,1730.9,red,2.5,1.29,24,47,red
4517856513,4,10,7,0,0,0,0,15032,6.6,16564,203,44,-4481,-1530,20.3,1503.2,10,4,19,1,1,0,1,19513,7,18094,245,45,4481,1530,24.5,1951.3,red,1.1,7.25,26,30,red
4511313757,4,13,4,0,0,0,0,14979,6.6,16961,194,46,-4686,-2937,19.4,1497.9,13,4,13,1,1,0,0,19665,7.4,19898,208,47,4686,2937,20.8,1966.5,red,0.62,6.5,13,15,red
4521333183,1,2,2,0,0,0,0,13863,6.8,17182,219,40,-1336,-1242,21.9,1386.3,2,1,1,1,1,0,0,15199,7,18424,226,75,1336,1242,22.6,1519.9,red,1.5,3,18,19,red
4526400961,4,1,7,0,0,0,0,15736,7.2,18522,216,56,2112,2566,21.6,1573.6,1,4,2,1,1,0,0,13624,6.6,15956,197,60,-2112,-2566,19.7,1362.4,blue,11,0.75,84,19,blue
4523291821,5,6,5,0,0,0,0,15978,6.8,17338,225,50,455,-1138,22.5,1597.8,6,5,7,0,0,0,0,15523,7,18476,191,40,-455,1138,19.1,1552.3,red,1.67,2.6,12,17,blue
4503341875,9,7,10,0,0,0,0,18400,7.2,18909,221,60,2746,1975,22.1,1840,7,9,10,1,1,0,0,15654,6.6,16934,164,52,-2746,-1975,16.4,1565.4,red,2.71,1.89,24,40,blue
4498216793,6,10,6,2,1,1,0,15573,6.8,18078,194,43,-4673,-1225,19.4,1557.3,10,6,10,0,0,0,1,20246,7.2,19303,246,50,4673,1225,24.6,2024.6,red,1.2,3.33,44,21,red
4515606448,4,6,7,1,1,0,0,15520,7,17369,207,59,-1949,-1983,20.7,1552,6,4,10,1,0,1,0,17469,7.2,19352,230,56,1949,1983,23,1746.9,red,1.83,4,17,39,red
4519509800,2,9,3,0,0,0,0,13367,6.4,15834,157,52,-4081,-1994,15.7,1336.7,9,2,11,1,1,0,0,17448,7.2,17828,216,44,4081,1994,21.6,1744.8,red,0.56,10,19,24,blue
4497961157,10,5,7,1,1,0,0,17687,6.8,18625,213,56,2159,2100,21.3,1768.7,5,10,5,0,0,0,0,15528,6.8,16525,180,52,-2159,-2100,18,1552.8,blue,3.4,1,16,17,red
4526622617,11,8,8,0,0,0,0,17663,6.6,16879,193,30,16,-639,19.3,1766.3,8,11,6,2,1,1,0,17647,7,17518,227,42,-16,639,22.7,1764.7,blue,2.38,1.27,22,19,red
4516123814,6,10,5,0,0,0,0,16108,6.4,16262,211,42,-1701,-771,21.1,1610.8,10,6,16,0,0,0,0,17809,6.8,17033,190,52,1701,771,19,1780.9,red,1.1,4.33,22,18,red
4525978244,3,3,5,1,1,0,0,14697,6.6,16968,229,44,-780,-1068,22.9,1469.7,3,3,3,1,0,1,0,15477,7,18036,236,59,780,1068,23.6,1547.7,blue,2.67,2,16,17,red
4508688616,5,9,4,0,0,0,0,15106,7,17323,200,36,-2793,83,20,1510.6,9,5,12,1,0,1,0,17899,6.8,17240,215,35,2793,-83,21.5,1789.9,red,1,4.2,17,24,red
4520868941,7,3,12,0,0,0,0,16175,6.6,16320,202,45,1426,524,20.2,1617.5,3,7,2,0,0,0,0,14749,6.6,15796,204,53,-1426,-524,20.4,1474.9,red,6.33,0.71,18,13,blue
4521879748,10,8,10,1,1,0,0,18787,7,18529,231,48,1876,1668,23.1,1878.7,8,10,10,0,0,0,0,16911,6.8,16861,203,28,-1876,-1668,20.3,1691.1,blue,2.5,1.8,14,59,blue
4509868261,9,3,10,0,0,0,0,17460,7,17575,217,40,2338,1009,21.7,1746,3,9,3,1,0,1,0,15122,6.6,16566,192,52,-2338,-1009,19.2,1512.2,blue,6.33,0.67,15,15,red
4514563182,9,5,5,1,0,1,0,16835,6.8,17752,200,48,606,533,20,1683.5,5,9,6,0,0,0,0,16229,6.8,17219,211,55,-606,-533,21.1,1622.9,red,2.8,1.22,19,16,red
4525869315,8,10,11,2,1,1,0,17351,6.6,16649,204,44,-780,63,20.4,1735.1,10,8,14,0,0,0,0,18131,6.8,16586,193,52,780,-63,19.3,1813.1,red,1.9,3,19,30,red
4512531903,6,2,4,0,0,0,0,16412,7,17900,235,47,1211,751,23.5,1641.2,2,6,2,1,1,0,0,15201,6.6,17149,249,52,-1211,-751,24.9,1520.1,blue,5,0.67,19,20,blue
4526023571,5,4,8,1,0,1,0,15040,6.8,18066,197,44,-1964,-963,19.7,1504,4,5,4,0,0,0,0,17004,7.2,19029,260,72,1964,963,26,1700.4,blue,3.25,1.6,17,12,red
4525350807,5,4,3,0,0,0,0,16293,6.8,17793,218,55,1006,1171,21.8,1629.3,4,5,5,1,1,0,0,15287,6.6,16622,207,52,-1006,-1171,20.7,1528.7,red,2,1.8,17,19,red
4509704397,6,4,5,1,1,0,0,16249,6.8,18007,221,40,444,1056,22.1,1624.9,4,6,4,1,0,1,0,15805,7,16951,213,51,-444,-1056,21.3,1580.5,red,2.75,1.33,22,26,red
4516719935,2,4,2,1,1,0,0,15312,7,18210,250,61,-961,-725,25,1531.2,4,2,3,0,0,0,0,16273,7.2,18935,250,56,961,725,25,1627.3,blue,1,3.5,15,20,red
4519804931,6,3,6,1,1,0,0,16432,7,18560,240,44,1804,1547,24,1643.2,3,6,3,0,0,0,0,14628,6.8,17013,200,43,-1804,-1547,20,1462.8,blue,4,1,17,35,blue
4521903863,8,3,10,2,1,1,0,18122,7.4,20449,247,68,2696,3081,24.7,1812.2,3,8,3,0,0,0,0,15426,6.8,17368,222,54,-2696,-3081,22.2,1542.6,blue,6,0.75,43,26,blue
4526903183,6,9,7,0,0,0,0,16223,6.8,17056,196,36,-605,-782,19.6,1622.3,9,6,7,1,1,0,0,16828,7,17838,203,56,605,782,20.3,1682.8,red,1.44,2.67,87,15,red
4515683822,6,8,7,1,1,0,0,16326,6.8,17923,236,40,-1114,-417,23.6,1632.6,8,6,12,0,0,0,0,17440,7,18340,241,47,1114,417,24.1,1744,red,1.62,3.33,15,35,red
4508915149,0,5,0,0,0,0,0,13561,6.6,16518,220,51,-1958,-1775,22,1356.1,5,0,4,1,1,0,0,15519,7,18293,223,37,1958,1775,22.3,1551.9,red,0,12.65,15,18,red
4420933848,5,6,3,0,0,0,0,15897,6.8,18131,219,53,-453,659,21.9,1589.7,6,5,10,1,1,0,0,16350,7,17472,188,48,453,-659,18.8,1635,blue,1.33,3.2,14,50,red
4516833244,6,8,6,1,0,1,0,16005,6.6,17346,188,58,-1205,-1042,18.8,1600.5,8,6,6,1,1,0,0,17210,7.2,18388,232,34,1205,1042,23.2,1721,red,1.5,2.33,17,21,red
4525957612,5,6,6,1,1,0,0,15907,6.6,16474,211,67,-393,-2719,21.1,1590.7,6,5,9,0,0,0,0,16300,7,19193,211,56,393,2719,21.1,1630,red,1.83,3,17,24,blue
4527528419,9,2,12,0,0,0,0,17440,7,18112,213,36,3422,1091,21.3,1744,2,9,1,0,0,0,0,14018,6.8,17021,216,56,-3422,-1091,21.6,1401.8,red,10.5,0.33,19,45,blue
4510187946,1,5,2,0,0,0,0,14257,6.6,17053,230,44,-3234,-2889,23,1425.7,5,1,9,0,0,0,0,17491,7.2,19942,247,68,3234,2889,24.7,1749.1,red,0.6,14,15,20,red
4516722910,7,10,11,0,0,0,0,15723,6.4,15809,159,44,-4307,-2260,15.9,1572.3,10,7,13,1,0,1,1,20030,7,18069,253,40,4307,2260,25.3,2003,red,1.8,3.29,16,17,red
4515957232,2,10,1,0,0,0,0,14817,6.4,16953,212,60,-3264,-1507,21.2,1481.7,10,2,11,1,1,0,0,18081,7,18460,211,40,3264,1507,21.1,1808.1,red,0.3,10.5,54,18,red
4508218503,0,1,0,0,0,0,0,14713,7,17547,261,53,-388,-1004,26.1,1471.3,1,0,1,1,1,0,0,15101,7,18551,264,56,388,1004,26.4,1510.1,red,0,12.65,15,14,red
4523938841,6,6,11,0,0,0,0,16319,6.6,17353,214,39,52,554,21.4,1631.9,6,6,6,1,0,1,0,16267,6.6,16799,235,36,-52,-554,23.5,1626.7,red,2.83,2,34,26,red
4526197736,10,8,14,1,1,0,0,18294,7.4,18581,204,43,1058,527,20.4,1829.4,8,10,12,0,0,0,0,17236,7,18054,210,46,-1058,-527,21,1723.6,red,3,2,39,13,red
4526110016,3,7,2,0,0,0,0,14415,6.8,17890,213,61,-3505,-1473,21.3,1441.5,7,3,9,1,1,0,0,17920,7.2,19363,226,70,3505,1473,22.6,1792,red,0.71,5.33,16,21,red
4524668362,10,6,17,0,0,0,0,17634,6.6,16665,193,35,2031,1004,19.3,1763.4,6,10,6,0,0,0,0,15603,6.4,15661,196,38,-2031,-1004,19.6,1560.3,red,4.5,1.2,16,19,blue
4525216073,6,2,7,1,1,0,0,17062,7.2,20216,235,64,2436,2608,23.5,1706.2,2,6,3,1,0,1,0,14626,7,17608,203,60,-2436,-2608,20.3,1462.6,blue,6.5,0.83,19,17,red
4488817314,12,9,20,0,0,0,0,19098,7,18390,230,36,1769,2294,23,1909.8,9,12,14,1,1,0,0,17329,6.4,16096,166,60,-1769,-2294,16.6,1732.9,red,3.56,1.92,19,18,blue
4520017267,8,12,8,0,0,0,0,17237,7,18392,213,41,-1133,-714,21.3,1723.7,12,8,12,1,1,0,0,18370,7.4,19106,196,46,1133,714,19.6,1837,red,1.33,3,12,57,blue
4508074123,10,6,8,0,0,0,0,18093,7.4,18871,222,42,1864,1877,22.2,1809.3,6,10,7,1,1,0,0,16229,6.6,16994,189,62,-1864,-1877,18.9,1622.9,blue,3,1.3,20,21,blue
4511419534,7,7,9,0,0,0,0,16276,6.6,17546,215,40,273,-1195,21.5,1627.6,7,7,2,1,0,1,0,16003,7.2,18741,196,48,-273,1195,19.6,1600.3,red,2.29,1.29,19,19,blue
4507747871,6,5,6,0,0,0,0,16471,6.8,17952,246,36,1450,763,24.6,1647.1,5,6,3,0,0,0,0,15021,6.8,17189,200,40,-1450,-763,20,1502.1,blue,2.4,1.33,19,20,blue
4510883651,6,11,5,0,0,0,0,15246,6.4,15419,151,42,-4370,-4504,15.1,1524.6,11,6,12,1,1,0,0,19616,7.2,19923,235,51,4370,4504,23.5,1961.6,red,1,3.83,18,21,blue
4525786511,8,2,10,1,0,1,1,18656,7.2,19071,229,45,3761,1269,22.9,1865.6,2,8,2,0,0,0,0,14895,6.6,17802,241,52,-3761,-1269,24.1,1489.5,blue,9,0.5,22,40,red
4500845226,5,1,5,2,1,1,0,16951,7.2,18681,270,43,1341,-85,27,1695.1,1,5,1,0,0,0,0,15610,7.2,18766,254,76,-1341,85,25.4,1561,blue,10,0.4,22,81,blue
4519568491,7,5,8,0,0,0,0,17830,7,18550,214,55,1299,8,21.4,1783,5,7,4,2,1,1,0,16531,7.2,18542,217,64,-1299,-8,21.7,1653.1,blue,3,1.29,17,15,red
4515648719,11,8,13,0,0,0,0,16886,6.6,16618,172,39,-2107,-1458,17.2,1688.6,8,11,8,1,1,0,0,18993,7.2,18076,189,60,2107,1458,18.9,1899.3,red,3,1.45,48,14,blue
4526919278,4,3,5,1,1,0,0,16122,6.8,17673,223,44,385,-1446,22.3,1612.2,3,4,2,1,0,1,0,15737,7.2,19119,240,64,-385,1446,24,1573.7,red,3,1.25,22,21,blue
4523554856,7,6,7,0,0,0,1,19367,7.2,19595,259,61,4507,2090,25.9,1936.7,6,7,2,1,1,0,0,14860,6.8,17505,202,45,-4507,-2090,20.2,1486,blue,2.33,1.14,21,14,blue
4510986413,9,2,8,1,0,1,1,20027,7.2,19439,257,55,6790,4889,25.7,2002.7,2,9,4,1,1,0,0,13237,6.2,14550,165,49,-6790,-4889,16.5,1323.7,blue,8.5,0.67,19,20,blue
4525594004,12,10,16,1,0,1,0,19784,7,18582,241,41,1680,473,24.1,1978.4,10,12,16,0,0,0,0,18104,7,18109,197,35,-1680,-473,19.7,1810.4,red,2.8,2.17,25,24,blue
4503836922,3,5,3,1,1,0,0,15118,7.2,18628,222,63,-769,891,22.2,1511.8,5,3,9,1,0,1,0,15887,7,17737,208,56,769,-891,20.8,1588.7,blue,1.2,4.67,44,16,red
4500568254,6,3,6,0,0,0,0,16195,7,17940,214,35,2254,1870,21.4,1619.5,3,6,1,0,0,0,0,13941,6.2,16070,193,56,-2254,-1870,19.3,1394.1,blue,4,0.67,17,15,blue
4515517372,2,2,2,0,0,0,0,15423,6.8,18333,227,60,699,753,22.7,1542.3,2,2,3,1,1,0,0,14724,6.8,17580,232,46,-699,-753,23.2,1472.4,blue,2,2.5,22,18,red
4527240593,9,5,8,0,0,0,0,18174,7,18815,232,55,3242,2227,23.2,1817.4,5,9,7,1,1,0,0,14932,6.8,16588,191,40,-3242,-2227,19.1,1493.2,red,3.4,1.33,39,37,blue
4526904265,7,4,6,0,0,0,0,16649,7,17555,212,52,1535,220,21.2,1664.9,4,7,4,2,1,1,0,15114,7,17335,222,53,-1535,-220,22.2,1511.4,blue,3.25,1.14,18,13,blue
4524535912,9,8,9,0,0,0,0,16818,6.6,16998,208,44,-141,222,20.8,1681.8,8,9,11,1,1,0,0,16959,6.8,16776,164,48,141,-222,16.4,1695.9,blue,2.25,2.11,14,14,blue
4515240006,5,10,8,0,0,0,0,15829,6.8,17626,236,53,-3567,-1828,23.6,1582.9,10,5,11,2,1,1,1,19396,7.2,19454,234,49,3567,1828,23.4,1939.6,red,1.3,4.2,21,22,red
4527159489,3,4,3,0,0,0,0,15604,7,18013,227,65,-557,625,22.7,1560.4,4,3,6,2,1,1,0,16161,6.8,17388,216,57,557,-625,21.6,1616.1,red,1.5,3.33,16,17,red
4522587256,4,11,3,0,0,0,0,14927,6.4,16195,195,44,-2597,-1718,19.5,1492.7,11,4,10,1,1,0,0,17524,7,17913,221,46,2597,1718,22.1,1752.4,blue,0.64,5.25,18,23,red
4505233035,5,7,4,0,0,0,0,16247,6.8,17790,189,52,-820,-575,18.9,1624.7,7,5,6,1,1,0,0,17067,7,18365,222,57,820,575,22.2,1706.7,blue,1.29,2.6,39,21,blue
4511813987,14,5,11,1,1,0,0,20070,7.2,20194,211,65,4235,3837,21.1,2007,5,14,8,0,0,0,0,15835,6.6,16357,188,34,-4235,-3837,18.8,1583.5,blue,5,0.93,53,45,blue
4492974122,5,4,6,0,0,0,0,16166,7,17990,198,47,180,-192,19.8,1616.6,4,5,2,1,1,0,0,15986,7,18182,212,80,-180,192,21.2,1598.6,red,2.75,1.2,22,22,blue
4527354441,3,5,2,0,0,0,0,15630,7,18378,254,48,-1092,-324,25.4,1563,5,3,7,0,0,0,0,16722,7,18702,264,44,1092,324,26.4,1672.2,red,1,4,54,39,red
4522421841,8,7,11,1,1,0,1,18744,6.8,18677,210,55,2858,1988,21,1874.4,7,8,7,0,0,0,0,15886,6.8,16689,174,56,-2858,-1988,17.4,1588.6,blue,2.71,1.75,22,16,blue
4509392638,5,9,4,0,0,0,0,15815,7,18120,202,56,-2234,-1264,20.2,1581.5,9,5,8,2,1,1,0,18049,7.4,19384,258,48,2234,1264,25.8,1804.9,red,1,3.4,21,21,blue
4527516350,6,7,6,0,0,0,0,16246,7,17593,193,45,-766,-577,19.3,1624.6,7,6,9,1,1,0,0,17012,7.2,18170,204,61,766,577,20.4,1701.2,blue,1.71,2.67,27,18,blue
4521334344,5,6,4,0,0,0,0,15701,7,17899,212,42,-662,-951,21.2,1570.1,6,5,3,2,1,1,0,16363,7,18850,243,52,662,951,24.3,1636.3,red,1.5,1.8,15,17,blue
4513796211,8,12,5,0,0,0,0,16024,7,17294,212,46,-2370,-2104,21.2,1602.4,12,8,10,1,1,0,0,18394,7.4,19398,194,61,2370,2104,19.4,1839.4,red,1.08,2.75,14,21,red
4511029912,6,13,2,0,0,0,0,15539,6.8,17438,202,48,-4311,-2532,20.2,1553.9,13,6,14,1,1,0,0,19850,7.4,19970,234,55,4311,2532,23.4,1985,red,0.62,4.5,86,23,blue
4506803451,11,2,8,1,1,0,0,19038,7.4,20256,252,46,4090,2523,25.2,1903.8,2,11,3,0,0,0,0,14948,7,17733,214,68,-4090,-2523,21.4,1494.8,blue,9.5,0.45,20,17,blue
4516581221,5,7,10,1,1,0,0,14492,6.4,16087,176,48,-2828,-1814,17.6,1449.2,7,5,4,1,0,1,0,17320,6.6,17901,217,54,2828,1814,21.7,1732,blue,2.14,2.2,60,19,blue
4502539772,3,8,6,0,0,0,0,15193,6.8,17054,232,57,-1810,-2661,23.2,1519.3,8,3,2,1,1,0,0,17003,7,19715,235,65,1810,2661,23.5,1700.3,red,1.12,3.33,16,16,blue
4527107365,4,8,0,0,0,0,0,13362,6.4,15531,155,34,-4968,-4165,15.5,1336.2,8,4,4,1,1,0,0,18330,7.2,19696,240,67,4968,4165,24,1833,red,0.5,3,16,15,blue
4525339326,1,3,1,1,1,0,0,14832,7,17330,228,60,-196,-282,22.8,1483.2,3,1,4,0,0,0,0,15028,7,17612,226,48,196,282,22.6,1502.8,blue,0.67,7,16,20,blue
4510322898,9,2,12,1,1,0,0,17664,7,17554,221,46,2946,1011,22.1,1766.4,2,9,4,0,0,0,0,14718,6.6,16543,236,46,-2946,-1011,23.6,1471.8,blue,10.5,0.67,20,18,blue
4511761586,6,7,8,1,1,0,0,17046,7.4,19783,217,67,307,2085,21.7,1704.6,7,6,7,0,0,0,0,16739,7,17698,256,40,-307,-2085,25.6,1673.9,blue,2,2.33,50,23,red
4519356539,3,0,3,0,0,0,0,15984,6.8,18306,261,49,1916,632,26.1,1598.4,0,3,0,0,0,0,0,14068,6.8,17674,224,72,-1916,-632,22.4,1406.8,red,12.03,0,42,16,blue
4523788727,12,9,18,0,0,0,0,18748,6.8,17354,195,45,1212,77,19.5,1874.8,9,12,8,1,1,0,0,17536,7,17277,193,52,-1212,-77,19.3,1753.6,blue,3.33,1.42,14,14,blue
4503411816,5,1,6,0,0,0,0,16733,7.2,19698,231,62,1901,1126,23.1,1673.3,1,5,1,2,1,1,0,14832,7,18572,239,68,-1901,-1126,23.9,1483.2,blue,11,0.4,20,18,blue
4526812997,6,12,12,1,1,0,0,15417,6.4,15374,154,51,-4032,-2866,15.4,1541.7,12,6,11,0,0,0,0,19449,7,18240,232,52,4032,2866,23.2,1944.9,red,1.5,3.83,60,39,red
4527587697,10,6,7,1,1,0,0,18302,7.2,18149,215,40,2617,1172,21.5,1830.2,6,10,4,1,0,1,0,15685,6.8,16977,178,63,-2617,-1172,17.8,1568.5,red,2.83,1,21,19,blue
4526761574,3,3,2,0,0,0,0,15471,6.8,18349,219,51,-251,560,21.9,1547.1,3,3,7,0,0,0,0,15722,7,17789,255,52,251,-560,25.5,1572.2,blue,1.67,3.33,81,16,red
4513988125,6,4,11,1,1,0,0,16612,6.8,17712,218,56,1094,287,21.8,1661.2,4,6,4,0,0,0,0,15518,6.8,17425,221,60,-1094,-287,22.1,1551.8,blue,4.25,1.33,43,20,blue
4516990759,6,4,3,0,0,0,0,16601,7,18618,242,52,1235,1010,24.2,1660.1,4,6,5,0,0,0,0,15366,6.8,17608,201,44,-1235,-1010,20.1,1536.6,blue,2.25,1.5,62,18,blue
4526157711,9,1,13,2,1,1,0,18159,6.6,16870,217,59,5302,3045,21.7,1815.9,1,9,2,0,0,0,0,12857,6,13825,147,48,-5302,-3045,14.7,1285.7,blue,22,0.33,53,13,blue
4526376483,5,7,9,0,0,0,0,14690,6.4,15168,188,40,-5426,-3115,18.8,1469,7,5,9,1,1,0,2,20116,7,18283,245,43,5426,3115,24.5,2011.6,red,2,3.2,19,14,red
4502939535,9,3,9,0,0,0,0,16963,7,18341,245,37,2609,681,24.5,1696.3,3,9,2,1,1,0,0,14354,7,17660,209,52,-2609,-681,20.9,1435.4,blue,6,0.56,17,20,blue
4499945956,5,8,4,0,0,0,0,16116,6.8,16953,233,43,-89,-953,23.3,1611.6,8,5,3,1,1,0,0,16205,6.8,17906,213,52,89,953,21.3,1620.5,red,1.12,2.2,18,18,blue
4521141561,5,12,5,0,0,0,0,15341,6.4,15896,188,32,-3588,-1795,18.8,1534.1,12,5,13,1,1,0,0,18929,6.6,17691,230,44,3588,1795,23,1892.9,red,0.83,5,23,20,red
4502988804,2,8,2,0,0,0,0,14177,6.4,15427,196,54,-2115,-2872,19.6,1417.7,8,2,18,1,1,0,0,16292,7,18299,200,43,2115,2872,20,1629.2,red,0.5,13,19,20,red
4526305174,7,4,11,0,0,0,0,17308,7.2,18538,213,44,1589,-197,21.3,1730.8,4,7,1,2,1,1,0,15719,7,18735,232,70,-1589,197,23.2,1571.9,red,4.5,0.71,21,19,blue
4506241300,4,5,5,0,0,0,0,15758,6.4,16906,211,50,628,-558,21.1,1575.8,5,4,9,1,1,0,0,15130,6.8,17464,205,37,-628,558,20.5,1513,red,1.8,3.5,25,53,blue
4511072996,8,10,14,1,1,0,0,17275,6.8,16684,204,55,-604,-1254,20.4,1727.5,10,8,16,0,0,0,0,17879,7,17938,186,52,604,1254,18.6,1787.9,red,2.2,3.25,14,42,blue
4509031908,7,10,4,1,1,0,0,16505,6.6,17778,206,39,-1861,-1195,20.6,1650.5,10,7,11,0,0,0,0,18366,7,18973,221,44,1861,1195,22.1,1836.6,red,1.1,3,12,13,blue
4521833951,8,3,13,0,0,0,0,18093,7.2,18506,238,51,2774,1134,23.8,1809.3,3,8,3,1,1,0,0,15319,6.8,17372,230,47,-2774,-1134,23,1531.9,red,7,0.75,20,46,blue
4499814815,7,9,5,0,0,0,0,15939,6.6,16482,205,31,-1323,-1025,20.5,1593.9,9,7,6,0,0,0,0,17262,6.8,17507,167,34,1323,1025,16.7,1726.2,red,1.33,2.14,13,15,red
4525831226,0,1,0,1,1,0,0,14457,7,18824,230,72,-832,541,23,1445.7,1,0,1,0,0,0,0,15289,7,18283,267,63,832,-541,26.7,1528.9,red,0,12.65,60,20,red
4475185229,11,5,12,1,0,1,2,20920,7.2,19263,243,36,5418,3077,24.3,2092,5,11,8,0,0,0,0,15502,6.8,16186,173,47,-5418,-3077,17.3,1550.2,blue,4.6,1.18,39,12,red
4500080276,7,0,8,0,0,0,0,16688,7.2,19162,233,60,3060,2469,23.3,1668.8,0,7,0,1,1,0,0,13628,6.8,16693,222,57,-3060,-2469,22.2,1362.8,blue,12.03,0,20,32,blue
4507744435,2,7,1,0,0,0,0,14873,6.8,17781,205,72,-2304,31,20.5,1487.3,7,2,9,1,1,0,0,17177,7,17750,238,44,2304,-31,23.8,1717.7,red,0.43,8,15,16,red
4522320216,4,7,4,0,0,0,0,15259,7,17666,214,63,-1396,-92,21.4,1525.9,7,4,7,1,1,0,0,16655,6.6,17758,250,48,1396,92,25,1665.5,red,1.14,3.5,21,20,red
4506553264,10,3,9,1,1,0,0,18096,7.2,19349,242,46,3738,4262,24.2,1809.6,3,10,4,0,0,0,0,14358,6.4,15087,198,47,-3738,-4262,19.8,1435.8,blue,6.33,0.7,14,15,blue
4514417841,5,3,5,1,0,1,0,16153,6.8,17913,227,35,1184,-80,22.7,1615.3,3,5,3,1,1,0,0,14969,7,17993,208,70,-1184,80,20.8,1496.9,blue,3.33,1.2,17,45,blue
4511678140,7,9,10,1,0,1,1,19036,7.2,19444,248,60,2346,751,24.8,1903.6,9,7,14,1,1,0,0,16690,7.4,18693,197,53,-2346,-751,19.7,1669,blue,1.89,3.29,18,38,blue
4527646038,10,11,12,0,0,0,0,17788,6.8,17829,159,59,-275,-739,15.9,1778.8,11,10,7,0,0,0,0,18063,7,18568,212,55,275,739,21.2,1806.3,red,2,1.8,21,24,red
4516268505,8,3,6,0,0,0,0,16532,7.2,18420,229,40,1558,785,22.9,1653.2,3,8,2,1,0,1,0,14974,7,17635,206,56,-1558,-785,20.6,1497.4,blue,4.67,0.62,44,36,blue
4526987414,3,6,4,0,0,0,0,15742,7,17970,214,64,-750,-276,21.4,1574.2,6,3,6,1,1,0,0,16492,7.2,18246,232,52,750,276,23.2,1649.2,red,1.17,4,29,20,blue
4526906717,4,3,0,0,0,0,0,15960,7.4,18912,253,60,1479,2350,25.3,1596,3,4,3,0,0,0,0,14481,6.4,16562,228,40,-1479,-2350,22.8,1448.1,blue,1.33,1.5,111,18,blue
4525315485,6,8,6,0,0,0,0,16132,6.8,18331,199,57,-1850,-1016,19.9,1613.2,8,6,9,1,1,0,0,17982,7.4,19347,243,54,1850,1016,24.3,1798.2,red,1.5,2.83,15,18,red
4519712655,9,8,10,0,0,0,0,17350,7.2,18836,202,45,620,874,20.2,1735,8,9,8,0,0,0,0,16730,6.6,17962,211,49,-620,-874,21.1,1673,red,2.38,1.78,73,18,blue
4524754524,3,8,2,0,0,0,0,13875,6.6,16394,209,36,-3866,-1987,20.9,1387.5,8,3,10,1,1,0,0,17741,7.2,18381,227,47,3866,1987,22.7,1774.1,red,0.62,6,17,26,red
4522030672,1,1,1,1,0,1,0,14969,6.8,17547,252,48,1089,33,25.2,1496.9,1,1,0,0,0,0,0,13880,6.8,17514,212,47,-1089,-33,21.2,1388,blue,2,1,20,51,red
4526010280,9,7,6,2,1,1,0,17195,7.2,18590,178,75,827,1271,17.8,1719.5,7,9,7,0,0,0,0,16368,6.8,17319,201,46,-827,-1271,20.1,1636.8,blue,2.14,1.56,39,18,red
4506537337,4,5,3,0,0,0,0,15347,7,17655,234,46,-1374,-1041,23.4,1534.7,5,4,7,2,1,1,0,16721,6.8,18696,238,57,1374,1041,23.8,1672.1,red,1.4,3,20,22,blue
4519118449,10,3,13,1,1,0,0,18290,7.6,20250,248,44,3943,4243,24.8,1829,3,10,4,0,0,0,0,14347,6.4,16007,200,51,-3943,-4243,20,1434.7,blue,7.67,0.7,17,17,red
4525208394,5,3,5,1,0,1,0,16176,7.2,18728,221,60,543,1065,22.1,1617.6,3,5,4,0,0,0,0,15633,6.8,17663,257,51,-543,-1065,25.7,1563.3,red,3.33,1.4,20,14,red
4526069179,6,6,7,1,1,0,0,16148,6.8,15943,200,45,-1106,-1434,20,1614.8,6,6,9,1,0,1,0,17254,6.6,17377,216,70,1106,1434,21.6,1725.4,red,2.17,2.5,17,17,blue
4524419928,3,4,4,2,1,1,0,15612,7,18702,214,72,-1011,-309,21.4,1561.2,4,3,6,0,0,0,0,16623,7.2,19011,239,65,1011,309,23.9,1662.3,blue,1.75,3.33,15,20,blue
4516204235,5,4,7,1,0,1,0,16104,7,17890,231,48,1039,589,23.1,1610.4,4,5,3,1,1,0,0,15065,6.8,17301,205,47,-1039,-589,20.5,1506.5,blue,3,1.4,20,21,red
4527544639,8,9,8,0,0,0,0,15372,6.8,16833,161,40,-3616,-3352,16.1,1537.2,9,8,4,1,1,0,0,18988,7.6,20185,248,64,3616,3352,24.8,1898.8,red,1.78,1.62,51,14,red
4510853790,4,4,5,0,0,0,0,15694,6.8,18453,242,59,217,709,24.2,1569.4,4,4,4,1,1,0,0,15477,7,17744,214,60,-217,-709,21.4,1547.7,red,2.25,2,22,20,red
4527220222,9,7,11,1,0,1,0,17578,7.2,18250,209,43,1641,1439,20.9,1757.8,7,9,10,0,0,0,0,15937,7,16811,175,56,-1641,-1439,17.5,1593.7,blue,2.86,1.89,23,22,red
4526484364,10,5,11,1,1,0,0,18436,7,18039,209,47,1990,-86,20.9,1843.6,5,10,4,1,0,1,0,16446,6.8,18125,226,48,-1990,86,22.6,1644.6,blue,4.2,0.9,21,20,blue
4520786443,7,4,7,1,0,1,0,16620,7.2,18824,211,48,273,255,21.1,1662,4,7,7,1,1,0,0,16347,7,18569,226,67,-273,-255,22.6,1634.7,red,3.5,1.57,14,15,blue
4509008728,5,2,4,2,1,1,0,16419,7,19317,248,57,1994,2643,24.8,1641.9,2,5,3,0,0,0,0,14425,6.6,16674,238,36,-1994,-2643,23.8,1442.5,red,4.5,1,21,21,blue
4509162427,5,5,5,0,0,0,0,16384,7.4,19826,229,61,759,2511,22.9,1638.4,5,5,7,1,1,0,0,15625,6.6,17315,205,55,-759,-2511,20.5,1562.5,blue,2,2.4,37,19,red
4524227003,3,8,3,1,0,1,0,15330,7,18294,230,57,-2105,-1066,23,1533,8,3,8,1,1,0,0,17435,7.2,19360,225,60,2105,1066,22.5,1743.5,red,0.75,5.33,24,29,red
4521974813,10,1,18,2,1,1,0,19008,7.2,19021,239,68,4319,2388,23.9,1900.8,1,10,2,0,0,0,0,14689,6.6,16633,240,56,-4319,-2388,24,1468.9,blue,28,0.3,50,16,blue
4515451687,5,2,7,0,0,0,0,16238,7,18854,260,36,428,374,26,1623.8,2,5,1,1,0,1,0,15810,7.2,18480,232,80,-428,-374,23.2,1581,red,6,0.6,64,84,red
4502573246,5,4,7,0,0,0,0,16094,6.8,17711,219,41,956,1998,21.9,1609.4,4,5,4,0,0,0,0,15138,6.6,15713,183,36,-956,-1998,18.3,1513.8,blue,3,1.6,18,16,red
4524060620,5,14,5,0,0,0,0,15099,6.8,17734,156,45,-5206,-1622,15.6,1509.9,14,5,8,0,0,0,1,20305,7,19356,226,39,5206,1622,22.6,2030.5,red,0.71,4.4,15,15,red
4521025681,2,10,0,0,0,0,0,14143,6.6,16647,183,55,-5891,-3716,18.3,1414.3,10,2,7,2,1,1,1,20034,7.4,20363,264,48,5891,3716,26.4,2003.4,red,0.2,8.5,22,14,red
4523694743,3,10,4,1,1,0,0,14385,6.4,15780,195,42,-4413,-3109,19.5,1438.5,10,3,12,1,0,1,0,18798,7,18889,234,41,4413,3109,23.4,1879.8,red,0.7,7.33,110,17,red
4526803305,3,4,6,0,0,0,0,14725,6.8,17291,204,43,-1680,-1155,20.4,1472.5,4,3,3,2,1,1,0,16405,7.4,18446,258,56,1680,1155,25.8,1640.5,red,2.25,2.33,56,24,red
4509982374,6,5,7,0,0,0,0,16543,7,18558,245,48,192,-656,24.5,1654.3,5,6,7,1,1,0,0,16351,7.2,19214,245,56,-192,656,24.5,1635.1,red,2.6,2,23,22,red
4508518310,2,3,4,0,0,0,0,14505,6.8,18139,230,51,-1183,-182,23,1450.5,3,2,4,1,1,0,0,15688,7,18321,253,48,1183,182,25.3,1568.8,red,2,3.5,18,45,red
4503986448,7,4,5,0,0,0,0,16681,7,18270,265,39,1403,389,26.5,1668.1,4,7,5,0,0,0,0,15278,7,17881,224,35,-1403,-389,22.4,1527.8,red,3,1.29,22,48,blue
4520653758,6,7,11,0,0,0,0,15844,6.8,16801,197,47,-151,-895,19.7,1584.4,7,6,5,2,1,1,0,15995,6.8,17696,205,60,151,895,20.5,1599.5,red,2.43,2,15,17,blue
4527207692,5,5,7,0,0,0,0,15843,7,17530,233,35,380,-245,23.3,1584.3,5,5,5,1,1,0,0,15463,7,17775,221,51,-380,245,22.1,1546.3,blue,2.4,2,23,24,blue
4500460530,9,2,12,1,1,0,0,17913,7.4,19102,218,53,3453,1775,21.8,1791.3,2,9,2,0,0,0,0,14460,6.8,17327,215,57,-3453,-1775,21.5,1446,blue,10.5,0.44,24,10,blue
4512191521,3,6,4,0,0,0,0,15057,6.8,17267,218,64,-3443,-1347,21.8,1505.7,6,3,10,1,1,0,1,18500,7.2,18614,219,68,3443,1347,21.9,1850,red,1.17,5.33,15,19,red
4505307600,5,9,5,0,0,0,0,14630,6.6,16527,177,28,-2167,-2045,17.7,1463,9,5,10,1,1,0,0,16797,7,18572,214,41,2167,2045,21.4,1679.7,blue,1.11,3.8,25,22,blue
4526123124,4,4,4,0,0,0,0,16156,6.8,17794,260,46,152,-722,26,1615.6,4,4,3,0,0,0,0,16004,7,18516,249,55,-152,722,24.9,1600.4,blue,2,1.75,36,54,blue
4511008520,2,5,1,1,1,0,0,13352,6.6,16455,188,44,-3059,-2718,18.8,1335.2,5,2,3,1,0,1,0,16411,7,19173,252,48,3059,2718,25.2,1641.1,red,0.6,4,18,13,red
4526787106,4,5,4,1,1,0,0,16042,7,17865,240,68,-236,711,24,1604.2,5,4,8,0,0,0,0,16278,6.8,17154,241,44,236,-711,24.1,1627.8,red,1.6,3.25,39,18,blue
4526234788,5,8,5,1,0,1,0,15420,6.8,16996,176,50,-2178,-1407,17.6,1542,8,5,7,1,1,0,0,17598,7,18403,219,34,2178,1407,21.9,1759.8,blue,1.25,3,47,16,red
4516306111,2,5,0,0,0,0,0,15080,6.8,17979,262,56,-1267,427,26.2,1508,5,2,6,2,1,1,0,16347,7,17552,255,48,1267,-427,25.5,1634.7,red,0.4,5.5,17,18,red
4522338858,4,7,5,1,1,0,0,15766,7,18750,232,60,-1035,582,23.2,1576.6,7,4,7,0,0,0,0,16801,7,18168,202,55,1035,-582,20.2,1680.1,blue,1.29,3.5,55,22,red
4502334465,11,8,16,1,0,1,1,20639,7.2,18457,207,61,4639,3197,20.7,2063.9,8,11,10,1,1,0,0,16000,6.2,15260,159,55,-4639,-3197,15.9,1600,blue,3.38,1.64,22,18,blue
4494986980,0,9,0,0,0,0,0,13345,6.6,15982,230,42,-5508,-3648,23,1334.5,9,0,10,1,1,0,1,18853,7.2,19630,235,57,5508,3648,23.5,1885.3,red,0,12.65,17,41,red
4527522353,10,7,9,1,1,0,0,17712,7,19043,207,42,2370,3795,20.7,1771.2,7,10,6,0,0,0,0,15342,6.4,15248,186,38,-2370,-3795,18.6,1534.2,blue,2.71,1.3,24,21,red
4525983160,11,4,13,1,1,0,0,18866,7,18926,225,41,3992,2506,22.5,1886.6,4,11,3,0,0,0,0,14874,6.4,16420,189,45,-3992,-2506,18.9,1487.4,blue,6,0.64,15,20,blue
4516712526,11,4,11,1,1,0,0,19035,7.4,19997,232,43,2739,1170,23.2,1903.5,4,11,5,1,0,1,0,16296,7.2,18827,268,44,-2739,-1170,26.8,1629.6,blue,5.5,0.82,22,18,blue
4527289282,3,9,3,0,0,0,0,15292,6.8,17170,223,55,-2513,-2247,22.3,1529.2,9,3,8,1,1,0,0,17805,7.2,19417,231,44,2513,2247,23.1,1780.5,blue,0.67,5.67,17,17,red
4502535933,1,1,1,0,0,0,0,15082,6.8,17854,239,51,1389,894,23.9,1508.2,1,1,0,1,1,0,0,13693,6.4,16960,209,56,-1389,-894,20.9,1369.3,blue,2,1,77,17,blue
4507594036,6,8,7,0,0,0,0,15818,6.6,16894,162,53,-1492,-1925,16.2,1581.8,8,6,5,1,1,0,0,17310,7.2,18819,214,56,1492,1925,21.4,1731,blue,1.62,2.17,15,15,red
4515910414,11,10,10,1,0,1,0,18145,7.2,18705,211,40,-139,-652,21.1,1814.5,10,11,8,1,1,0,0,18284,7.2,19357,236,50,139,652,23.6,1828.4,red,2.1,1.64,18,17,blue
4525790014,5,3,2,0,0,0,0,15934,7,18258,251,52,943,505,25.1,1593.4,3,5,2,1,1,0,0,14991,7,17753,231,56,-943,-505,23.1,1499.1,blue,2.33,1,14,16,blue
4509319311,8,5,12,1,1,0,0,17846,7,18097,192,67,2425,824,19.2,1784.6,5,8,4,1,0,1,0,15421,6.8,17273,215,48,-2425,-824,21.5,1542.1,blue,4,1.12,20,16,blue
4525851788,6,5,9,1,0,1,0,17025,6.8,17699,207,56,1128,-45,20.7,1702.5,5,6,4,1,1,0,0,15897,7,17744,226,52,-1128,45,22.6,1589.7,blue,3,1.5,14,18,blue
4500869291,11,8,9,2,1,1,0,17598,7.2,18935,225,52,1380,1402,22.5,1759.8,8,11,8,0,0,0,0,16218,6.8,17533,192,44,-1380,-1402,19.2,1621.8,red,2.5,1.45,23,16,red
4515205200,4,3,2,1,0,1,0,16220,7,18251,239,54,688,415,23.9,1622,3,4,4,1,1,0,0,15532,7,17836,221,57,-688,-415,22.1,1553.2,red,2,1.75,18,23,blue
4507437151,11,6,13,1,1,0,0,18395,6.6,16701,206,31,2933,1905,20.6,1839.5,6,11,6,0,0,0,0,15462,6.2,14796,167,39,-2933,-1905,16.7,1546.2,red,4,1.09,17,13,red
4509649121,6,12,4,1,0,1,0,15727,6.2,15909,171,49,-2467,-1494,17.1,1572.7,12,6,13,0,0,0,0,18194,7,17403,202,35,2467,1494,20.2,1819.4,red,0.83,4.17,38,18,red
4511683364,4,3,3,0,0,0,0,15832,7.2,18431,257,52,755,436,25.7,1583.2,3,4,4,2,1,1,0,15077,7,17995,217,60,-755,-436,21.7,1507.7,blue,2.33,1.75,24,21,red
4524119242,10,2,12,1,1,0,0,18549,7.2,19419,203,63,4378,3157,20.3,1854.9,2,10,2,0,0,0,0,14171,6.6,16262,214,44,-4378,-3157,21.4,1417.1,blue,11,0.4,19,15,blue
4521081622,8,10,5,1,1,0,0,16589,6.8,17707,221,44,-1302,-90,22.1,1658.9,10,8,14,0,0,0,0,17891,7,17797,207,50,1302,90,20.7,1789.1,red,1.3,3,16,24,blue
4513902880,5,2,4,0,0,0,0,14945,6.8,17524,168,48,-145,850,16.8,1494.5,2,5,2,1,1,0,0,15090,6.6,16674,233,48,145,-850,23.3,1509,blue,4.5,0.8,12,19,blue
4506650887,9,4,6,1,0,1,1,19279,7.6,19873,230,69,4305,3750,23,1927.9,4,9,4,1,1,0,0,14974,6.4,16123,182,42,-4305,-3750,18.2,1497.4,blue,3.75,0.89,22,204,blue
4525849637,5,11,5,0,0,0,0,15871,6.6,16394,200,56,-3162,-23,20,1587.1,11,5,15,0,0,0,1,19033,6.4,16417,195,36,3162,23,19.5,1903.3,blue,0.91,5.2,17,23,red
4505985909,8,9,7,2,1,1,1,18790,7.2,18604,224,48,1726,-196,22.4,1879,9,8,13,0,0,0,0,17064,7.2,18800,195,51,-1726,196,19.5,1706.4,blue,1.67,2.75,14,76,red
4508832149,9,7,8,1,0,1,0,16616,7,17642,182,39,350,689,18.2,1661.6,7,9,5,1,1,0,0,16266,6.8,16953,206,52,-350,-689,20.6,1626.6,red,2.43,1.33,22,24,blue
4521837052,5,9,7,0,0,0,0,15701,6.8,16610,186,60,-2760,-2274,18.6,1570.1,9,5,9,1,1,0,0,18461,7.2,18884,247,50,2760,2274,24.7,1846.1,blue,1.33,3.6,20,18,red
4526108051,9,7,9,0,0,0,0,17556,7.2,18967,214,59,805,1723,21.4,1755.6,7,9,12,1,1,0,0,16751,6.8,17244,230,36,-805,-1723,23,1675.1,red,2.57,2.11,19,15,red
4511255731,1,8,1,1,1,0,0,13591,6.6,16284,201,56,-3754,-2371,20.1,1359.1,8,1,6,0,0,0,0,17345,7.2,18655,256,56,3754,2371,25.6,1734.5,red,0.25,14,16,17,red
4526616225,10,4,8,1,1,0,0,17637,7,18484,198,64,2216,949,19.8,1763.7,4,10,2,1,0,1,0,15421,6.8,17535,236,39,-2216,-949,23.6,1542.1,blue,4.5,0.6,36,16,blue
4526030485,7,2,4,0,0,0,0,17047,7,19573,224,54,3135,1888,22.4,1704.7,2,7,1,1,1,0,0,13912,6.8,17685,201,50,-3135,-1888,20.1,1391.2,blue,5.5,0.43,19,19,blue
4506841392,9,5,14,2,1,1,0,17821,7.2,18702,215,46,1855,1520,21.5,1782.1,5,9,4,0,0,0,0,15966,6.6,17182,233,57,-1855,-1520,23.3,1596.6,red,4.6,1,19,16,red
4518702917,5,4,7,0,0,0,0,15694,7,18079,209,53,-451,591,20.9,1569.4,4,5,5,1,1,0,0,16145,7,17488,241,63,451,-591,24.1,1614.5,red,3,1.8,28,28,blue
4525303042,8,9,8,0,0,0,0,16640,6.6,16726,222,43,-1939,-2911,22.2,1664,9,8,15,2,1,1,0,18579,7.4,19637,233,56,1939,2911,23.3,1857.9,red,1.78,3,17,15,blue
4521047659,4,3,4,1,1,0,0,16235,7,18651,260,58,584,370,26,1623.5,3,4,7,0,0,0,0,15651,7,18281,221,68,-584,-370,22.1,1565.1,blue,2.67,2.5,21,18,red
4508648628,3,9,2,1,0,1,0,14423,7.2,17518,188,59,-2911,-286,18.8,1442.3,9,3,12,0,0,0,0,17334,6.8,17804,201,38,2911,286,20.1,1733.4,red,0.56,7,31,13,red
4517695714,6,6,4,0,0,0,0,15911,6.6,17205,224,36,-194,-1106,22.4,1591.1,6,6,7,0,0,0,0,16105,7.2,18311,193,48,194,1106,19.3,1610.5,red,1.67,2.17,26,21,red
4516988752,3,9,3,0,0,0,0,14232,6.8,17038,186,56,-3082,-646,18.6,1423.2,9,3,14,1,1,0,0,17314,6.8,17684,208,48,3082,646,20.8,1731.4,red,0.67,7.67,14,18,red
4526878026,5,8,2,0,0,0,0,15429,6.6,16825,227,48,-1480,-1366,22.7,1542.9,8,5,10,0,0,0,0,16909,6.8,18191,218,42,1480,1366,21.8,1690.9,red,0.88,3.6,22,54,blue
4509977321,2,5,1,0,0,0,0,14349,7,17864,199,62,-2289,-277,19.9,1434.9,5,2,4,1,1,0,0,16638,7.2,18141,246,57,2289,277,24.6,1663.8,red,0.6,4.5,16,21,red
4514142967,10,12,15,1,1,0,0,17877,6.8,17302,186,43,-920,-1562,18.6,1787.7,12,10,9,1,0,1,0,18797,7.2,18864,231,40,920,1562,23.1,1879.7,blue,2.08,2.1,20,22,red
4492831778,8,10,8,0,0,0,0,15968,6.4,15868,145,42,-1912,-19,14.5,1596.8,10,8,13,1,1,0,0,17880,6.6,15887,191,33,1912,19,19.1,1788,blue,1.6,2.88,15,18,red
4516967863,7,8,5,2,1,1,1,17931,7,18404,210,65,-546,-104,21,1793.1,8,7,13,0,0,0,0,18477,7,18508,217,50,546,104,21.7,1847.7,blue,1.5,3,18,16,blue
4510156433,9,7,10,0,0,0,0,17082,7.2,18101,223,36,188,-498,22.3,1708.2,7,9,11,1,1,0,0,16894,7,18599,215,72,-188,498,21.5,1689.4,red,2.71,2,18,16,red
4509929305,7,8,6,1,1,0,0,17147,7,18525,205,52,-142,-1193,20.5,1714.7,8,7,2,1,0,1,0,17289,7.4,19718,242,59,142,1193,24.2,1728.9,red,1.62,1.43,20,20,red
4524922802,12,4,14,0,0,0,0,18338,7,18468,211,43,3054,2510,21.1,1833.8,4,12,2,1,1,0,0,15284,6.6,15958,190,61,-3054,-2510,19,1528.4,blue,6.5,0.5,21,18,blue
4521352083,4,9,3,1,1,0,0,15367,6.6,17109,214,54,-2572,-2642,21.4,1536.7,9,4,12,1,0,1,0,17939,7,19751,198,70,2572,2642,19.8,1793.9,red,0.78,5.25,35,45,red
4527650807,2,4,3,1,1,0,0,14408,6.6,16534,212,49,-1147,-1842,21.2,1440.8,4,2,4,0,0,0,0,15555,6.8,18376,218,52,1147,1842,21.8,1555.5,blue,1.25,4,50,17,blue
4511176249,5,4,6,0,0,0,0,14991,6.8,17977,193,43,-274,-406,19.3,1499.1,4,5,3,1,1,0,0,15265,7,18383,217,56,274,406,21.7,1526.5,blue,2.75,1.4,50,20,blue
4518413320,5,1,6,1,0,1,0,16144,7,17907,226,65,2237,1009,22.6,1614.4,1,5,1,0,0,0,0,13907,6.8,16898,226,53,-2237,-1009,22.6,1390.7,blue,11,0.4,43,35,red
4526208806,6,8,6,0,0,0,0,15186,6.8,16381,204,24,-2666,-1972,20.4,1518.6,8,6,14,1,1,0,0,17852,7,18353,218,57,2666,1972,21.8,1785.2,red,1.5,3.67,17,42,blue
4517672775,7,3,11,1,1,0,0,17072,7,19087,227,52,1782,1234,22.7,1707.2,3,7,1,0,0,0,0,15290,7,17853,212,61,-1782,-1234,21.2,1529,blue,6,0.57,16,14,blue
4513061726,2,6,2,1,1,0,0,15381,6.6,16972,249,52,-2545,-1960,24.9,1538.1,6,2,6,1,0,1,1,17926,7,18932,243,56,2545,1960,24.3,1792.6,red,0.67,6,17,19,blue
4515259819,0,3,0,1,1,0,0,13610,6.6,16594,199,46,-1817,-1854,19.9,1361,3,0,1,0,0,0,0,15427,7,18448,238,53,1817,1854,23.8,1542.7,blue,0,12.65,138,20,red
4515471946,7,4,9,0,0,0,0,16535,7,17582,230,33,443,-1176,23,1653.5,4,7,3,0,0,0,0,16092,7,18758,216,64,-443,1176,21.6,1609.2,blue,4,1,23,23,blue
4526301397,3,11,4,0,0,0,0,15145,6.6,16768,200,32,-3472,-3059,20,1514.5,11,3,6,1,0,1,0,18617,7.4,19827,227,63,3472,3059,22.7,1861.7,red,0.64,5.67,11,102,red
4506659179,8,8,4,0,0,0,0,15686,6.8,17245,195,35,-2594,-1150,19.5,1568.6,8,8,9,0,0,0,0,18280,7,18395,236,60,2594,1150,23.6,1828,red,1.5,2.12,19,17,red
4507080672,10,5,14,1,1,0,0,17379,7,18458,200,52,1138,-7,20,1737.9,5,10,3,0,0,0,0,16241,7,18465,246,44,-1138,7,24.6,1624.1,blue,4.8,0.8,20,19,blue
4524768975,10,15,12,0,0,0,0,18051,6.8,17921,201,41,-2224,-2008,20.1,1805.1,15,10,13,1,1,0,0,20275,7.4,19929,226,48,2224,2008,22.6,2027.5,red,1.47,2.8,17,18,blue
4506887349,3,2,3,1,1,0,0,16075,7.2,19032,251,63,597,559,25.1,1607.5,2,3,3,0,0,0,0,15478,7,18473,244,44,-597,-559,24.4,1547.8,blue,3,1.67,21,19,red
4522491015,3,3,6,2,1,1,0,14854,7,16846,212,44,-630,-865,21.2,1485.4,3,3,2,0,0,0,0,15484,7,17711,203,68,630,865,20.3,1548.4,blue,3,1.67,42,18,blue
4514601877,4,2,5,1,1,0,0,15770,7,17426,229,60,669,-483,22.9,1577,2,4,1,0,0,0,0,15101,7,17909,261,43,-669,483,26.1,1510.1,blue,4.5,0.75,46,22,blue
4497670644,7,8,8,0,0,0,0,16308,7.2,17911,199,48,-1464,-1575,19.9,1630.8,8,7,3,0,0,0,0,17772,7.4,19486,250,48,1464,1575,25,1777.2,blue,1.88,1.57,40,18,red
4525597127,3,3,4,1,1,0,0,15008,7,18344,211,56,-37,1144,21.1,1500.8,3,3,3,0,0,0,0,15045,6.8,17200,221,47,37,-1144,22.1,1504.5,red,2.33,2,20,20,red
4518443170,5,5,5,0,0,0,0,15238,6.8,17288,184,60,-719,825,18.4,1523.8,5,5,4,0,0,0,0,15957,6.8,16463,211,44,719,-825,21.1,1595.7,blue,2,1.8,18,18,red
4514156871,4,4,2,2,1,1,0,15534,7,18339,223,64,-483,-442,22.3,1553.4,4,4,5,0,0,0,0,16017,7.2,18781,266,52,483,442,26.6,1601.7,blue,1.5,2.25,14,16,blue
4510890954,8,8,6,1,1,0,0,16707,6.6,17154,217,44,-164,343,21.7,1670.7,8,8,12,0,0,0,0,16871,6.8,16811,174,49,164,-343,17.4,1687.1,red,1.75,2.5,43,26,blue
4511901984,3,4,5,0,0,0,0,17200,7,18695,237,57,1266,612,23.7,1720,4,3,3,1,1,0,0,15934,7,18083,239,55,-1266,-612,23.9,1593.4,red,2,2.33,22,15,red
4527144840,3,11,3,0,0,0,0,14830,6.6,17313,221,48,-4299,-3010,22.1,1483,11,3,17,0,0,0,0,19129,7.4,20323,228,64,4299,3010,22.8,1912.9,red,0.55,9.33,15,37,red
4527075241,6,6,7,1,1,0,0,16620,6.8,16713,212,52,1156,168,21.2,1662,6,6,6,1,0,1,0,15464,6.6,16545,200,39,-1156,-168,20,1546.4,blue,2.17,2,17,21,blue
4508196606,9,2,12,2,1,1,0,17611,7,18390,232,45,3878,3016,23.2,1761.1,2,9,4,0,0,0,0,13733,6.4,15374,205,44,-3878,-3016,20.5,1373.3,blue,10.5,0.67,19,20,blue
4525941408,9,7,12,1,1,0,0,17908,7,17505,220,55,1717,775,22,1790.8,7,9,9,1,0,1,0,16191,6.6,16730,212,35,-1717,-775,21.2,1619.1,blue,3,1.78,17,10,red
4511628511,7,5,9,1,1,0,0,17791,7,19243,244,71,2037,2483,24.4,1779.1,5,7,5,0,0,0,0,15754,6.6,16760,209,36,-2037,-2483,20.9,1575.4,blue,3.2,1.43,16,18,blue
4514796338,2,6,3,0,0,0,0,15509,7,18064,235,58,-1098,-966,23.5,1550.9,6,2,4,2,1,1,0,16607,7.2,19030,204,68,1098,966,20.4,1660.7,red,0.83,5,17,141,red
4505630754,6,5,4,0,0,0,0,16304,6.8,17893,209,50,-794,-951,20.9,1630.4,5,6,3,0,0,0,0,17098,7.2,18844,220,73,794,951,22,1709.8,blue,2,1.33,20,16,blue
4526523004,7,3,14,1,1,0,0,16594,7,18266,217,51,611,290,21.7,1659.4,3,7,1,0,0,0,0,15983,6.8,17976,239,60,-611,-290,23.9,1598.3,red,7,0.57,19,19,blue
4518722458,4,7,3,0,0,0,0,14732,6.6,16332,186,47,-2749,-3335,18.6,1473.2,7,4,6,1,1,0,0,17481,7.6,19667,222,76,2749,3335,22.2,1748.1,red,1,3.25,31,18,red
4514235759,9,8,5,1,0,1,0,17149,6.8,17767,211,35,-417,-1028,21.1,1714.9,8,9,6,1,1,0,0,17566,7,18795,215,61,417,1028,21.5,1756.6,blue,1.75,1.56,15,43,red
4504764958,7,1,9,0,0,0,0,18408,7.4,20063,250,60,4119,2320,25,1840.8,1,7,1,2,1,1,0,14289,6.8,17743,234,51,-4119,-2320,23.4,1428.9,blue,16,0.29,19,16,blue
4524396486,0,5,0,0,0,0,0,14211,6.6,17270,232,59,-3051,-2114,23.2,1421.1,5,0,3,2,1,1,1,17262,7.2,19384,250,55,3051,2114,25,1726.2,red,0,12.65,16,27,red
4520893771,3,2,4,2,1,1,0,15698,7,18088,253,56,-451,-1374,25.3,1569.8,2,3,1,0,0,0,0,16149,7.2,19462,255,75,451,1374,25.5,1614.9,blue,3.5,1,31,48,blue
4524792382,7,8,8,1,1,0,0,15956,6.6,17062,200,44,-916,-1466,20,1595.6,8,7,6,0,0,0,0,16872,7.2,18528,204,52,916,1466,20.4,1687.2,red,1.88,2,42,13,blue
4518264766,12,1,24,1,1,0,0,20289,7.2,20144,245,48,7039,4860,24.5,2028.9,1,12,1,0,0,0,0,13250,6.4,15284,152,60,-7039,-4860,15.2,1325,blue,36,0.17,21,55,blue
4519674041,7,12,5,0,0,0,0,16948,7,17861,207,48,-2581,-1304,20.7,1694.8,12,7,12,1,1,0,0,19529,7.2,19165,252,48,2581,1304,25.2,1952.9,blue,1,3.43,19,97,red
4512329437,4,5,7,0,0,0,0,15900,7,17743,187,68,-688,-230,18.7,1590,5,4,4,1,1,0,0,16588,6.8,17973,236,51,688,230,23.6,1658.8,red,2.2,2.25,56,16,red
4527590417,4,10,3,0,0,0,0,15690,6.8,18165,223,40,-2802,-1606,22.3,1569,10,4,16,2,1,1,0,18492,7.4,19771,227,44,2802,1606,22.7,1849.2,red,0.7,6.5,14,20,red
4500333234,5,3,5,2,1,1,0,17018,7.4,20337,262,60,1496,1664,26.2,1701.8,3,5,2,0,0,0,0,15522,7.2,18673,253,59,-1496,-1664,25.3,1552.2,blue,3.33,1,37,18,blue
4500168780,10,6,12,2,1,1,1,19639,7.2,19616,241,57,2778,1130,24.1,1963.9,6,10,8,0,0,0,0,16861,7.2,18486,240,54,-2778,-1130,24,1686.1,blue,3.67,1.4,21,27,blue
4526930343,6,6,6,1,1,0,0,16019,6.6,17728,193,47,-612,-167,19.3,1601.9,6,6,8,0,0,0,0,16631,7,17895,218,51,612,167,21.8,1663.1,blue,2,2.33,14,17,blue
4521085561,2,9,3,0,0,0,0,14525,7,18541,214,72,-3207,-1327,21.4,1452.5,9,2,9,1,1,0,0,17732,7.2,19868,241,52,3207,1327,24.1,1773.2,red,0.56,9,41,44,red
4524842008,4,6,7,1,1,0,0,14931,6.4,16059,199,46,-2698,-2458,19.9,1493.1,6,4,11,1,0,1,0,17629,7,18517,239,49,2698,2458,23.9,1762.9,red,1.83,4.25,22,19,red
4510803003,10,2,7,2,1,1,1,20540,7.6,20655,256,55,6921,4411,25.6,2054,2,10,1,0,0,0,0,13619,6.6,16244,186,40,-6921,-4411,18.6,1361.9,blue,8.5,0.3,25,15,blue
4516234243,2,1,3,0,0,0,0,14895,6.8,17420,236,52,773,320,23.6,1489.5,1,2,0,1,1,0,0,14122,6.8,17100,212,48,-773,-320,21.2,1412.2,blue,5,0.5,45,19,blue
4517953972,2,14,3,0,0,0,0,14584,6.4,16269,198,50,-4788,-2570,19.8,1458.4,14,2,20,1,1,0,0,19372,7.2,18839,214,44,4788,2570,21.4,1937.2,red,0.36,17,17,53,red
4515708213,5,2,3,0,0,0,0,15757,6.8,17869,229,52,603,-461,22.9,1575.7,2,5,0,1,1,0,0,15154,7,18330,246,67,-603,461,24.6,1515.4,blue,4,0.4,17,86,blue
4526627727,7,4,5,0,0,0,0,16477,7.2,18750,198,56,435,564,19.8,1647.7,4,7,2,1,1,0,0,16042,7,18186,258,64,-435,-564,25.8,1604.2,red,3,0.86,18,17,blue
4520798666,5,2,5,0,0,0,0,15048,6.4,16614,182,48,384,872,18.2,1504.8,2,5,2,1,1,0,0,14664,6.6,15742,229,48,-384,-872,22.9,1466.4,red,5,0.8,19,23,blue
4527662502,7,4,10,1,1,0,0,17197,7.2,18431,224,64,2348,1047,22.4,1719.7,4,7,4,0,0,0,0,14849,6.6,17384,206,49,-2348,-1047,20.6,1484.9,blue,4.25,1.14,20,21,blue
4521899160,7,7,7,1,0,1,0,16956,6.8,18758,223,64,314,611,22.3,1695.6,7,7,7,1,1,0,0,16642,7.2,18147,235,57,-314,-611,23.5,1664.2,red,2,2,24,24,red
4509706108,4,11,3,0,0,0,0,14958,6.6,16928,184,42,-5089,-4890,18.4,1495.8,11,4,7,1,0,1,1,20047,7.8,21818,243,63,5089,4890,24.3,2004.7,red,0.64,4.5,34,54,blue
4526042120,5,9,5,1,1,0,0,17006,7.2,18416,245,52,-1682,-1153,24.5,1700.6,9,5,12,0,0,0,0,18688,7.2,19569,260,47,1682,1153,26,1868.8,red,1.11,4.2,14,17,red
4526597273,11,7,14,0,0,0,0,19866,7.6,20339,202,53,3128,2919,20.2,1986.6,7,11,5,0,0,0,0,16738,6.8,17420,202,48,-3128,-2919,20.2,1673.8,blue,3.57,1.09,91,17,blue
4515829402,6,7,3,0,0,0,0,15720,6.8,17660,187,43,-1862,-1326,18.7,1572,7,6,6,1,0,1,0,17582,7.2,18986,240,52,1862,1326,24,1758.2,red,1.29,2.17,106,16,blue
4527531982,10,13,7,0,0,0,0,17938,7,18477,150,29,-1415,-1826,15,1793.8,13,10,7,0,0,0,0,19353,7.6,20303,196,60,1415,1826,19.6,1935.3,red,1.31,2,18,77,red
4522480570,7,6,6,0,0,0,0,17197,7.2,18196,238,45,1125,-141,23.8,1719.7,6,7,6,0,0,0,0,16072,7,18337,205,65,-1125,141,20.5,1607.2,red,2.17,1.71,15,38,blue
4525091372,3,7,4,0,0,0,0,14343,6.6,16877,209,39,-3049,-2220,20.9,1434.3,7,3,9,0,0,0,0,17392,7.2,19097,241,51,3049,2220,24.1,1739.2,blue,1,5.33,41,20,red
4527566867,2,6,0,0,0,0,0,14485,6.8,17588,233,64,-1422,-861,23.3,1448.5,6,2,7,1,1,0,0,15907,7,18449,235,56,1422,861,23.5,1590.7,red,0.33,6.5,23,68,red
4505373402,6,3,6,0,0,0,0,17671,7,18649,250,56,2135,1254,25,1767.1,3,6,4,1,1,0,0,15536,7,17395,231,52,-2135,-1254,23.1,1553.6,blue,4,1.17,20,63,red
4520875987,4,10,6,0,0,0,0,15430,6.8,16509,207,40,-2763,-1881,20.7,1543,10,4,13,0,0,0,0,18193,7,18390,218,47,2763,1881,21.8,1819.3,red,1,5.75,17,17,red
4519890701,3,5,3,1,0,1,0,15072,7,17479,233,52,-1247,-2320,23.3,1507.2,5,3,6,1,1,0,0,16319,7.4,19799,222,76,1247,2320,22.2,1631.9,red,1.2,3.67,15,43,blue
4524620771,1,10,1,2,1,1,0,13815,6.8,16570,219,51,-4898,-3736,21.9,1381.5,10,1,13,0,0,0,0,18713,7.4,20306,261,40,4898,3736,26.1,1871.3,red,0.2,23,15,22,red
4499835508,7,12,5,0,0,0,0,17080,7,18513,219,54,-758,-516,21.9,1708,12,7,10,1,1,0,0,17838,7.2,19029,209,64,758,516,20.9,1783.8,red,1,3.14,17,36,red
4500522425,7,2,7,1,1,0,0,17103,7,19263,221,56,2481,2112,22.1,1710.3,2,7,2,0,0,0,0,14622,7,17151,210,52,-2481,-2112,21,1462.2,blue,7,0.57,22,22,red
4523672153,10,7,10,1,1,0,0,18312,6.8,18057,239,46,1250,-226,23.9,1831.2,7,10,5,1,0,1,0,17062,6.8,18283,206,57,-1250,226,20.6,1706.2,red,2.86,1.2,22,21,blue
4521220052,7,4,2,1,1,0,0,15924,7,17965,211,45,961,1114,21.1,1592.4,4,7,3,0,0,0,0,14963,6.6,16851,199,38,-961,-1114,19.9,1496.3,blue,2.25,1,15,15,blue
4525239809,4,7,3,0,0,0,0,15122,6.8,17880,216,53,-1740,-46,21.6,1512.2,7,4,7,0,0,0,0,16862,7,17926,195,53,1740,46,19.5,1686.2,red,1,3.5,17,17,red
4520853492,11,7,14,1,0,1,0,18361,7,18709,234,43,1531,1680,23.4,1836.1,7,11,13,1,1,0,0,16830,6.8,17029,207,44,-1531,-1680,20.7,1683,red,3.57,1.82,21,14,red
4492740731,4,6,3,0,0,0,0,15888,6.8,17305,229,57,-209,-732,22.9,1588.8,6,4,8,1,1,0,0,16097,6.8,18037,232,43,209,732,23.2,1609.7,blue,1.17,3.5,31,24,blue
4500199178,5,8,6,1,0,1,0,15717,6.6,16971,196,60,-646,-960,19.6,1571.7,8,5,8,1,1,0,0,16363,6.8,17931,222,31,646,960,22.2,1636.3,red,1.38,3.2,18,19,red
4497853195,9,3,11,0,0,0,0,19153,7.4,20631,262,51,4003,2755,26.2,1915.3,3,9,3,1,1,0,0,15150,7.2,17876,225,55,-4003,-2755,22.5,1515,blue,6.67,0.67,22,20,blue
4525064823,9,6,7,1,0,1,0,17530,6.8,18078,238,48,2063,1430,23.8,1753,6,9,3,0,0,0,0,15467,6.8,16648,189,48,-2063,-1430,18.9,1546.7,blue,2.67,1,21,42,red
4527328545,10,3,9,0,0,0,0,18389,7,18618,227,64,5191,4111,22.7,1838.9,3,10,3,0,0,0,0,13198,6.2,14507,162,40,-5191,-4111,16.2,1319.8,blue,6.33,0.6,18,16,blue
4512906607,7,2,8,0,0,0,0,17381,7.2,18931,258,42,2389,892,25.8,1738.1,2,7,2,1,1,0,0,14992,7,18039,216,56,-2389,-892,21.6,1499.2,red,7.5,0.57,18,20,blue
4525207447,4,3,6,0,0,0,0,15091,7.2,18237,215,39,-1516,-441,21.5,1509.1,3,4,3,1,1,0,0,16607,7,18678,267,54,1516,441,26.7,1660.7,blue,3.33,1.5,53,23,red
4513010497,2,8,1,0,0,0,0,15097,7,18355,223,72,-2575,-982,22.3,1509.7,8,2,9,1,1,0,0,17672,7.2,19337,226,44,2575,982,22.6,1767.2,red,0.38,8.5,14,15,red
4524248019,7,3,6,1,1,0,0,16272,7,18613,232,48,1471,806,23.2,1627.2,3,7,3,0,0,0,0,14801,6.8,17807,239,45,-1471,-806,23.9,1480.1,blue,4.33,0.86,16,13,blue
4522136543,6,8,6,2,1,1,0,16618,7,17861,206,69,-702,746,20.6,1661.8,8,6,11,0,0,0,0,17320,6.4,17115,206,38,702,-746,20.6,1732,blue,1.5,3.17,14,17,red
4493204321,2,8,1,0,0,0,0,14826,6.6,16327,222,37,-1635,-1544,22.2,1482.6,8,2,12,2,1,1,0,16461,6.8,17871,210,50,1635,1544,21,1646.1,red,0.38,10,17,21,red
4520775356,11,2,8,2,1,1,0,19354,7.2,20036,251,48,5462,3677,25.1,1935.4,2,11,2,0,0,0,0,13892,6.8,16359,192,51,-5462,-3677,19.2,1389.2,blue,9.5,0.36,17,15,blue
4502578758,7,4,12,0,0,0,0,17380,6.8,18705,232,50,2615,2028,23.2,1738,4,7,3,0,0,0,0,14765,6.6,16677,181,56,-2615,-2028,18.1,1476.5,blue,4.75,1,23,17,blue
4526235126,5,3,9,0,0,0,0,16952,7.2,19223,239,52,790,83,23.9,1695.2,3,5,3,0,0,0,0,16162,7.2,19140,251,76,-790,-83,25.1,1616.2,blue,4.67,1.2,17,18,blue
4490673829,4,5,11,0,0,0,0,16316,6.6,17968,241,62,1193,1453,24.1,1631.6,5,4,5,0,0,0,0,15123,6.4,16515,208,44,-1193,-1453,20.8,1512.3,blue,3,2.5,86,17,blue
4506722541,0,8,0,0,0,0,0,13608,6.6,16690,229,52,-4785,-3229,22.9,1360.8,8,0,11,2,1,1,0,18393,7.2,19919,239,64,4785,3229,23.9,1839.3,red,0,12.65,11,14,red
4525932869,8,14,9,1,1,0,0,16227,6.6,16987,197,48,-3055,-2672,19.7,1622.7,14,8,15,0,0,0,0,19282,7.2,19659,214,44,3055,2672,21.4,1928.2,red,1.21,3.62,23,21,blue
4527350448,8,10,5,1,1,0,0,16285,6.4,16278,183,48,-1655,-1008,18.3,1628.5,10,8,9,0,0,0,0,17940,6.6,17286,189,36,1655,1008,18.9,1794,blue,1.3,2.38,22,19,blue
4527306086,15,10,19,1,1,0,0,19407,7.4,19360,217,42,1259,550,21.7,1940.7,10,15,11,0,0,0,0,18148,7,18810,193,54,-1259,-550,19.3,1814.8,blue,3.4,1.4,13,13,blue
4501239867,8,8,10,0,0,0,0,17208,7.2,18713,231,45,-737,667,23.1,1720.8,8,8,10,0,0,0,0,17945,6.8,18046,239,29,737,-667,23.9,1794.5,red,2.25,2.25,12,13,red
4527573382,2,5,1,1,0,1,0,15915,7.2,18778,245,65,-255,-545,24.5,1591.5,5,2,7,1,1,0,0,16170,7.2,19323,197,63,255,545,19.7,1617,red,0.6,6,65,16,blue
4517803168,13,6,12,0,0,0,0,19012,7.2,18944,210,54,2194,1814,21,1901.2,6,13,9,0,0,0,0,16818,6.8,17130,195,49,-2194,-1814,19.5,1681.8,blue,4.17,1.15,23,21,blue
4522201400,13,5,14,1,0,1,1,20861,7,18819,213,45,5245,2754,21.3,2086.1,5,13,7,0,0,0,0,15616,6.4,16065,195,40,-5245,-2754,19.5,1561.6,blue,5.4,0.92,21,14,blue
4524546153,5,5,5,0,0,0,0,16051,6.8,16995,235,48,-290,-1061,23.5,1605.1,5,5,7,1,1,0,0,16341,6.8,18056,245,35,290,1061,24.5,1634.1,red,2,2.4,22,23,blue
4525911356,5,3,9,1,1,0,0,16380,6.8,18331,229,46,-115,480,22.9,1638,3,5,3,1,0,1,1,16495,7,17851,225,54,115,-480,22.5,1649.5,red,4.67,1.2,20,14,red
4515536584,4,4,4,1,0,1,0,15420,6.6,16188,185,61,-634,-1526,18.5,1542,4,4,4,1,1,0,0,16054,6.8,17714,236,52,634,1526,23.6,1605.4,red,2,2,19,24,blue
4527457700,8,4,11,1,1,0,0,18320,7,18926,244,56,3461,1985,24.4,1832,4,8,2,0,0,0,0,14859,6.6,16941,217,36,-3461,-1985,21.7,1485.9,blue,4.75,0.75,17,23,blue
4522454983,6,6,5,2,1,1,0,16604,7,17994,240,56,867,420,24,1660.4,6,6,3,0,0,0,0,15737,6.8,17574,205,40,-867,-420,20.5,1573.7,blue,1.83,1.5,20,20,blue
4515845230,4,5,5,0,0,0,0,15610,7,18203,184,63,-215,155,18.4,1561,5,4,5,0,0,0,0,15825,7,18048,221,43,215,-155,22.1,1582.5,red,1.8,2.5,16,15,red
4508384732,10,5,8,0,0,0,0,17403,7,18532,181,40,1515,1112,18.1,1740.3,5,10,7,1,1,0,0,15888,7,17420,231,44,-1515,-1112,23.1,1588.8,red,3.6,1.2,17,21,blue
4521375608,7,5,7,1,1,0,0,16030,6.8,17738,180,66,-114,433,18,1603,5,7,4,0,0,0,0,16144,6.8,17305,233,40,114,-433,23.3,1614.4,blue,2.8,1.29,19,16,red
4525764211,2,6,2,0,0,0,0,14756,6.8,17221,217,50,-1942,-407,21.7,1475.6,6,2,6,1,1,0,0,16698,6.6,17628,212,69,1942,407,21.2,1669.8,red,0.67,6,11,13,red
4510122654,4,7,3,0,0,0,0,14156,6.6,16075,177,43,-3906,-2509,17.7,1415.6,7,4,7,0,0,0,1,18062,7.2,18584,233,48,3906,2509,23.3,1806.2,red,1,3.5,15,13,red
4525297517,7,8,7,0,0,0,0,16927,6.8,17042,223,42,-498,-861,22.3,1692.7,8,7,7,0,0,0,0,17425,7,17903,228,51,498,861,22.8,1742.5,red,1.75,2.14,22,24,blue
4512606539,7,3,11,1,1,0,0,17365,6.8,17243,223,56,2208,-313,22.3,1736.5,3,7,6,0,0,0,0,15157,6.8,17556,192,56,-2208,313,19.2,1515.7,blue,6,1.29,18,15,blue
4513373886,4,5,2,0,0,0,0,15226,6.8,17774,168,67,-1667,-654,16.8,1522.6,5,4,6,0,0,0,0,16893,6.8,18428,227,55,1667,654,22.7,1689.3,blue,1.2,2.75,18,16,blue
4519670030,8,7,7,0,0,0,0,17123,6.8,17730,190,51,1110,974,19,1712.3,7,8,9,1,1,0,0,16013,6.8,16756,161,52,-1110,-974,16.1,1601.3,red,2.14,2,20,19,red
4518966647,3,7,2,1,1,0,0,14663,6.8,17795,206,59,-1984,-715,20.6,1466.3,7,3,9,0,0,0,0,16647,7,18510,205,52,1984,715,20.5,1664.7,red,0.71,5.33,14,14,red
4521831054,9,6,8,1,0,1,0,17897,7.2,19344,217,53,1692,1998,21.7,1789.7,6,9,8,1,1,0,0,16205,7,17346,206,44,-1692,-1998,20.6,1620.5,red,2.83,1.56,48,15,blue
4508674756,2,11,2,0,0,0,0,13418,5.8,13877,175,32,-5710,-4952,17.5,1341.8,11,2,15,2,1,1,0,19128,7.2,18829,213,63,5710,4952,21.3,1912.8,red,0.36,13,19,95,red
4513116527,6,6,7,1,0,1,0,15928,6.8,17872,195,43,806,371,19.5,1592.8,6,6,7,1,1,0,0,15122,6.8,17501,200,44,-806,-371,20,1512.2,red,2.17,2.17,21,18,red
4506388090,3,12,2,1,0,1,0,15111,6.8,17710,210,68,-3620,-2690,21,1511.1,12,3,9,1,1,0,0,18731,7.2,20400,236,45,3620,2690,23.6,1873.1,red,0.42,7,17,21,red
4514404370,8,2,8,0,0,0,0,17101,7,18836,237,45,3056,1805,23.7,1710.1,2,8,2,0,0,0,0,14045,6.6,17031,194,48,-3056,-1805,19.4,1404.5,blue,8,0.5,21,18,blue
4520391228,8,5,10,1,1,0,0,17194,7.2,19279,200,71,2562,3016,20,1719.4,5,8,4,0,0,0,0,14632,6.4,16263,184,44,-2562,-3016,18.4,1463.2,blue,3.6,1.12,39,17,red
4522035012,6,5,2,1,0,1,0,16565,7,17877,214,51,824,521,21.4,1656.5,5,6,2,1,1,0,0,15741,6.8,17356,212,45,-824,-521,21.2,1574.1,blue,1.6,1.17,20,19,blue
4502034096,8,10,10,1,1,0,0,16943,6.8,17157,208,37,-1074,-1632,20.8,1694.3,10,8,10,1,0,1,0,18017,7,18789,229,56,1074,1632,22.9,1801.7,red,1.8,2.5,22,145,red
4520842972,7,4,8,1,1,0,0,17568,7.2,19108,241,56,1975,802,24.1,1756.8,4,7,5,0,0,0,0,15593,7,18306,229,48,-1975,-802,22.9,1559.3,blue,3.75,1.29,15,17,blue
4527513607,6,8,10,0,0,0,0,17250,7.2,18763,206,60,86,467,20.6,1725,8,6,9,2,1,1,0,17164,7,18296,197,60,-86,-467,19.7,1716.4,red,2,2.83,31,67,red
4507100108,4,2,5,1,0,1,0,16559,7,17552,216,52,1928,257,21.6,1655.9,2,4,1,1,1,0,0,14631,6.6,17295,248,48,-1928,-257,24.8,1463.1,blue,4.5,0.75,20,17,blue
4500906460,1,3,0,0,0,0,0,14351,6.6,17173,218,60,-982,-1614,21.8,1435.1,3,1,2,1,1,0,0,15333,7.4,18787,219,48,982,1614,21.9,1533.3,red,0.33,5,15,19,red
4519464273,2,5,4,0,0,0,0,14735,6.6,16525,236,40,-1751,-2530,23.6,1473.5,5,2,6,0,0,0,0,16486,7,19055,223,68,1751,2530,22.3,1648.6,red,1.2,5.5,32,36,blue
4495208776,9,1,17,2,1,1,0,18070,7.2,19270,235,55,3828,2447,23.5,1807,1,9,0,0,0,0,0,14242,6.6,16823,214,68,-3828,-2447,21.4,1424.2,blue,26,0.11,19,17,blue
4494851448,4,3,5,1,1,0,0,15449,6.8,17026,206,52,423,-315,20.6,1544.9,3,4,1,0,0,0,0,15026,6.6,17341,254,44,-423,315,25.4,1502.6,red,3,1,23,21,blue
4526207203,8,5,6,0,0,0,0,17581,7,18639,243,45,1839,312,24.3,1758.1,5,8,2,1,1,0,0,15742,7.2,18327,221,45,-1839,-312,22.1,1574.2,blue,2.8,0.88,28,123,blue
4507088738,4,6,3,1,0,1,0,15505,6.8,18109,215,40,-875,-363,21.5,1550.5,6,4,4,1,1,0,0,16380,7.2,18472,232,48,875,363,23.2,1638,red,1.17,2.5,41,16,red
4527233294,8,8,12,0,0,0,0,16873,6.8,17879,215,45,375,296,21.5,1687.3,8,8,14,1,1,0,0,16498,7,17583,202,40,-375,-296,20.2,1649.8,blue,2.5,2.75,26,41,blue
4518611921,4,10,7,0,0,0,0,14755,6.2,15569,213,39,-4095,-1033,21.3,1475.5,10,4,19,1,1,0,0,18850,6.6,16602,199,56,4095,1033,19.9,1885,red,1.1,7.25,52,15,red
4510212768,10,6,11,0,0,0,0,18081,7,18813,207,63,2273,1714,20.7,1808.1,6,10,10,0,0,0,0,15808,6.8,17099,220,41,-2273,-1714,22,1580.8,blue,3.5,1.6,17,14,blue
4527098797,5,9,7,0,0,0,0,15791,7,17342,192,57,-1892,-580,19.2,1579.1,9,5,12,0,0,0,0,17683,7.2,17922,205,40,1892,580,20.5,1768.3,blue,1.33,4.2,87,12,red
4522145954,1,6,0,1,1,0,0,13480,6.4,16396,215,52,-3137,-2097,21.5,1348,6,1,10,0,0,0,0,16617,7,18493,233,49,3137,2097,23.3,1661.7,red,0.17,16,14,23,red
4519316312,8,7,10,0,0,0,0,17946,7.2,18778,204,48,2401,727,20.4,1794.6,7,8,5,0,0,0,0,15545,6.8,18051,187,51,-2401,-727,18.7,1554.5,blue,2.57,1.5,14,15,blue
4523556041,10,10,10,1,1,0,0,17754,7,18278,195,52,292,1026,19.5,1775.4,10,10,12,1,0,1,0,17462,6.8,17252,190,40,-292,-1026,19,1746.2,blue,2,2.2,19,124,red
4516727076,4,9,3,0,0,0,0,16172,6.8,17632,221,48,-1460,-1134,22.1,1617.2,9,4,15,1,1,0,0,17632,7.2,18766,223,56,1460,1134,22.3,1763.2,blue,0.78,6,15,16,red
4526702861,2,2,0,0,0,0,0,14828,7.2,18414,237,68,-507,343,23.7,1482.8,2,2,3,1,1,0,0,15335,7,18071,260,40,507,-343,26,1533.5,red,1,2.5,16,17,blue
4516522462,7,10,5,0,0,0,0,16589,7,18188,188,57,-3242,-950,18.8,1658.9,10,7,11,1,1,0,1,19831,7.2,19138,253,54,3242,950,25.3,1983.1,blue,1.2,3,18,17,red
4526645317,3,7,5,0,0,0,0,15521,7,17703,210,63,-1079,233,21,1552.1,7,3,14,1,1,0,0,16600,7,17470,215,44,1079,-233,21.5,1660,blue,1.14,7,14,49,red
4522288723,6,3,9,1,1,0,0,16198,6.8,17866,226,44,1873,1987,22.6,1619.8,3,6,4,0,0,0,0,14325,6.4,15879,179,44,-1873,-1987,17.9,1432.5,blue,5,1.17,20,20,blue
4514518973,1,10,1,0,0,0,0,13125,6.2,15273,167,59,-4596,-2815,16.7,1312.5,10,1,11,1,1,0,0,17721,7.2,18088,243,46,4596,2815,24.3,1772.1,red,0.2,21,42,22,red
4499735549,7,3,10,1,1,0,0,16065,6.8,17018,200,53,1322,148,20,1606.5,3,7,2,0,0,0,0,14743,6.6,16870,213,35,-1322,-148,21.3,1474.3,blue,5.67,0.71,34,45,red
4506389635,6,7,5,0,0,0,0,16940,7.2,17909,246,38,566,-57,24.6,1694,7,6,11,0,0,0,0,16374,7.2,17966,219,37,-566,57,21.9,1637.4,blue,1.57,3,18,20,blue
4526832449,7,9,9,1,0,1,1,17655,6.4,16585,203,52,-134,-1518,20.3,1765.5,9,7,16,1,1,0,0,17789,7,18103,217,53,134,1518,21.7,1778.9,red,1.78,3.57,18,18,blue
4513221186,8,6,9,1,1,0,0,16707,6.8,17380,193,44,-724,1250,19.3,1670.7,6,8,7,0,0,0,1,17431,6.4,16130,216,36,724,-1250,21.6,1743.1,red,2.83,1.62,14,21,blue
4517507679,6,11,5,0,0,0,0,15214,7,17796,171,48,-3709,-1635,17.1,1521.4,11,6,10,0,0,0,0,18923,7.2,19431,228,40,3709,1635,22.8,1892.3,red,1,3.5,87,19,red
4522494083,12,5,13,0,0,0,0,19835,7.4,19690,223,48,4675,3054,22.3,1983.5,5,12,5,1,1,0,0,15160,6.8,16636,169,48,-4675,-3054,16.9,1516,blue,5,0.83,18,15,blue
4525366511,1,3,3,0,0,0,0,14289,6.8,17513,246,41,-1222,-874,24.6,1428.9,3,1,3,2,1,1,0,15511,6.8,18387,248,60,1222,874,24.8,1551.1,blue,1.33,6,20,15,red
4513275057,8,2,8,1,1,0,0,16846,7.4,19790,224,54,2487,1963,22.4,1684.6,2,8,1,0,0,0,0,14359,6.8,17827,223,48,-2487,-1963,22.3,1435.9,red,8,0.38,26,29,blue
4526260032,6,12,3,1,0,1,0,15488,6.8,17274,196,60,-4858,-1631,19.6,1548.8,12,6,15,1,1,0,1,20346,6.8,18905,214,70,4858,1631,21.4,2034.6,red,0.75,4.5,17,24,red
4514274413,7,10,8,0,0,0,0,16855,6.8,17721,218,62,-1678,-959,21.8,1685.5,10,7,14,1,1,0,0,18533,7,18680,232,48,1678,959,23.2,1853.3,blue,1.5,3.43,18,15,blue
4522086611,5,5,4,1,1,0,0,16660,7,19188,217,55,785,1439,21.7,1666,5,5,6,0,0,0,0,15875,6.8,17749,200,48,-785,-1439,20,1587.5,blue,1.8,2.2,19,20,red
4509576274,10,5,9,1,1,0,0,18611,7.6,20169,225,68,2819,3222,22.5,1861.1,5,10,6,0,0,0,0,15792,6.8,16947,211,49,-2819,-3222,21.1,1579.2,red,3.8,1.1,15,19,blue
4525144811,8,8,5,1,0,1,0,18233,7.4,19767,256,56,363,-533,25.6,1823.3,8,8,13,1,1,0,0,17870,7.6,20300,239,52,-363,533,23.9,1787,red,1.62,2.62,17,80,red
4516186940,6,5,10,1,0,1,0,16616,6.6,17450,215,56,930,2011,21.5,1661.6,5,6,7,0,0,0,0,15686,6.2,15439,168,60,-930,-2011,16.8,1568.6,red,3.2,2,40,15,blue
4509107682,6,7,8,0,0,0,0,16107,7.2,17763,231,39,-621,-23,23.1,1610.7,7,6,9,1,1,0,0,16728,6.8,17786,216,43,621,23,21.6,1672.8,blue,2,2.67,19,21,red
4527063486,7,5,12,0,0,0,0,16674,6.8,17188,204,47,111,-199,20.4,1667.4,5,7,5,2,1,1,0,16563,7,17387,221,48,-111,199,22.1,1656.3,blue,3.8,1.43,30,24,blue
4519284907,7,2,12,1,1,0,0,16671,6.8,17285,216,48,2644,1400,21.6,1667.1,2,7,1,1,0,1,0,14027,6.4,15885,228,52,-2644,-1400,22.8,1402.7,blue,9.5,0.43,19,19,blue
4514329925,9,6,6,1,1,0,0,17261,7,18577,219,56,1704,2023,21.9,1726.1,6,9,8,0,0,0,0,15557,6.6,16554,182,42,-1704,-2023,18.2,1555.7,blue,2.5,1.56,19,16,red
4527297210,6,2,4,2,1,1,0,16886,7.2,18724,242,64,2881,2005,24.2,1688.6,2,6,2,0,0,0,0,14005,6.8,16719,186,48,-2881,-2005,18.6,1400.5,blue,5,0.67,16,142,red
4527454309,10,7,7,2,1,1,0,18226,7.2,18871,211,53,1063,1153,21.1,1822.6,7,10,8,0,0,0,0,17163,7,17718,229,52,-1063,-1153,22.9,1716.3,red,2.43,1.5,62,25,blue
4513780081,11,6,13,1,1,0,0,18136,7,18077,194,55,649,343,19.4,1813.6,6,11,8,0,0,0,0,17487,7,17734,239,44,-649,-343,23.9,1748.7,blue,4,1.27,18,18,blue
4510137231,1,0,0,1,0,1,0,14712,7,17631,253,62,-132,-1473,25.3,1471.2,0,1,0,1,1,0,0,14844,7,19104,264,68,132,1473,26.4,1484.4,red,12.03,0,16,14,blue
4521185772,7,8,4,1,0,1,0,16420,7,18391,224,49,-1250,-1034,22.4,1642,8,7,6,1,1,0,0,17670,7.2,19425,239,55,1250,1034,23.9,1767,blue,1.38,2,17,19,blue
4527007820,9,10,9,0,0,0,0,17678,6.8,17263,190,40,-1213,848,19,1767.8,10,9,19,1,1,0,1,18891,6.6,16415,182,37,1213,-848,18.2,1889.1,blue,1.8,3.22,19,18,red
4519672552,9,7,10,0,0,0,0,17126,6.8,17604,195,52,1386,679,19.5,1712.6,7,9,4,1,1,0,0,15740,6.6,16925,202,48,-1386,-679,20.2,1574,red,2.71,1.22,32,20,red
4515454034,4,14,4,0,0,0,0,15001,6.6,16275,205,37,-5120,-4011,20.5,1500.1,14,4,16,1,0,1,0,20121,7.4,20286,233,64,5120,4011,23.3,2012.1,red,0.57,7.5,19,49,red
4519982625,4,6,2,0,0,0,0,15416,7.2,18403,214,51,-2219,-677,21.4,1541.6,6,4,7,2,1,1,0,17635,7.2,19080,237,56,2219,677,23.7,1763.5,red,1,3.25,17,18,blue
4508717293,5,8,3,0,0,0,0,15177,6.6,16094,206,33,-2399,-2317,20.6,1517.7,8,5,7,1,1,0,0,17576,7,18411,243,47,2399,2317,24.3,1757.6,red,1,3,21,18,blue
4501146183,4,4,2,0,0,0,0,15853,6.8,18455,229,64,20,-1382,22.9,1585.3,4,4,3,1,1,0,0,15833,7.4,19837,232,69,-20,1382,23.2,1583.3,red,1.5,1.75,14,20,blue
4518072555,8,5,10,1,1,0,0,17513,7,18498,234,44,834,861,23.4,1751.3,5,8,7,0,0,0,0,16679,6.8,17637,215,60,-834,-861,21.5,1667.9,red,3.6,1.5,21,27,red
4511479972,8,8,9,0,0,0,0,16345,7,17692,206,43,-1208,-213,20.6,1634.5,8,8,9,2,1,1,0,17553,7,17905,223,56,1208,213,22.3,1755.3,red,2.12,2.12,21,23,red
4520301016,5,9,6,0,0,0,0,14826,6.8,16490,176,40,-2907,-3389,17.6,1482.6,9,5,2,1,1,0,0,17733,7.4,19879,229,65,2907,3389,22.9,1773.3,red,1.22,2.2,24,38,red
4492410898,7,6,7,0,0,0,0,16440,6.8,17181,197,37,-635,-1449,19.7,1644,6,7,8,1,1,0,0,17075,7,18630,246,49,635,1449,24.6,1707.5,red,2.33,2,18,16,blue
4525558466,4,3,4,1,1,0,0,16571,7.2,18893,258,52,1749,1270,25.8,1657.1,3,4,3,0,0,0,0,14822,6.6,17623,232,49,-1749,-1270,23.2,1482.2,blue,2.67,1.5,21,23,blue
4516194928,4,10,10,0,0,0,0,15928,6.8,17242,204,56,-2760,-1949,20.4,1592.8,10,4,13,1,1,0,0,18688,7.2,19191,233,55,2760,1949,23.3,1868.8,red,1.4,5.75,20,15,red
4517932062,7,10,11,1,0,1,0,17759,7.2,18043,246,36,-695,-2159,24.6,1775.9,10,7,6,0,0,0,0,18454,7.4,20202,214,64,695,2159,21.4,1845.4,red,1.8,2.29,19,16,blue
4527289759,2,4,1,0,0,0,0,13995,7,17605,176,71,-1171,-854,17.6,1399.5,4,2,6,1,1,0,0,15166,7,18459,218,64,1171,854,21.8,1516.6,blue,0.75,5,20,56,red
4500388564,5,8,5,1,0,1,0,16607,7,17949,223,68,-1001,-543,22.3,1660.7,8,5,10,1,1,0,0,17608,7,18492,229,41,1001,543,22.9,1760.8,blue,1.25,3.6,20,56,blue
4509560405,19,4,22,1,1,0,0,22173,7.4,20408,234,45,7154,6032,23.4,2217.3,4,19,5,1,0,1,0,15019,6,14376,189,38,-7154,-6032,18.9,1501.9,blue,10.25,0.47,15,12,red
4506470828,3,7,1,0,0,0,0,14114,6.8,17331,215,36,-3063,-2014,21.5,1411.4,7,3,12,1,1,0,0,17177,7.4,19345,227,60,3063,2014,22.7,1717.7,red,0.57,6.33,19,24,red
4506730764,6,3,4,2,1,1,1,18704,7.6,20796,260,67,3917,2196,26,1870.4,3,6,1,0,0,0,0,14787,7,18600,216,60,-3917,-2196,21.6,1478.7,blue,3.33,0.67,96,39,red
4522252043,6,3,8,0,0,0,0,18236,7.2,19626,234,76,3586,3431,23.4,1823.6,3,6,4,0,0,0,0,14650,6.6,16195,221,47,-3586,-3431,22.1,1465,blue,4.67,1.17,13,14,blue
4511683858,5,7,4,0,0,0,0,15437,7,17811,195,68,-2205,-1308,19.5,1543.7,7,5,6,1,1,0,0,17642,7.2,19119,270,40,2205,1308,27,1764.2,red,1.29,2.6,22,21,red
4514830749,7,10,7,1,1,0,0,15842,6.6,17223,216,35,-3572,-1330,21.6,1584.2,10,7,10,0,0,0,1,19414,7,18553,225,36,3572,1330,22.5,1941.4,red,1.4,2.86,21,26,red
4522438327,4,4,5,1,1,0,0,16476,6.6,17137,225,50,896,-140,22.5,1647.6,4,4,1,1,0,1,0,15580,6.8,17277,227,54,-896,140,22.7,1558,blue,2.25,1.25,38,18,red
4526683512,8,7,9,1,0,1,0,17075,7,17360,198,49,399,-182,19.8,1707.5,7,8,6,1,1,0,0,16676,7,17542,219,65,-399,182,21.9,1667.6,blue,2.43,1.62,21,17,red
4525780580,10,5,6,1,1,0,0,18327,7.2,18553,219,62,2980,1865,21.9,1832.7,5,10,3,0,0,0,0,15347,6.8,16688,233,43,-2980,-1865,23.3,1534.7,blue,3.2,0.8,110,13,blue
4526035454,5,8,6,0,0,0,0,15432,7,17869,225,46,-2228,-745,22.5,1543.2,8,5,8,1,1,0,0,17660,7,18614,247,56,2228,745,24.7,1766,red,1.38,3.2,19,19,red
4524141985,2,3,3,0,0,0,0,14510,6.8,17801,247,36,-1456,-251,24.7,1451,3,2,5,2,1,1,0,15966,7,18052,252,56,1456,251,25.2,1596.6,red,1.67,4,20,82,red
4527381514,2,8,1,1,1,0,0,14426,6.6,17051,210,60,-2709,-1468,21,1442.6,8,2,9,0,0,0,0,17135,7,18519,239,48,2709,1468,23.9,1713.5,red,0.38,8.5,18,16,red
4511994182,11,5,9,1,1,0,1,19632,7,18732,222,60,4648,2498,22.2,1963.2,5,11,7,0,0,0,0,14984,6.4,16234,181,37,-4648,-2498,18.1,1498.4,blue,4,1.09,15,12,red
4502131494,9,8,17,1,1,0,0,17923,7,17698,189,54,-37,-100,18.9,1792.3,8,9,9,0,0,0,0,17960,7,17798,202,60,37,100,20.2,1796,blue,3.25,1.89,14,15,red
4493017629,4,4,3,0,0,0,0,16297,6.8,17730,237,62,1772,1255,23.7,1629.7,4,4,4,0,0,0,0,14525,6.6,16475,202,36,-1772,-1255,20.2,1452.5,blue,1.75,2,24,18,blue
4499811143,9,3,9,0,0,0,1,20026,7.2,19142,246,51,6773,5215,24.6,2002.6,3,9,4,1,1,0,0,13253,6.2,13927,148,32,-6773,-5215,14.8,1325.3,blue,6,0.78,15,84,blue
4525832836,5,4,3,1,1,0,0,15926,6.6,16415,247,48,-299,-1889,24.7,1592.6,4,5,4,0,0,0,0,16225,7,18304,230,49,299,1889,23,1622.5,red,2,1.6,21,38,blue
4526363486,4,8,5,1,1,0,0,15579,6.8,18054,203,67,-2227,-1077,20.3,1557.9,8,4,6,1,0,1,0,17806,7.2,19131,254,53,2227,1077,25.4,1780.6,blue,1.12,3.5,23,19,red
4527216964,3,7,4,0,0,0,0,15270,7,18043,235,55,-1429,1040,23.5,1527,7,3,8,0,0,0,0,16699,6.4,17003,204,39,1429,-1040,20.4,1669.9,blue,1,5,41,90,red
4516583288,4,10,4,1,1,0,0,15994,7,18031,229,64,-2519,-1610,22.9,1599.4,10,4,15,0,0,0,0,18513,7.2,19641,238,39,2519,1610,23.8,1851.3,red,0.8,6.25,14,19,red
4516987544,3,3,3,0,0,0,0,16064,7.2,18651,247,56,1117,472,24.7,1606.4,3,3,0,2,1,1,0,14947,6.8,18179,229,54,-1117,-472,22.9,1494.7,red,2,1,16,19,blue
4498628249,8,8,12,1,1,0,0,16796,6.6,16424,185,48,700,1221,18.5,1679.6,8,8,14,0,0,0,0,16096,6.2,15203,175,28,-700,-1221,17.5,1609.6,blue,2.5,2.75,24,18,blue
4526211011,5,7,4,0,0,0,0,15553,6.6,15768,203,40,-977,-2180,20.3,1555.3,7,5,5,2,1,1,0,16530,7,17948,222,54,977,2180,22.2,1653,blue,1.29,2.4,16,17,red
4519844480,4,17,4,0,0,0,0,14838,6,15075,180,44,-6265,-3518,18,1483.8,17,4,24,1,0,1,0,21103,7,18593,194,28,6265,3518,19.4,2110.3,red,0.47,10.25,41,27,red
4518050280,4,4,4,0,0,0,0,15506,6.6,17801,229,50,-154,663,22.9,1550.6,4,4,7,1,1,0,0,15660,6.6,17138,222,44,154,-663,22.2,1566,blue,2,2.75,21,21,red
4526670419,6,10,3,0,0,0,0,16531,7.4,19310,226,59,-1114,-398,22.6,1653.1,10,6,10,1,1,0,0,17645,7.4,19708,199,58,1114,398,19.9,1764.5,red,0.9,3.33,44,40,red
4522402589,7,12,9,0,0,0,0,16000,6.4,16324,190,44,-2111,-2875,19,1600,12,7,11,0,0,0,0,18111,7.2,19199,221,51,2111,2875,22.1,1811.1,red,1.33,3.29,17,20,blue
4514530513,6,11,5,0,0,0,0,16281,6.8,17569,209,53,-2082,-2125,20.9,1628.1,11,6,9,1,1,0,0,18363,7.4,19694,206,64,2082,2125,20.6,1836.3,red,1,3.33,13,14,red
4515527717,7,8,7,1,1,0,0,17442,6.8,17426,236,36,153,-519,23.6,1744.2,8,7,8,0,0,0,0,17289,6.8,17945,226,48,-153,519,22.6,1728.9,blue,1.75,2.29,19,21,blue
4519862589,10,6,12,1,0,1,0,18692,7.4,19767,248,48,2830,1589,24.8,1869.2,6,10,4,0,0,0,0,15862,6.8,18178,210,39,-2830,-1589,21,1586.2,blue,3.67,1,18,14,blue
4519645138,5,6,4,1,1,0,0,17028,7,18519,235,60,1761,2297,23.5,1702.8,6,5,9,1,0,1,0,15267,6.6,16222,177,36,-1761,-2297,17.7,1526.7,blue,1.5,3,20,20,red
4513383518,0,3,0,1,1,0,0,13787,6.8,17848,225,52,-2153,-1344,22.5,1378.7,3,0,3,0,0,0,0,15940,7.2,19192,237,56,2153,1344,23.7,1594,red,0,12.65,55,18,red
4526291828,5,2,3,2,1,1,0,17956,7,18251,271,50,4594,2745,27.1,1795.6,2,5,6,0,0,0,0,13362,6.4,15506,187,33,-4594,-2745,18.7,1336.2,blue,4,1.6,17,21,red
4527018824,2,5,6,1,1,0,0,15476,6.8,17429,237,64,-781,-1559,23.7,1547.6,5,2,3,1,0,1,0,16257,7.2,18988,227,48,781,1559,22.7,1625.7,red,1.6,4,23,23,red
4520629363,4,4,3,2,1,1,0,15875,6.8,18309,234,65,455,1305,23.4,1587.5,4,4,6,0,0,0,0,15420,6.4,17004,233,42,-455,-1305,23.3,1542,blue,1.75,2.5,18,19,red
4506971085,8,9,9,2,1,1,0,17030,6.8,17359,206,43,-493,-986,20.6,1703,9,8,13,0,0,0,0,17523,7.2,18345,186,44,493,986,18.6,1752.3,blue,1.89,2.75,17,19,blue
4521155877,3,6,1,0,0,0,0,14719,6.6,16759,214,43,-2418,-2255,21.4,1471.9,6,3,7,0,0,0,0,17137,7,19014,240,64,2418,2255,24,1713.7,red,0.67,4.33,22,39,red
4523110443,7,4,8,1,0,1,1,17617,6.6,17519,199,47,241,307,19.9,1761.7,4,7,7,1,1,0,1,17376,6.6,17212,214,58,-241,-307,21.4,1737.6,blue,3.75,1.57,24,28,red
4467610572,5,4,6,1,0,1,0,16457,7,18669,229,60,1023,1754,22.9,1645.7,4,5,7,0,0,0,0,15434,6.6,16915,219,53,-1023,-1754,21.9,1543.4,red,2.75,2.2,19,21,blue
4509643983,5,6,9,0,0,0,0,15885,6.6,16674,203,40,-75,-1566,20.3,1588.5,6,5,1,2,1,1,0,15960,7,18240,211,68,75,1566,21.1,1596,red,2.33,1.4,19,16,blue
4493059433,10,4,10,1,0,1,1,19107,7.4,20103,230,56,3799,2856,23,1910.7,4,10,3,0,0,0,0,15308,6.8,17247,210,56,-3799,-2856,21,1530.8,blue,5,0.7,14,13,blue
4527471301,7,4,10,0,0,0,0,16507,6.4,16273,212,42,1114,-1294,21.2,1650.7,4,7,5,0,0,0,0,15393,6.8,17567,221,55,-1114,1294,22.1,1539.3,blue,4.25,1.29,27,22,red
4507115446,6,4,11,1,1,0,0,16538,7.2,18707,235,55,1585,1348,23.5,1653.8,4,6,4,0,0,0,0,14953,6.6,17359,189,44,-1585,-1348,18.9,1495.3,blue,4.25,1.33,22,17,red
4515526880,3,10,3,0,0,0,0,15067,6.6,15937,186,39,-2968,-3336,18.6,1506.7,10,3,11,1,1,0,0,18035,7.4,19273,214,57,2968,3336,21.4,1803.5,red,0.6,7,36,22,red
4505276282,7,13,11,0,0,0,0,16571,6.4,15773,178,44,-1624,-3004,17.8,1657.1,13,7,15,0,0,0,0,18195,7.2,18777,207,32,1624,3004,20.7,1819.5,red,1.38,4,16,23,blue
4526464882,5,8,6,0,0,0,0,16530,7.4,19242,231,51,-1347,-1433,23.1,1653,8,5,6,1,1,0,0,17877,7.6,20675,231,79,1347,1433,23.1,1787.7,red,1.38,2.8,42,28,red
4509303236,6,6,9,1,1,0,0,16239,7,18439,203,52,36,-234,20.3,1623.9,6,6,3,0,0,0,0,16203,7.2,18673,224,50,-36,234,22.4,1620.3,blue,2.5,1.5,15,22,red
4502663674,6,4,7,0,0,0,0,16624,6.8,18473,208,52,115,-256,20.8,1662.4,4,6,6,2,1,1,0,16509,7,18729,239,68,-115,256,23.9,1650.9,red,3.25,1.67,18,19,blue
4508966614,7,11,7,1,1,0,0,15890,6.4,16536,201,39,-3280,-2301,20.1,1589,11,7,14,1,0,1,0,19170,7.4,18837,223,47,3280,2301,22.3,1917,red,1.27,3.57,24,24,red
4521617459,13,4,23,0,0,0,0,18957,7.4,19663,222,68,2842,1659,22.2,1895.7,4,13,7,1,1,0,0,16115,6.8,18004,238,64,-2842,-1659,23.8,1611.5,blue,9,0.85,17,18,blue
4502847673,11,5,10,1,1,0,0,18307,7.2,19247,228,54,3223,2804,22.8,1830.7,5,11,3,0,0,0,0,15084,6.6,16443,198,40,-3223,-2804,19.8,1508.4,blue,4.2,0.73,23,16,red
4505820252,2,3,2,2,1,1,0,16394,7.4,20016,264,85,1447,1753,26.4,1639.4,3,2,1,0,0,0,0,14947,6.8,18263,227,54,-1447,-1753,22.7,1494.7,blue,1.33,2,15,16,red
4512913820,3,12,3,1,0,1,0,15096,6.2,15306,212,50,-2483,-1696,21.2,1509.6,12,3,16,1,1,0,0,17579,6.6,17002,144,41,2483,1696,14.4,1757.9,blue,0.5,9.33,49,34,red
4522857741,3,3,5,1,1,0,0,15200,6.8,17127,230,56,662,33,23,1520,3,3,3,0,0,0,0,14538,6.6,17094,202,47,-662,-33,20.2,1453.8,blue,2.67,2,22,19,blue
4523494411,3,5,3,1,1,0,0,14684,6.8,16985,217,49,-2212,-1666,21.7,1468.4,5,3,4,0,0,0,0,16896,7.2,18651,258,57,2212,1666,25.8,1689.6,blue,1.2,3,28,38,red
4520806066,8,8,7,1,1,0,0,16228,6.6,16387,194,44,-412,22,19.4,1622.8,8,8,9,0,0,0,0,16640,6.6,16365,208,51,412,-22,20.8,1664,blue,1.88,2.12,13,16,blue
4526502680,9,7,10,1,1,0,0,18101,7.2,19775,213,74,1645,1489,21.3,1810.1,7,9,5,0,0,0,0,16456,6.8,18286,187,47,-1645,-1489,18.7,1645.6,blue,2.71,1.33,14,17,blue
4517814495,14,3,15,1,0,1,1,21055,7.2,19573,219,52,6744,5355,21.9,2105.5,3,14,3,1,1,0,0,14311,6,14218,166,53,-6744,-5355,16.6,1431.1,red,9.67,0.43,18,19,blue
4525934339,4,5,2,0,0,0,0,13933,6.4,16078,199,39,-2215,-1879,19.9,1393.3,5,4,6,2,1,1,0,16148,6.8,17957,212,48,2215,1879,21.2,1614.8,red,1.2,2.75,16,18,blue
4523577373,11,7,13,1,0,1,0,19497,7.2,18445,221,55,3611,2847,22.1,1949.7,7,11,9,0,0,0,0,15886,6.4,15598,165,40,-3611,-2847,16.5,1588.6,blue,3.43,1.45,18,15,blue
4513101725,3,4,1,0,0,0,0,15236,7.2,18474,236,41,-297,548,23.6,1523.6,4,3,4,1,1,0,0,15533,7,17926,205,54,297,-548,20.5,1553.3,blue,1,2.67,18,17,red
4525230162,5,3,5,1,1,0,0,16700,7.2,18574,242,52,1928,1297,24.2,1670,3,5,1,0,0,0,0,14772,6.6,17277,243,47,-1928,-1297,24.3,1477.2,red,3.33,0.8,20,18,blue
4519287844,5,1,11,2,1,1,0,16506,7,17981,213,52,2663,864,21.3,1650.6,1,5,0,0,0,0,0,13843,6.6,17117,224,46,-2663,-864,22.4,1384.3,blue,16,0.2,40,18,blue
4523260482,7,4,11,1,1,0,0,16482,6.6,16880,222,46,1086,756,22.2,1648.2,4,7,6,0,0,0,0,15396,6.4,16124,212,58,-1086,-756,21.2,1539.6,blue,4.5,1.43,44,25,blue
4525320313,3,4,2,0,0,0,0,15694,7,17920,241,48,764,-29,24.1,1569.4,4,3,1,1,1,0,0,14930,7,17949,221,47,-764,29,22.1,1493,blue,1.25,1.67,20,20,red
4500173548,7,8,9,1,0,1,0,16276,7,17562,195,40,-1216,-629,19.5,1627.6,8,7,10,0,0,0,0,17492,7,18191,210,76,1216,629,21,1749.2,blue,2,2.57,21,19,blue
4508846278,12,14,14,1,0,1,0,18331,7,18445,181,52,-1572,-208,18.1,1833.1,14,12,17,1,1,0,0,19903,7,18653,228,40,1572,208,22.8,1990.3,red,1.86,2.58,30,17,red
4495426871,9,3,10,1,1,0,0,17347,7,18131,230,51,2547,1386,23,1734.7,3,9,7,0,0,0,0,14800,6.6,16745,208,60,-2547,-1386,20.8,1480,blue,6.33,1.11,13,16,blue
4527204318,0,9,0,0,0,0,0,15090,7,18031,238,65,-1931,-299,23.8,1509,9,0,13,1,1,0,0,17021,7.2,18330,220,44,1931,299,22,1702.1,red,0,12.65,21,52,red
4527545380,10,8,17,1,0,1,0,17799,7,18078,190,40,-333,-359,19,1779.9,8,10,7,1,1,0,0,18132,7.2,18437,241,59,333,359,24.1,1813.2,blue,3.38,1.5,17,19,blue
4497717907,4,8,6,0,0,0,0,15694,6.6,16853,202,59,-3531,-2649,20.2,1569.4,8,4,8,1,1,0,1,19225,7.2,19502,265,40,3531,2649,26.5,1922.5,red,1.25,4,19,10,blue
4521559243,7,0,8,0,0,0,0,17269,7.2,19988,244,52,3425,3823,24.4,1726.9,0,7,0,1,1,0,0,13844,6.6,16165,228,52,-3425,-3823,22.8,1384.4,blue,12.03,0,14,17,blue
4527661727,6,6,3,1,1,0,0,16662,7,18914,237,48,619,35,23.7,1666.2,6,6,7,0,0,0,0,16043,7.2,18879,212,48,-619,-35,21.2,1604.3,blue,1.5,2.17,27,25,red
4526793578,5,9,4,0,0,0,0,17292,7,18087,238,63,-689,-266,23.8,1729.2,9,5,18,1,1,0,0,17981,7,18353,214,44,689,266,21.4,1798.1,red,1,5.4,15,14,blue
4516541266,2,5,4,1,0,1,0,14772,6.8,17784,214,59,-2395,-2173,21.4,1477.2,5,2,5,1,1,0,0,17167,7.4,19957,258,68,2395,2173,25.8,1716.7,red,1.2,5,52,17,red
4518116410,2,8,1,1,0,1,0,15157,6.8,16829,228,52,-1082,-1819,22.8,1515.7,8,2,4,1,1,0,0,16239,7,18648,229,40,1082,1819,22.9,1623.9,red,0.38,6,18,20,blue
4515824128,7,6,8,0,0,0,0,16124,6.8,17018,192,52,-467,-86,19.2,1612.4,6,7,8,2,1,1,0,16591,6.8,17104,211,49,467,86,21.1,1659.1,blue,2.5,2,22,22,blue
4527387973,7,5,11,1,0,1,0,17881,7.2,19560,257,56,3135,2366,25.7,1788.1,5,7,7,0,0,0,0,14746,6.6,17194,201,36,-3135,-2366,20.1,1474.6,blue,3.6,1.71,19,13,red
4525633564,10,9,12,2,1,1,0,17676,6.8,17633,186,67,1209,1019,18.6,1767.6,9,10,7,0,0,0,0,16467,6.8,16614,189,39,-1209,-1019,18.9,1646.7,blue,2.44,1.6,19,41,blue
4521175049,3,5,3,1,1,0,0,15809,6.8,17675,214,63,-1462,-1833,21.4,1580.9,5,3,8,1,0,1,0,17271,7.4,19508,232,56,1462,1833,23.2,1727.1,red,1.2,4.33,18,19,red
4500193521,7,4,5,1,1,0,0,16960,6.8,17503,215,59,-60,10,21.5,1696,4,7,7,1,0,1,1,17020,6.8,17493,222,46,60,-10,22.2,1702,red,3,1.57,20,21,blue
4514350751,3,4,4,0,0,0,0,15372,6.8,17983,234,51,-6,-1746,23.4,1537.2,4,3,0,1,1,0,0,15378,7.2,19729,236,48,6,1746,23.6,1537.8,red,1.75,1.33,16,20,blue
4518093474,8,9,7,1,1,0,0,16527,6.6,16884,194,52,-233,-754,19.4,1652.7,9,8,12,1,0,1,0,16760,6.8,17638,197,38,233,754,19.7,1676,red,1.67,2.62,20,45,blue
4527258307,6,0,9,0,0,0,0,17774,6.8,18689,226,65,4232,1501,22.6,1777.4,0,6,0,0,0,0,0,13542,7,17188,218,62,-4232,-1501,21.8,1354.2,blue,12.03,0,21,47,blue
4502041517,3,7,3,1,0,1,0,16074,7,17776,237,48,-283,-484,23.7,1607.4,7,3,6,0,0,0,0,16357,7.2,18260,220,31,283,484,22,1635.7,blue,0.86,4.33,25,47,red
4525376845,4,1,5,2,1,1,0,15612,7,17678,234,61,1518,1208,23.4,1561.2,1,4,2,0,0,0,0,14094,6.8,16470,213,50,-1518,-1208,21.3,1409.4,red,9,0.75,33,18,red
4519651388,10,16,7,0,0,0,0,16759,6.4,15499,163,37,-4236,-4211,16.3,1675.9,16,10,15,1,1,0,0,20995,7.4,19710,187,46,4236,4211,18.7,2099.5,red,1.06,3.1,15,17,blue
4515194519,3,2,5,1,1,0,0,14911,6.8,16715,228,44,-224,-1942,22.8,1491.1,2,3,2,0,0,0,0,15135,7.2,18657,248,64,224,1942,24.8,1513.5,red,4,1.33,18,19,blue
4523512356,8,6,14,1,1,0,0,16980,6.8,18629,218,48,-53,559,21.8,1698,6,8,4,0,0,0,0,17033,7,18070,240,59,53,-559,24,1703.3,blue,3.67,1.25,13,21,red
4526872931,3,4,5,0,0,0,0,15776,7,17726,261,52,969,1563,26.1,1577.6,4,3,5,1,1,0,0,14807,6.8,16163,207,44,-969,-1563,20.7,1480.7,red,2,3,18,27,blue
4527291717,4,7,2,0,0,0,0,14961,6.8,17673,215,40,-2090,-916,21.5,1496.1,7,4,7,1,1,0,0,17051,7,18589,239,56,2090,916,23.9,1705.1,red,0.86,3.5,75,21,red
4498211277,4,3,6,1,1,0,0,16031,7,18664,223,60,687,510,22.3,1603.1,3,4,1,0,0,0,0,15344,6.6,18154,254,44,-687,-510,25.4,1534.4,blue,3.33,1,48,24,red
4515507171,5,5,4,1,1,0,0,16313,7,18652,242,47,-152,-537,24.2,1631.3,5,5,5,0,0,0,0,16465,7.2,19189,213,64,152,537,21.3,1646.5,blue,1.8,2,17,22,red
4526480699,6,5,7,1,0,1,0,15964,6.8,18133,217,51,-68,963,21.7,1596.4,5,6,9,1,1,0,0,16032,6.8,17170,198,51,68,-963,19.8,1603.2,red,2.6,2.33,11,56,blue
4518209107,13,9,12,1,1,0,0,20541,7.4,19687,260,60,2368,1767,26,2054.1,9,13,16,0,0,0,0,18173,6.8,17920,169,52,-2368,-1767,16.9,1817.3,blue,2.78,1.92,16,31,red
4518472442,8,4,8,1,1,0,0,17415,6.8,16774,232,48,2791,1911,23.2,1741.5,4,8,8,0,0,0,0,14624,6.2,14863,205,26,-2791,-1911,20.5,1462.4,red,4,1.5,20,44,red
4493326882,6,10,5,1,1,0,1,16878,7,17994,185,64,-2636,-1390,18.5,1687.8,10,6,9,1,0,1,1,19514,7.4,19384,227,55,2636,1390,22.7,1951.4,red,1.1,3.17,109,21,red
4522178825,5,6,5,1,1,0,0,15901,6.8,16965,213,44,324,-409,21.3,1590.1,6,5,6,0,0,0,0,15577,6.6,17374,207,40,-324,409,20.7,1557.7,blue,1.67,2.4,18,16,blue
4525832598,4,6,6,1,1,0,0,16040,6.8,17697,235,54,-572,35,23.5,1604,6,4,13,0,0,0,0,16612,7,17662,221,45,572,-35,22.1,1661.2,blue,1.67,4.75,16,72,blue
4526594026,9,4,11,1,1,0,0,18140,7.2,20250,204,79,2793,3324,20.4,1814,4,9,3,0,0,0,0,15347,6.8,16926,222,36,-2793,-3324,22.2,1534.7,blue,5,0.78,45,22,red
4492694297,11,6,9,1,1,0,0,17229,7,18401,191,40,354,736,19.1,1722.9,6,11,6,0,0,0,0,16875,6.8,17665,202,52,-354,-736,20.2,1687.5,blue,3.33,1.09,15,32,blue
4526195256,5,4,5,1,0,1,0,15916,6.8,17531,237,51,73,-806,23.7,1591.6,4,5,4,1,1,0,0,15843,7,18337,238,61,-73,806,23.8,1584.3,blue,2.5,1.6,21,27,blue
4512891978,6,4,8,1,1,0,0,15452,7,18378,191,49,-1039,827,19.1,1545.2,4,6,4,1,0,1,1,16491,6.8,17551,215,51,1039,-827,21.5,1649.1,red,3.5,1.33,14,18,blue
4513346421,5,9,4,0,0,0,0,15999,6.8,17524,203,62,-1189,-1741,20.3,1599.9,9,5,5,1,1,0,0,17188,7.2,19265,224,50,1189,1741,22.4,1718.8,blue,1,2.8,20,20,red
4527416964,3,6,3,0,0,0,0,14399,6.6,17167,221,40,-3656,-2866,22.1,1439.9,6,3,4,0,0,0,0,18055,7.4,20033,232,82,3656,2866,23.2,1805.5,red,1,3.33,19,20,red
4521066118,1,7,2,1,1,0,0,13449,6.6,16281,205,45,-4357,-4959,20.5,1344.9,7,1,9,0,0,0,0,17806,7.6,21240,226,79,4357,4959,22.6,1780.6,red,0.43,16,18,58,red
4527444282,3,9,2,1,1,0,0,13876,6.6,16521,175,47,-3248,-1706,17.5,1387.6,9,3,8,0,0,0,0,17124,7,18227,194,52,3248,1706,19.4,1712.4,red,0.56,5.67,15,47,red
4512728524,5,12,3,0,0,0,0,15776,6.8,16537,209,58,-3587,-2861,20.9,1577.6,12,5,10,2,1,1,1,19363,7.2,19398,197,56,3587,2861,19.7,1936.3,red,0.67,4.4,21,19,blue
4527556875,4,3,2,1,1,0,0,15282,7,17671,232,54,-35,317,23.2,1528.2,3,4,4,0,0,0,0,15317,6.8,17354,206,47,35,-317,20.6,1531.7,red,2,1.75,22,28,blue
4515671076,2,7,3,1,1,0,0,14258,6.6,16594,198,52,-3903,-2516,19.8,1425.8,7,2,8,0,0,0,0,18161,7.2,19110,261,48,3903,2516,26.1,1816.1,red,0.71,7.5,18,25,red
4509965953,2,11,1,0,0,0,0,14316,6.6,16505,214,48,-4885,-2721,21.4,1431.6,11,2,12,2,1,1,0,19201,7.4,19226,249,55,4885,2721,24.9,1920.1,red,0.27,11.5,19,20,red
4525051102,3,4,3,0,0,0,0,15482,6.8,17584,243,47,36,-928,24.3,1548.2,4,3,1,2,1,1,0,15446,7.2,18512,226,67,-36,928,22.6,1544.6,blue,1.5,1.67,13,21,blue
4515677158,5,4,6,0,0,0,0,16402,7,18713,250,43,1678,1857,25,1640.2,4,5,3,1,1,0,0,14724,6.6,16856,173,75,-1678,-1857,17.3,1472.4,red,2.75,1.4,43,16,blue
4511386287,10,7,8,1,1,0,1,18822,7,18319,224,51,2830,1605,22.4,1882.2,7,10,5,1,0,1,0,15992,6.6,16714,195,47,-2830,-1605,19.5,1599.2,red,2.57,1.2,26,22,blue
4508253654,11,4,6,0,0,0,0,17702,7.2,18597,216,30,1741,675,21.6,1770.2,4,11,2,0,0,0,0,15961,6.8,17922,211,63,-1741,-675,21.1,1596.1,blue,4.25,0.55,21,19,blue
4526479094,3,6,2,0,0,0,0,16178,7,19240,258,56,-183,257,25.8,1617.8,6,3,5,1,1,0,0,16361,7.2,18983,226,68,183,-257,22.6,1636.1,red,0.83,3.67,18,16,red
4527372782,5,3,5,0,0,0,0,15897,7,18190,226,44,485,858,22.6,1589.7,3,5,3,0,0,0,0,15412,6.8,17332,238,31,-485,-858,23.8,1541.2,red,3.33,1.2,18,18,red
4516959189,6,6,5,0,0,0,0,16248,7.4,19928,204,64,131,1207,20.4,1624.8,6,6,4,0,0,0,0,16117,7,18721,211,44,-131,-1207,21.1,1611.7,blue,1.83,1.67,14,15,red
4514791683,3,7,4,1,0,1,0,15797,6.8,18289,226,64,-1234,26,22.6,1579.7,7,3,8,1,1,0,0,17031,7,18263,222,55,1234,-26,22.2,1703.1,red,1,5,28,39,red
4527354492,5,6,3,0,0,0,0,15678,6.8,17696,211,51,-596,774,21.1,1567.8,6,5,9,0,0,0,0,16274,6.8,16922,223,32,596,-774,22.3,1627.4,blue,1.33,3,22,22,red
4516653257,6,8,7,1,1,0,0,16006,6.8,17612,233,47,-1493,-1266,23.3,1600.6,8,6,11,0,0,0,0,17499,7,18878,247,36,1493,1266,24.7,1749.9,blue,1.62,3.17,20,20,blue
4519922949,5,7,3,1,1,0,0,16590,7,18656,251,48,-283,84,25.1,1659,7,5,8,0,0,0,0,16873,7.2,18572,208,52,283,-84,20.8,1687.3,blue,1.14,3,17,143,red
4511396736,4,6,5,1,0,1,0,14939,6.6,15632,189,51,-798,-1418,18.9,1493.9,6,4,13,1,1,0,0,15737,6.8,17050,210,50,798,1418,21,1573.7,red,1.5,4.75,20,14,red
4526046259,5,6,6,1,1,0,0,16787,7,18246,248,47,-240,-694,24.8,1678.7,6,5,8,1,0,1,0,17027,7.2,18940,216,63,240,694,21.6,1702.7,red,1.83,2.8,67,41,red
4506349624,6,6,4,0,0,0,0,17388,7.2,19549,250,60,1994,230,25,1738.8,6,6,2,1,1,0,0,15394,7.2,19319,205,63,-1994,-230,20.5,1539.4,blue,1.67,1.33,28,40,red
4512793610,2,3,1,0,0,0,0,14868,7,17736,257,39,-539,-852,25.7,1486.8,3,2,4,1,0,1,0,15407,7.2,18588,243,58,539,852,24.3,1540.7,red,1,3.5,26,22,blue
4506000995,3,6,3,0,0,0,0,15676,6.8,17248,267,35,-703,-1216,26.7,1567.6,6,3,8,1,1,0,0,16379,6.8,18464,224,56,703,1216,22.4,1637.9,red,1,4.67,23,50,red
4514715647,2,6,1,0,0,0,0,14230,6.6,17035,232,39,-2647,-1872,23.2,1423,6,2,6,2,1,1,0,16877,7,18907,254,69,2647,1872,25.4,1687.7,red,0.5,6,60,17,red
4509066141,5,3,10,0,0,0,1,16981,6.8,17309,214,38,384,-465,21.4,1698.1,3,5,2,2,1,1,1,16597,7,17774,224,64,-384,465,22.4,1659.7,blue,5,1,20,22,red
4526636452,9,7,13,0,0,0,0,16374,6.6,15811,152,65,1057,-143,15.2,1637.4,7,9,6,1,1,0,0,15317,6.6,15954,196,44,-1057,143,19.6,1531.7,red,3.14,1.44,34,19,blue
4521755848,7,6,6,0,0,0,0,17227,7,18842,218,55,1687,2040,21.8,1722.7,6,7,7,1,1,0,0,15540,6.8,16802,205,32,-1687,-2040,20.5,1554,red,2.17,1.86,46,21,blue
4524250123,7,2,4,0,0,0,0,16631,7.2,19270,234,53,2088,1774,23.4,1663.1,2,7,3,1,1,0,0,14543,6.8,17496,209,64,-2088,-1774,20.9,1454.3,blue,5.5,0.71,23,28,blue
4513970313,5,5,4,0,0,0,0,15888,6.8,18144,218,52,-149,645,21.8,1588.8,5,5,4,1,1,0,0,16037,6.6,17499,204,55,149,-645,20.4,1603.7,red,1.8,1.8,16,14,red
4521710145,3,6,4,0,0,0,0,15688,6.8,17439,239,52,-1434,-1422,23.9,1568.8,6,3,5,1,0,1,0,17122,7,18861,237,52,1434,1422,23.7,1712.2,red,1.17,3.67,15,15,red
4526932906,5,9,6,0,0,0,0,16462,7,17215,223,52,-922,-1305,22.3,1646.2,9,5,11,2,1,1,0,17384,7.2,18520,227,49,922,1305,22.7,1738.4,red,1.22,4,24,14,blue
4512196421,3,7,3,2,1,1,0,14548,6.6,17158,204,49,-2408,-2325,20.4,1454.8,7,3,5,0,0,0,0,16956,7.2,19483,253,52,2408,2325,25.3,1695.6,red,0.86,4,15,13,red
4501326958,11,5,8,1,1,0,0,18128,7.2,18825,205,41,1851,2008,20.5,1812.8,5,11,9,0,0,0,0,16277,6.8,16817,211,50,-1851,-2008,21.1,1627.7,blue,3.8,1.27,23,13,red
4526067873,4,9,3,0,0,0,0,15162,6.8,17438,220,44,-3051,-2198,22,1516.2,9,4,8,2,1,1,0,18213,7.4,19636,250,53,3051,2198,25,1821.3,blue,0.78,4.25,19,50,red
4515588467,2,6,2,0,0,0,0,14767,6.6,16585,230,35,-1233,-1450,23,1476.7,6,2,7,1,1,0,0,16000,6.8,18035,193,38,1233,1450,19.3,1600,blue,0.67,6.5,19,41,blue
4522190753,11,2,11,1,1,0,0,17384,7,18198,202,35,3390,2090,20.2,1738.4,2,11,4,0,0,0,0,13994,6.6,16108,201,48,-3390,-2090,20.1,1399.4,red,11,0.55,18,36,blue
4524909030,6,4,7,1,0,1,0,16159,6.6,16943,208,44,1656,1298,20.8,1615.9,4,6,4,0,0,0,0,14503,6.4,15645,200,36,-1656,-1298,20,1450.3,red,3.25,1.33,52,18,red
4524787194,1,4,0,0,0,0,0,13046,6.2,15452,197,41,-2264,-964,19.7,1304.6,4,1,2,0,0,0,0,15310,6.6,16416,222,44,2264,964,22.2,1531,red,0.25,6,43,21,red
4509570260,1,6,1,0,0,0,0,15459,7,18187,243,71,-2483,-1894,24.3,1545.9,6,1,7,2,1,1,0,17942,7.4,20081,254,72,2483,1894,25.4,1794.2,red,0.33,13,23,23,red
4511130155,4,7,3,0,0,0,0,13886,6,14445,178,42,-4582,-3594,17.8,1388.6,7,4,6,2,1,1,1,18468,6.8,18039,210,51,4582,3594,21,1846.8,red,1,3.25,25,19,red
4526133153,6,9,4,1,0,1,0,15928,6.8,17865,206,45,-1938,-1993,20.6,1592.8,9,6,8,1,1,0,0,17866,7.2,19858,244,45,1938,1993,24.4,1786.6,red,1.11,2.83,27,41,red
4500727933,2,2,1,1,0,1,0,14687,6.8,17701,234,53,-668,-300,23.4,1468.7,2,2,2,0,0,0,0,15355,6.8,18001,255,48,668,300,25.5,1535.5,red,1.5,2,19,37,blue
4508109073,5,6,4,1,0,1,0,17146,7,19051,240,67,954,1154,24,1714.6,6,5,8,1,1,0,0,16192,7,17897,212,50,-954,-1154,21.2,1619.2,blue,1.5,2.8,18,27,blue
4499724520,13,3,15,1,1,0,0,19814,7.6,20713,224,58,5468,5522,22.4,1981.4,3,13,3,0,0,0,0,14346,6.2,15191,197,32,-5468,-5522,19.7,1434.6,blue,9.33,0.46,15,10,blue
4526414474,10,8,8,0,0,0,0,17945,7.4,19818,206,56,209,1647,20.6,1794.5,8,10,3,1,1,0,1,17736,6.8,18171,196,56,-209,-1647,19.6,1773.6,red,2.25,1.1,34,83,red
4510706282,6,2,7,1,0,1,0,16646,7.2,18530,226,51,2352,1002,22.6,1664.6,2,6,2,1,1,0,0,14294,6.8,17528,210,60,-2352,-1002,21,1429.4,red,6.5,0.67,19,13,red
4526037415,9,7,12,0,0,0,0,17604,6.8,17925,194,49,1538,1118,19.4,1760.4,7,9,7,1,1,0,0,16066,6.8,16807,168,48,-1538,-1118,16.8,1606.6,red,3,1.56,17,52,blue
4516037651,7,5,5,0,0,0,0,16089,6.8,17265,198,45,-490,-217,19.8,1608.9,5,7,4,1,1,0,0,16579,6.8,17482,229,57,490,217,22.9,1657.9,red,2.4,1.29,48,17,red
4521841751,6,14,9,1,1,0,0,15544,6.2,15313,176,43,-4625,-3447,17.6,1554.4,14,6,17,1,0,1,1,20169,7.2,18760,239,40,4625,3447,23.9,2016.9,red,1.07,5.17,16,19,red
4511221654,9,16,11,0,0,0,0,17434,7,17974,188,43,-3478,-2027,18.8,1743.4,16,9,21,1,1,0,0,20912,7.4,20001,196,52,3478,2027,19.6,2091.2,red,1.25,4.11,17,19,red
4516373262,4,3,5,0,0,0,0,15945,7.2,18619,204,51,405,487,20.4,1594.5,3,4,2,0,0,0,0,15540,7,18132,236,55,-405,-487,23.6,1554,red,3,1.25,16,16,blue
4522526213,3,7,2,0,0,0,0,15692,7,17807,234,55,-560,476,23.4,1569.2,7,3,4,1,1,0,0,16252,6.8,17331,199,56,560,-476,19.9,1625.2,red,0.71,3.67,16,16,red
4526610114,9,6,8,1,1,0,0,17469,7.2,18286,206,48,2278,2188,20.6,1746.9,6,9,11,0,0,0,0,15191,6.4,16098,174,28,-2278,-2188,17.4,1519.1,blue,2.83,1.89,13,43,blue
4510548126,4,11,4,0,0,0,0,16314,6.8,16894,250,48,-2665,-900,25,1631.4,11,4,14,2,1,1,1,18979,7,17794,200,58,2665,900,20,1897.9,red,0.73,6.25,19,22,blue
4500036039,6,3,10,0,0,0,0,16299,7,17994,234,45,1049,-291,23.4,1629.9,3,6,1,0,0,0,0,15250,7,18285,240,51,-1049,291,24,1525,blue,5.33,0.67,20,38,blue
4525370217,5,7,10,1,1,0,0,15844,6.6,16971,209,51,-2270,-2033,20.9,1584.4,7,5,9,0,0,0,0,18114,7.2,19004,243,64,2270,2033,24.3,1811.4,red,2.14,3.2,62,32,red
4519408439,5,7,5,0,0,0,0,15856,7,18029,224,44,295,630,22.4,1585.6,7,5,6,0,0,0,0,15561,6.8,17399,173,51,-295,-630,17.3,1556.1,red,1.43,2.6,90,17,red
4502491381,6,9,5,0,0,0,0,15967,6.6,17065,217,47,-2162,-2253,21.7,1596.7,9,6,9,0,0,0,0,18129,7.2,19318,224,53,2162,2253,22.4,1812.9,red,1.22,3,16,46,blue
4526160950,4,2,6,0,0,0,0,15236,6.8,17761,196,52,194,143,19.6,1523.6,2,4,3,1,1,0,0,15042,6.8,17618,254,48,-194,-143,25.4,1504.2,red,5,1.25,53,17,blue
4517946996,1,9,2,0,0,0,0,12941,6.4,15085,178,43,-5519,-5521,17.8,1294.1,9,1,10,2,1,1,0,18460,7.6,20606,253,52,5519,5521,25.3,1846,red,0.33,19,25,22,red
4518551820,10,8,17,1,1,0,0,17513,6.6,16367,174,48,332,-200,17.4,1751.3,8,10,13,0,0,0,0,17181,6.4,16567,209,46,-332,200,20.9,1718.1,blue,3.38,2.1,19,28,red
4515935955,7,4,3,2,1,1,0,16700,7,19019,218,72,1039,1629,21.8,1670,4,7,3,0,0,0,0,15661,7,17390,248,48,-1039,-1629,24.8,1566.1,blue,2.5,1,23,17,red
4495136621,7,5,15,0,0,0,0,18038,7,17959,241,43,3107,2223,24.1,1803.8,5,7,6,1,1,0,0,14931,6.4,15736,154,60,-3107,-2223,15.4,1493.1,red,4.4,1.57,18,17,blue
4524261959,5,10,5,0,0,0,0,15491,6.4,15893,194,45,-2183,-2010,19.4,1549.1,10,5,6,0,0,0,0,17674,6.8,17903,224,35,2183,2010,22.4,1767.4,blue,1,3.2,19,23,red
4527413531,7,13,9,0,0,0,0,16090,6.6,16407,182,44,-4191,-2861,18.2,1609,13,7,26,1,1,0,0,20281,7.4,19268,219,46,4191,2861,21.9,2028.1,red,1.23,5.57,19,23,red
4527682051,8,7,6,1,1,0,0,17204,7,18534,236,42,1072,1587,23.6,1720.4,7,8,7,0,0,0,0,16132,6.6,16947,222,38,-1072,-1587,22.2,1613.2,blue,2,1.75,18,16,red
4507962788,3,6,2,2,1,1,0,15032,6.8,18187,207,65,-1920,-363,20.7,1503.2,6,3,8,0,0,0,0,16952,7,18550,246,53,1920,363,24.6,1695.2,blue,0.83,4.67,21,18,blue
4522051549,8,11,8,0,0,0,0,17739,6.6,16482,215,55,377,-597,21.5,1773.9,11,8,12,2,1,1,0,17362,6.8,17079,197,44,-377,597,19.7,1736.2,red,1.45,2.88,19,26,blue
4506079101,8,9,11,1,1,0,0,16894,6.6,17233,203,50,-1529,82,20.3,1689.4,9,8,11,1,0,1,1,18423,6.8,17151,232,37,1529,-82,23.2,1842.3,red,2.11,2.5,19,24,blue
4523550797,2,6,2,0,0,0,0,14944,6.8,17906,237,45,-2150,-1318,23.7,1494.4,6,2,11,1,1,0,0,17094,7.2,19224,241,76,2150,1318,24.1,1709.4,red,0.67,8.5,16,25,red
4504912203,3,4,3,0,0,0,0,14623,6.4,16060,200,36,-1585,-2306,20,1462.3,4,3,6,1,1,0,0,16208,6.8,18366,253,52,1585,2306,25.3,1620.8,red,1.5,3.33,46,43,blue
4526076411,5,9,2,0,0,0,0,15278,6.8,17274,219,44,-3315,-1641,21.9,1527.8,9,5,7,1,0,1,0,18593,7.2,18915,227,56,3315,1641,22.7,1859.3,red,0.78,3.2,21,21,red
4512589969,5,2,6,0,0,0,0,17126,7,19205,249,53,2361,1802,24.9,1712.6,2,5,2,2,1,1,0,14765,6.8,17403,230,52,-2361,-1802,23,1476.5,red,5.5,0.8,20,18,blue
4517910135,4,10,4,1,1,0,0,15494,6.8,17574,211,44,-2846,-2039,21.1,1549.4,10,4,12,0,0,0,0,18340,7.4,19613,213,44,2846,2039,21.3,1834,red,0.8,5.5,43,18,red
4527623126,6,6,3,1,0,1,0,16904,7.2,18744,245,54,406,782,24.5,1690.4,6,6,9,1,1,0,0,16498,6.8,17962,210,58,-406,-782,21,1649.8,blue,1.5,2.5,20,21,blue
4508392711,6,4,8,0,0,0,0,17214,7.2,18948,244,52,2045,1938,24.4,1721.4,4,6,5,1,1,0,0,15169,6.8,17010,220,40,-2045,-1938,22,1516.9,blue,3.5,1.5,16,18,red
4526552295,6,4,8,0,0,0,0,16352,7,18600,230,52,209,-6,23,1635.2,4,6,6,1,0,1,0,16143,7,18606,243,48,-209,6,24.3,1614.3,blue,3.5,1.67,39,24,blue
4502030084,4,7,4,0,0,0,0,14696,6.6,16517,202,41,-2688,-1172,20.2,1469.6,7,4,5,1,1,0,0,17384,7,17689,212,56,2688,1172,21.2,1738.4,red,1.14,3,21,57,red
4518281398,4,5,3,0,0,0,0,15392,7,17929,222,52,-982,-1613,22.2,1539.2,5,4,3,1,1,0,0,16374,7.4,19542,234,64,982,1613,23.4,1637.4,blue,1.4,2,24,17,blue
4524150838,3,1,3,1,1,0,0,15928,7.4,19109,266,53,1468,1205,26.6,1592.8,1,3,2,0,0,0,0,14460,6.8,17904,228,68,-1468,-1205,22.8,1446,blue,6,1,23,40,blue
4512184861,9,4,6,0,0,0,0,18417,7.2,19926,231,64,3910,3400,23.1,1841.7,4,9,3,2,1,1,0,14507,6.6,16526,206,51,-3910,-3400,20.6,1450.7,blue,3.75,0.78,22,20,blue
4520561506,2,5,1,0,0,0,0,14981,7,18767,222,76,-1607,-48,22.2,1498.1,5,2,6,1,1,0,0,16588,7.2,18815,259,48,1607,48,25.9,1658.8,blue,0.6,5.5,19,21,red
4519919253,5,7,4,1,0,1,0,15994,6.8,17724,225,52,-144,1497,22.5,1599.4,7,5,12,0,0,0,0,16138,6.4,16227,183,44,144,-1497,18.3,1613.8,blue,1.29,3.8,16,19,red
4527477768,11,8,13,0,0,0,0,18420,7,19041,218,42,1472,1838,21.8,1842,8,11,9,0,0,0,0,16948,6.8,17203,209,41,-1472,-1838,20.9,1694.8,blue,3,1.55,14,20,red
4522681859,7,6,6,0,0,0,0,17421,7.2,19606,241,59,1053,1304,24.1,1742.1,6,7,4,2,1,1,0,16368,7.2,18302,223,60,-1053,-1304,22.3,1636.8,red,2.17,1.43,23,19,red
4507071282,2,11,2,0,0,0,0,13671,6.8,16878,202,47,-5751,-4242,20.2,1367.1,11,2,12,1,1,0,0,19422,7.6,21120,259,48,5751,4242,25.9,1942.2,red,0.36,11.5,33,66,red
4500920231,6,5,9,1,0,1,0,17544,7,18604,230,73,1092,1401,23,1754.4,5,6,9,0,0,0,0,16452,6.8,17203,258,30,-1092,-1401,25.8,1645.2,blue,3,2.33,22,26,red
4526576560,4,8,6,1,1,0,0,15589,7,18306,219,64,-2268,-1810,21.9,1558.9,8,4,8,0,0,0,0,17857,7.4,20116,261,58,2268,1810,26.1,1785.7,red,1.25,4,23,37,red
4508183655,6,1,10,0,0,0,0,16702,7.2,18943,234,56,1868,1041,23.4,1670.2,1,6,1,1,1,0,0,14834,7,17902,230,60,-1868,-1041,23,1483.4,blue,16,0.33,18,22,red
4527222548,10,3,12,2,1,1,0,18211,7.4,20198,209,61,3608,3085,20.9,1821.1,3,10,3,0,0,0,0,14603,6.8,17113,183,52,-3608,-3085,18.3,1460.3,blue,7.33,0.6,24,62,red
4521462133,4,9,3,0,0,0,0,14640,6.6,17333,224,36,-3116,-1994,22.4,1464,9,4,14,1,1,0,0,17756,7.2,19327,215,55,3116,1994,21.5,1775.6,red,0.78,5.75,59,16,red
4527579335,6,7,4,1,1,0,0,16211,7.2,18576,207,47,-706,-306,20.7,1621.1,7,6,5,0,0,0,0,16917,7,18882,239,55,706,306,23.9,1691.7,blue,1.43,2,45,24,blue
4512892156,6,5,7,0,0,0,0,16517,6.4,17161,219,49,1402,-566,21.9,1651.7,5,6,3,1,1,0,0,15115,7,17727,206,56,-1402,566,20.6,1511.5,red,2.6,1.33,22,18,blue
4527589890,2,3,2,2,1,1,0,15723,7.2,19631,246,72,139,260,24.6,1572.3,3,2,2,0,0,0,0,15584,7.4,19371,253,61,-139,-260,25.3,1558.4,blue,1.33,2.5,43,18,blue
4505924248,2,5,3,0,0,0,0,14993,6.6,17018,241,44,-1481,-1877,24.1,1499.3,5,2,5,1,1,0,0,16474,7.2,18895,226,61,1481,1877,22.6,1647.4,red,1,5,18,20,red
4524216210,12,5,12,1,1,0,0,19576,7.2,18210,236,50,4417,2933,23.6,1957.6,5,12,9,0,0,0,0,15159,6.2,15277,198,33,-4417,-2933,19.8,1515.9,blue,4.8,1.17,18,16,red
4519632042,5,4,6,0,0,0,0,15217,7,18056,195,49,-784,754,19.5,1521.7,4,5,5,1,1,0,0,16001,6.6,17302,238,54,784,-754,23.8,1600.1,blue,2.75,1.8,51,25,red
4525567739,4,3,5,0,0,0,0,15502,7,17716,223,56,243,-31,22.3,1550.2,3,4,5,1,1,0,0,15259,6.8,17747,214,49,-243,31,21.4,1525.9,blue,3,2,16,19,red
4505464624,4,7,2,1,1,0,0,15125,6.8,17495,200,55,-2302,-702,20,1512.5,7,4,9,0,0,0,0,17427,6.8,18197,207,48,2302,702,20.7,1742.7,red,0.86,4,25,16,red
4521893389,6,9,3,0,0,0,0,15845,6.6,16561,195,40,-1018,-981,19.5,1584.5,9,6,7,0,0,0,0,16863,7.2,17542,213,52,1018,981,21.3,1686.3,blue,1,2.67,18,15,red
4509771893,6,6,8,0,0,0,0,16433,7,18215,229,52,-350,49,22.9,1643.3,6,6,4,0,0,0,0,16783,7,18166,224,43,350,-49,22.4,1678.3,blue,2.33,1.67,15,18,red
4517546735,9,1,11,1,1,0,0,18824,7.2,19996,237,59,5240,2335,23.7,1882.4,1,9,0,0,0,0,0,13584,7,17661,217,42,-5240,-2335,21.7,1358.4,blue,20,0.11,91,22,blue
4519910436,6,4,4,1,1,0,0,16360,6.8,17624,234,49,1447,-149,23.4,1636,4,6,2,0,0,0,0,14913,7,17773,214,48,-1447,149,21.4,1491.3,blue,2.5,1,81,25,blue
4524693952,6,8,8,1,1,0,0,15128,6.2,15881,172,37,-1187,-1137,17.2,1512.8,8,6,9,0,0,0,0,16315,6.8,17018,179,40,1187,1137,17.9,1631.5,red,1.75,2.83,55,22,red
4522502603,11,7,6,1,0,1,0,18317,7.2,19636,229,59,2214,1305,22.9,1831.7,7,11,8,0,0,0,0,16103,7,18331,204,48,-2214,-1305,20.4,1610.3,blue,2.43,1.36,22,22,blue
4509716236,6,6,4,1,1,0,0,16248,7,18567,220,47,174,1511,22,1624.8,6,6,7,0,0,0,0,16074,6.6,17056,211,42,-174,-1511,21.1,1607.4,red,1.67,2.17,13,18,red
4506111258,4,7,3,0,0,0,0,15871,6.8,17457,234,31,-967,-1216,23.4,1587.1,7,4,8,1,1,0,0,16838,7.2,18673,214,32,967,1216,21.4,1683.8,red,1,3.75,44,20,blue
4507328701,9,4,10,1,1,0,0,17779,7.2,19282,220,52,2178,1829,22,1777.9,4,9,2,0,0,0,0,15601,6.8,17453,244,56,-2178,-1829,24.4,1560.1,blue,4.75,0.67,18,13,blue
4527441922,8,5,9,0,0,0,0,16785,6.8,17837,186,48,-860,214,18.6,1678.5,5,8,7,1,1,0,0,17645,6.6,17623,236,56,860,-214,23.6,1764.5,red,3.4,1.5,82,19,red
4510543830,5,6,3,2,1,1,0,15524,6.8,17366,182,63,-700,83,18.2,1552.4,6,5,7,0,0,0,0,16224,6.8,17283,194,39,700,-83,19.4,1622.4,blue,1.33,2.6,15,17,blue
4525858898,6,7,7,0,0,0,0,16592,7,18393,221,44,813,1232,22.1,1659.2,7,6,8,0,0,0,0,15779,7,17161,195,47,-813,-1232,19.5,1577.9,blue,1.86,2.5,19,23,blue
4516912566,7,0,9,2,1,1,1,19148,7,18457,232,50,7791,6458,23.2,1914.8,0,7,0,0,0,0,0,11357,5.6,11999,137,45,-7791,-6458,13.7,1135.7,blue,12.03,0,21,10,blue
4525369607,8,5,7,0,0,0,0,17337,7,18952,228,56,2429,2405,22.8,1733.7,5,8,5,1,1,0,0,14908,6.6,16547,198,46,-2429,-2405,19.8,1490.8,red,3,1.25,18,47,red
4519205202,5,6,7,0,0,0,0,16003,6.6,17152,213,55,-954,-1007,21.3,1600.3,6,5,14,1,1,0,0,16957,7,18159,261,49,954,1007,26.1,1695.7,blue,2,4,20,22,red
4509679309,8,3,9,1,0,1,0,17370,7.4,19627,249,58,2279,2409,24.9,1737,3,8,7,1,1,0,0,15091,7,17218,229,42,-2279,-2409,22.9,1509.1,blue,5.67,1.25,46,13,blue
4526857610,10,5,5,0,0,0,0,18036,7.4,19849,243,54,2203,1534,24.3,1803.6,5,10,5,1,1,0,0,15833,7,18315,193,72,-2203,-1534,19.3,1583.3,blue,3,1,45,18,blue
4525545427,3,5,2,1,1,0,0,14711,7,18380,209,52,-1244,-548,20.9,1471.1,5,3,6,1,0,1,0,15955,7.2,18928,234,51,1244,548,23.4,1595.5,blue,1,3.67,36,12,blue
4527222225,7,4,5,2,1,1,0,16468,6.8,17897,224,44,142,-58,22.4,1646.8,4,7,6,0,0,0,0,16326,7,17955,209,64,-142,58,20.9,1632.6,red,3,1.43,45,26,red
4527198639,4,9,2,0,0,0,0,15285,6.8,16734,194,49,-974,-815,19.4,1528.5,9,4,12,1,1,0,0,16259,6.6,17549,184,33,974,815,18.4,1625.9,red,0.67,5.25,17,43,blue
4508149513,10,6,5,1,1,0,0,17151,7,18598,195,43,267,553,19.5,1715.1,6,10,5,0,0,0,0,16884,6.8,18045,234,32,-267,-553,23.4,1688.4,red,2.5,1.1,24,19,red
4523699051,10,7,12,0,0,0,0,17951,6.6,17346,211,45,2095,628,21.1,1795.1,7,10,4,0,0,0,0,15856,6.8,16718,171,47,-2095,-628,17.1,1585.6,blue,3.14,1.1,37,17,blue
4526189371,6,9,4,0,0,0,0,15917,6.8,17466,200,51,-3142,-2289,20,1591.7,9,6,8,0,0,0,0,19059,7.4,19755,243,56,3142,2289,24.3,1905.9,red,1.11,2.83,13,15,red
4526491541,8,8,11,1,1,0,0,17399,7,17937,245,44,381,865,24.5,1739.9,8,8,9,0,0,0,0,17018,6.4,17072,237,36,-381,-865,23.7,1701.8,red,2.38,2.12,22,20,blue
4525312884,7,3,7,1,1,0,0,17639,7.2,18319,247,47,2392,1200,24.7,1763.9,3,7,3,0,0,0,0,15247,6.8,17119,214,48,-2392,-1200,21.4,1524.7,blue,4.67,0.86,18,18,blue
4522358340,11,10,6,0,0,0,0,17183,7,18197,208,44,157,1673,20.8,1718.3,10,11,14,1,1,0,0,17026,6.8,16524,188,41,-157,-1673,18.8,1702.6,red,1.7,2.18,24,21,blue
4523665643,8,8,7,0,0,0,0,17130,6.8,17703,221,47,690,664,22.1,1713,8,8,14,0,0,0,0,16440,6.8,17039,208,48,-690,-664,20.8,1644,red,1.88,2.75,32,26,blue
4496641163,4,6,6,0,0,0,0,15920,6.6,17106,229,51,-905,-2229,22.9,1592,6,4,12,2,1,1,0,16825,7,19335,224,46,905,2229,22.4,1682.5,red,1.67,4.5,21,62,red
4505511340,10,9,10,0,0,0,0,17818,6.8,17651,204,41,-1272,-1634,20.4,1781.8,9,10,9,0,0,0,0,19090,7.2,19285,258,36,1272,1634,25.8,1909,red,2.22,1.8,22,54,blue
4498448542,3,3,3,2,1,1,0,15956,6.8,18145,215,73,656,526,21.5,1595.6,3,3,5,0,0,0,0,15300,6.8,17619,212,50,-656,-526,21.2,1530,red,2,2.67,23,20,red
4525583733,4,4,7,0,0,0,0,15582,6.4,15958,238,43,977,134,23.8,1558.2,4,4,7,1,1,0,0,14605,6.4,15824,204,36,-977,-134,20.4,1460.5,blue,2.75,2.75,41,44,blue
4497709596,5,10,5,2,1,1,0,16486,7,18609,244,56,-2249,-1547,24.4,1648.6,10,5,12,0,0,0,0,18735,7.4,20156,214,72,2249,1547,21.4,1873.5,red,1,4.4,19,19,blue
4510559226,6,3,9,1,1,0,0,15692,6.8,17598,217,32,189,-99,21.7,1569.2,3,6,2,0,0,0,0,15503,6.6,17697,244,48,-189,99,24.4,1550.3,blue,5,0.83,20,19,red
4517827670,4,8,5,0,0,0,0,14232,6.6,15999,197,41,-3089,-3265,19.7,1423.2,8,4,7,1,1,0,0,17321,7.2,19264,251,46,3089,3265,25.1,1732.1,red,1.12,3.75,20,21,blue
4499897772,7,8,10,1,0,1,1,18133,7,17764,215,46,1025,-1153,21.5,1813.3,8,7,5,1,1,0,0,17108,6.8,18917,218,54,-1025,1153,21.8,1710.8,blue,2.12,1.86,14,14,blue
4524941419,22,6,29,1,0,1,1,23205,7,17846,208,23,7600,1865,20.8,2320.5,6,22,9,0,0,0,0,15605,6.4,15981,171,58,-7600,-1865,17.1,1560.5,blue,8.5,0.68,13,16,red
4518184888,4,6,6,2,1,1,0,15564,7,18158,214,46,-1075,378,21.4,1556.4,6,4,11,0,0,0,0,16639,7,17780,240,44,1075,-378,24,1663.9,blue,1.67,4.25,79,18,red
4525326999,3,3,3,1,1,0,0,14977,7,17698,223,44,98,161,22.3,1497.7,3,3,4,0,0,0,0,14879,6.8,17537,224,44,-98,-161,22.4,1487.9,blue,2,2.33,43,34,blue
4507966982,5,10,7,0,0,0,0,16263,6.8,16732,198,52,-1911,-2325,19.8,1626.3,10,5,7,1,1,0,0,18174,7.2,19057,220,45,1911,2325,22,1817.4,red,1.2,3.4,47,29,red
4490921913,7,2,7,1,1,0,0,18477,7.2,19323,275,45,4458,3839,27.5,1847.7,2,7,4,0,0,0,0,14019,6.2,15484,188,50,-4458,-3839,18.8,1401.9,blue,7,0.86,19,16,red
4501037269,7,7,11,2,1,1,0,16484,7,17470,202,62,-375,-752,20.2,1648.4,7,7,5,0,0,0,0,16859,7.2,18222,219,41,375,752,21.9,1685.9,red,2.57,1.71,23,86,blue
4525626053,2,2,2,1,0,1,0,15167,6.8,18214,244,43,7,-659,24.4,1516.7,2,2,3,0,0,0,0,15160,7.2,18873,242,56,-7,659,24.2,1516,red,2,2.5,14,42,blue
4522327087,5,8,5,0,0,0,0,16007,7.2,18083,207,56,-1534,-167,20.7,1600.7,8,5,9,2,1,1,0,17541,6.8,18250,196,64,1534,167,19.6,1754.1,red,1.25,3.4,21,73,red
4525330228,8,6,8,0,0,0,0,18093,7,18394,231,48,1882,1490,23.1,1809.3,6,8,8,0,0,0,0,16211,6.8,16904,203,44,-1882,-1490,20.3,1621.1,blue,2.67,1.75,23,18,red
4525010648,10,8,10,0,0,0,0,18588,7.2,19735,225,64,2382,2614,22.5,1858.8,8,10,7,0,0,0,0,16206,6.8,17121,192,28,-2382,-2614,19.2,1620.6,blue,2.5,1.5,38,17,red
4526851533,8,1,8,1,1,0,0,16853,7,18255,226,44,2751,1464,22.6,1685.3,1,8,0,0,0,0,0,14102,6.8,16791,199,57,-2751,-1464,19.9,1410.2,blue,16,0.12,68,14,blue
4509949605,7,7,9,0,0,0,0,16323,7.2,18362,213,44,-451,336,21.3,1632.3,7,7,10,1,1,0,0,16774,6.8,18026,219,44,451,-336,21.9,1677.4,blue,2.29,2.43,20,68,red
4520356694,4,6,2,0,0,0,0,15063,6.8,17979,206,64,-1213,-1013,20.6,1506.3,6,4,2,1,1,0,0,16276,7,18992,253,56,1213,1013,25.3,1627.6,blue,1,2,19,24,red
4526101033,4,7,10,0,0,0,0,14929,6.2,15842,223,34,-3291,-2502,22.3,1492.9,7,4,8,2,1,1,1,18220,7.2,18344,248,56,3291,2502,24.8,1822,red,2,3.75,21,22,blue
4519740782,6,3,5,2,1,1,0,17119,7.2,18962,233,57,2031,1967,23.3,1711.9,3,6,3,0,0,0,0,15088,6.8,16995,209,52,-2031,-1967,20.9,1508.8,blue,3.67,1,19,17,blue
4514345833,9,7,10,2,1,1,1,19049,7,17924,202,56,1618,-74,20.2,1904.9,7,9,8,0,0,0,0,17431,6.8,17998,209,42,-1618,74,20.9,1743.1,red,2.71,1.67,17,17,red
4525540282,14,5,26,1,1,0,0,19452,7,18579,209,45,3682,1284,20.9,1945.2,5,14,6,0,0,0,0,15770,6.6,17295,207,56,-3682,-1284,20.7,1577,red,8,0.79,21,18,blue
4519250441,1,12,0,1,0,1,0,13981,6.6,16277,220,52,-5870,-3642,22,1398.1,12,1,18,0,0,0,0,19851,7.4,19919,234,53,5870,3642,23.4,1985.1,red,0.08,30,19,45,red
4516052882,7,11,7,0,0,0,0,15418,6.4,15315,203,31,-3531,-3889,20.3,1541.8,11,7,15,2,1,1,0,18949,7.4,19204,215,48,3531,3889,21.5,1894.9,red,1.27,3.71,16,22,blue
4527534005,8,5,9,1,1,0,0,17636,7.2,19458,218,52,2360,2396,21.8,1763.6,5,8,4,0,0,0,0,15276,6.6,17062,188,48,-2360,-2396,18.8,1527.6,blue,3.4,1.12,18,51,red
4525937822,6,7,8,1,1,0,0,17026,7.2,18215,229,48,326,85,22.9,1702.6,7,6,6,0,0,0,0,16700,6.8,18130,217,52,-326,-85,21.7,1670,blue,2,2.17,19,18,red
4524056834,8,3,10,1,1,0,0,17084,7.2,18781,219,52,2148,1700,21.9,1708.4,3,8,2,0,0,0,0,14936,6.4,17081,217,52,-2148,-1700,21.7,1493.6,red,6,0.62,19,19,red
4518437302,3,7,3,0,0,0,0,14501,6.6,16545,195,64,-2930,-2779,19.5,1450.1,7,3,5,1,1,0,0,17431,7.2,19324,239,60,2930,2779,23.9,1743.1,red,0.86,4,16,22,red
4520825684,4,5,7,0,0,0,0,15745,6.8,17654,236,40,-1300,-652,23.6,1574.5,5,4,10,1,1,0,0,17045,7.2,18306,252,55,1300,652,25.2,1704.5,blue,2.2,3.75,22,21,red
4525941863,5,7,6,1,1,0,0,16571,7,18777,220,65,88,413,22,1657.1,7,5,7,0,0,0,0,16483,7,18364,202,46,-88,-413,20.2,1648.3,blue,1.57,2.8,40,23,blue
4514740327,5,7,7,0,0,0,0,17224,6.8,18105,229,60,631,-265,22.9,1722.4,7,5,6,1,1,0,0,16593,7.2,18370,218,46,-631,265,21.8,1659.3,red,1.71,2.6,16,86,blue
4522552557,9,1,14,0,0,0,0,18518,7.4,19380,224,55,4619,2904,22.4,1851.8,1,9,2,1,1,0,0,13899,6.6,16476,205,62,-4619,-2904,20.5,1389.9,blue,23,0.33,29,54,blue
4518532291,5,11,5,0,0,0,0,17155,7.2,18632,224,72,-1516,391,22.4,1715.5,11,5,12,1,1,0,0,18671,7,18241,228,40,1516,-391,22.8,1867.1,red,0.91,4.6,88,19,red
4501240960,5,5,6,1,1,0,0,16046,6.8,17207,234,41,699,18,23.4,1604.6,5,5,6,0,0,0,0,15347,6.6,17189,199,52,-699,-18,19.9,1534.7,blue,2.2,2.2,18,14,red
4527043235,6,3,6,0,0,0,0,16986,7,18376,226,35,2587,1971,22.6,1698.6,3,6,4,1,1,0,0,14399,6.6,16405,208,40,-2587,-1971,20.8,1439.9,red,4,1.17,16,15,blue
4525941193,4,6,5,1,0,1,0,16368,7,18857,216,56,-180,-890,21.6,1636.8,6,4,5,1,1,0,0,16548,7.4,19747,224,56,180,890,22.4,1654.8,blue,1.5,2.75,43,17,blue
4508992127,4,10,4,0,0,0,0,15302,6.8,16647,210,55,-3051,-2123,21,1530.2,10,4,12,1,1,0,0,18353,7,18770,215,50,3051,2123,21.5,1835.3,red,0.8,5.5,21,28,blue
4526331089,5,6,3,1,1,0,0,15367,7.2,18799,217,56,-2021,-768,21.7,1536.7,6,5,7,0,0,0,0,17388,7.4,19567,238,68,2021,768,23.8,1738.8,red,1.33,2.6,17,20,red
4517588876,2,3,4,1,1,0,0,15178,6.8,17707,236,50,-673,-1332,23.6,1517.8,3,2,5,1,0,1,0,15851,7.2,19039,252,64,673,1332,25.2,1585.1,red,2,4,22,20,red
4523127328,4,7,3,0,0,0,0,13824,6.2,14814,167,40,-5059,-5247,16.7,1382.4,7,4,9,2,1,1,1,18883,7.6,20061,235,79,5059,5247,23.5,1888.3,red,1,4,17,18,red
4509906383,7,11,8,0,0,0,0,15919,6.8,16956,200,32,-2604,-1096,20,1591.9,11,7,10,0,0,0,0,18523,7,18052,183,48,2604,1096,18.3,1852.3,red,1.36,3,17,16,red
4525953760,5,11,2,1,0,1,0,16627,7,18559,229,64,-844,737,22.9,1662.7,11,5,14,0,0,0,0,17471,7,17822,206,40,844,-737,20.6,1747.1,red,0.64,5,35,67,red
4499972378,1,5,2,1,1,0,0,14032,6.4,16940,220,53,-1935,-1534,22,1403.2,5,1,5,0,0,0,0,15967,7.2,18474,231,45,1935,1534,23.1,1596.7,red,0.6,10,43,18,red
4501521847,13,5,17,1,1,0,0,18787,7,17878,193,40,3886,1777,19.3,1878.7,5,13,5,0,0,0,0,14901,6.6,16101,175,43,-3886,-1777,17.5,1490.1,blue,6,0.77,93,17,blue
4522436299,2,5,3,0,0,0,0,15205,6.6,16968,248,44,-977,-1320,24.8,1520.5,5,2,8,0,0,0,0,16182,7,18288,186,64,977,1320,18.6,1618.2,red,1,6.5,23,26,blue
4521892508,4,8,4,1,1,0,0,15651,6.8,16945,201,48,-1990,-3002,20.1,1565.1,8,4,6,0,0,0,0,17641,7.4,19947,226,56,1990,3002,22.6,1764.1,red,1,3.5,20,40,blue
4515694077,7,2,6,0,0,0,0,17376,7,18907,238,43,2809,1740,23.8,1737.6,2,7,3,1,0,1,0,14567,6.6,17167,234,44,-2809,-1740,23.4,1456.7,red,6.5,0.71,23,24,blue
4519903713,4,11,5,1,1,0,0,15788,6.6,17331,223,52,-3084,-3141,22.3,1578.8,11,4,9,0,0,0,0,18872,7.6,20472,230,64,3084,3141,23,1887.2,red,0.82,5,35,11,red
4525018915,4,6,4,0,0,0,0,15688,6.6,16920,226,53,-162,-553,22.6,1568.8,6,4,10,0,0,0,0,15850,7,17473,233,44,162,553,23.3,1585,red,1.33,4,25,27,blue
4500088034,4,6,2,1,0,1,0,15374,6.8,17943,223,49,-780,107,22.3,1537.4,6,4,6,1,1,0,0,16154,7.2,17836,231,61,780,-107,23.1,1615.4,blue,1,3,20,21,red
4522346713,2,5,0,1,0,1,0,13418,6.4,16047,189,52,-2958,-1733,18.9,1341.8,5,2,5,1,1,0,0,16376,7,17780,220,63,2958,1733,22,1637.6,red,0.4,5,17,12,red
4518241123,4,11,4,0,0,0,0,12178,4.6,10098,120,20,-6754,-5726,12,1217.8,11,4,14,0,0,0,1,18932,6.4,15824,203,36,6754,5726,20.3,1893.2,red,0.73,6.25,14,17,red
4516362177,8,10,8,0,0,0,0,15984,6.6,16282,206,34,-2111,-1573,20.6,1598.4,10,8,14,1,0,1,0,18095,6.8,17855,208,45,2111,1573,20.8,1809.5,blue,1.6,3,21,18,blue
4413326513,3,5,3,0,0,0,0,15908,7.4,18487,220,60,-1194,-1133,22,1590.8,5,3,4,1,1,0,0,17102,7.2,19620,255,56,1194,1133,25.5,1710.2,blue,1.2,3,37,20,red
4502124778,6,11,6,0,0,0,0,15240,7,17500,162,48,-3562,-2590,16.2,1524,11,6,8,1,1,0,0,18802,7.4,20090,221,48,3562,2590,22.1,1880.2,red,1.09,3.17,17,16,blue
4512490031,3,4,3,1,1,0,0,14943,6.8,17710,223,51,-626,61,22.3,1494.3,4,3,8,0,0,0,0,15569,6.8,17649,233,48,626,-61,23.3,1556.9,blue,1.5,4,14,19,red
4512278735,4,6,7,0,0,0,0,15634,7.2,18046,235,49,-1848,-617,23.5,1563.4,6,4,9,1,1,0,0,17482,7.2,18663,256,54,1848,617,25.6,1748.2,blue,1.83,3.75,19,26,red
4527842983,6,7,10,1,1,0,0,17071,7.2,19207,245,58,374,1465,24.5,1707.1,7,6,10,0,0,0,0,16697,6.8,17742,209,36,-374,-1465,20.9,1669.7,blue,2.29,2.83,40,19,red
4513377157,4,7,7,1,0,1,0,15726,7.2,17885,222,60,-1614,-418,22.2,1572.6,7,4,9,1,1,0,0,17340,7,18303,239,56,1614,418,23.9,1734,blue,1.57,4,24,25,red
4527808251,3,2,4,0,0,0,0,15249,7.2,19121,240,45,-162,1520,24,1524.9,2,3,3,2,1,1,0,15411,6.8,17601,248,40,162,-1520,24.8,1541.1,red,3.5,1.67,40,21,red
4527767522,6,2,8,1,1,0,0,16055,7,18838,208,64,583,439,20.8,1605.5,2,6,1,0,0,0,0,15472,7.2,18399,259,54,-583,-439,25.9,1547.2,blue,7,0.5,22,43,red
4527853173,2,8,1,0,0,0,0,13446,6.4,15500,190,32,-4676,-3551,19,1344.6,8,2,9,2,1,1,0,18122,7.2,19051,243,50,4676,3551,24.3,1812.2,red,0.38,8.5,17,16,red
4527742166,4,4,5,1,1,0,0,15903,7,17640,239,48,428,400,23.9,1590.3,4,4,6,0,0,0,0,15475,6.8,17240,217,57,-428,-400,21.7,1547.5,red,2.25,2.5,25,20,blue
4527648336,9,5,7,0,0,0,0,16940,7.2,18098,203,36,893,256,20.3,1694,5,9,5,1,1,0,0,16047,7,17842,228,48,-893,-256,22.8,1604.7,red,3.2,1.11,44,35,blue
4527888798,8,4,7,1,0,1,0,16882,7.2,18657,221,35,1632,1767,22.1,1688.2,4,8,4,0,0,0,0,15250,6.6,16890,179,44,-1632,-1767,17.9,1525,blue,3.75,1,15,14,red
4525312579,6,7,3,0,0,0,0,15894,7,17808,212,52,-1019,-1564,21.2,1589.4,7,6,4,1,1,0,0,16913,7.2,19372,229,44,1019,1564,22.9,1691.3,red,1.29,1.83,85,30,red
4527909697,4,1,13,2,1,1,0,16047,7,18644,244,48,1976,1778,24.4,1604.7,1,4,1,0,0,0,0,14071,6.8,16866,222,44,-1976,-1778,22.2,1407.1,blue,17,0.5,44,19,red
4527637091,4,8,2,0,0,0,0,14709,6.6,17092,217,38,-2591,-1250,21.7,1470.9,8,4,10,1,1,0,0,17300,7.2,18342,236,55,2591,1250,23.6,1730,red,0.75,4.5,17,16,red
4527658315,6,6,9,1,0,1,0,16368,7,17821,234,47,-1314,-1708,23.4,1636.8,6,6,4,1,1,0,0,17682,7.2,19529,230,76,1314,1708,23,1768.2,blue,2.5,1.67,44,23,red
4527865649,7,8,9,1,0,1,0,17394,6.8,17904,261,32,188,-676,26.1,1739.4,8,7,7,0,0,0,0,17206,7,18580,212,56,-188,676,21.2,1720.6,red,2,2.14,19,33,red
4527796790,6,6,7,1,1,0,0,15950,6.8,17303,196,55,175,-234,19.6,1595,6,6,4,0,0,0,0,15775,6.8,17537,221,28,-175,234,22.1,1577.5,blue,2.17,1.67,13,86,red
4527433973,2,7,3,0,0,0,0,15268,6.8,17717,214,72,-880,179,21.4,1526.8,7,2,8,0,0,0,0,16148,6.6,17538,198,42,880,-179,19.8,1614.8,red,0.71,7.5,18,18,red
4527887542,10,2,12,0,0,0,0,18274,6.8,19011,232,49,4693,2968,23.2,1827.4,2,10,1,0,0,0,0,13581,6.4,16043,179,45,-4693,-2968,17.9,1358.1,blue,11,0.3,20,17,blue
4527750562,5,7,6,0,0,0,0,15993,6.8,17528,206,48,-645,-448,20.6,1599.3,7,5,9,1,1,0,0,16638,6.8,17976,197,64,645,448,19.7,1663.8,red,1.57,3.2,41,24,blue
4527782537,3,6,7,1,1,0,0,14857,6.8,16510,226,43,-959,-1248,22.6,1485.7,6,3,3,1,0,1,0,15816,6.8,17758,195,58,959,1248,19.5,1581.6,red,1.67,3,54,32,blue
4527696871,9,4,11,1,1,0,0,18503,7.4,19717,250,56,2527,1695,25,1850.3,4,9,9,0,0,0,0,15976,7,18022,210,63,-2527,-1695,21,1597.6,blue,5,1.44,38,42,blue
4527990640,8,7,11,1,0,1,0,17442,7.2,20005,210,68,-347,966,21,1744.2,7,8,10,0,0,0,0,17789,7.2,19039,218,58,347,-966,21.8,1778.9,blue,2.71,2.12,88,14,red
4527729232,4,13,5,0,0,0,0,14478,6.2,14665,171,32,-5087,-4618,17.1,1447.8,13,4,12,0,0,0,0,19565,7.2,19283,199,71,5087,4618,19.9,1956.5,red,0.69,6.25,39,43,red
4521542969,6,4,10,2,1,1,0,17086,7,17746,229,54,1838,-689,22.9,1708.6,4,6,7,0,0,0,0,15248,7.2,18435,231,51,-1838,689,23.1,1524.8,blue,4,1.83,16,17,blue
4527658739,5,7,6,1,0,1,2,18075,7.2,19324,233,60,600,289,23.3,1807.5,7,5,6,1,1,0,0,17475,7,19035,224,63,-600,-289,22.4,1747.5,blue,1.57,2.6,19,41,red
4527898486,5,4,5,1,1,0,0,15965,7,18534,208,52,725,1773,20.8,1596.5,4,5,5,1,0,1,0,15240,6.8,16761,202,40,-725,-1773,20.2,1524,blue,2.5,1.8,60,19,blue
4527885240,4,7,1,0,0,0,0,15261,7,18671,223,60,-1461,-69,22.3,1526.1,7,4,8,1,1,0,0,16722,7,18740,215,56,1461,69,21.5,1672.2,blue,0.71,3.75,35,15,red
4527780032,1,2,0,1,1,0,0,14603,7,18478,232,71,670,1446,23.2,1460.3,2,1,5,0,0,0,0,13933,6.8,17032,197,52,-670,-1446,19.7,1393.3,blue,0.5,7,19,41,red
4527908858,1,3,0,1,0,1,0,13836,6.6,17114,213,59,-1798,-674,21.3,1383.6,3,1,4,1,1,0,0,15634,6.8,17788,251,46,1798,674,25.1,1563.4,red,0.33,7,16,17,red
4527960459,7,1,5,1,0,1,0,17170,7,19211,251,54,3234,2427,25.1,1717,1,7,1,0,0,0,0,13936,6.8,16784,203,68,-3234,-2427,20.3,1393.6,blue,12,0.29,20,23,blue
4527875317,9,12,12,1,1,0,0,16198,7,18249,165,33,-2121,-1038,16.5,1619.8,12,9,7,1,0,1,0,18319,7.4,19287,187,68,2121,1038,18.7,1831.9,red,1.75,2.11,13,16,red
4527811425,5,3,2,0,0,0,0,16923,7.2,19758,222,72,1974,1712,22.2,1692.3,3,5,5,1,1,0,0,14949,6.8,18046,202,64,-1974,-1712,20.2,1494.9,blue,2.33,1.6,48,11,blue
4527715781,4,5,5,2,1,1,0,15131,6.8,18216,214,61,-727,343,21.4,1513.1,5,4,2,0,0,0,0,15858,6.8,17873,248,48,727,-343,24.8,1585.8,red,1.8,1.75,14,21,red
4527650398,7,7,9,0,0,0,0,17155,7,18002,231,36,756,1,23.1,1715.5,7,7,8,1,1,0,0,16399,7,18001,216,58,-756,-1,21.6,1639.9,blue,2.29,2.14,12,63,blue
4527878058,12,6,13,0,0,0,0,18573,7.2,19391,207,46,2639,2364,20.7,1857.3,6,12,6,0,0,0,0,15934,6.6,17027,197,38,-2639,-2364,19.7,1593.4,blue,4.17,1,20,22,blue
4527873286,7,4,5,1,1,0,0,17765,7.2,18967,211,69,2519,2469,21.1,1776.5,4,7,7,0,0,0,0,15246,6.8,16498,229,34,-2519,-2469,22.9,1524.6,blue,3,1.57,19,49,blue
4527797466,6,4,8,1,1,0,0,16238,7.2,19255,233,48,782,888,23.3,1623.8,4,6,3,0,0,0,0,15456,7,18367,206,56,-782,-888,20.6,1545.6,blue,3.5,1.17,54,33,red
4527713716,6,7,5,0,0,0,0,15903,7,18032,210,45,-2416,-1877,21,1590.3,7,6,11,1,1,0,0,18319,7.4,19909,261,60,2416,1877,26.1,1831.9,red,1.57,3,24,14,red
4527628313,2,3,3,1,1,0,0,14459,6.6,17229,224,48,-839,-1085,22.4,1445.9,3,2,1,0,0,0,0,15298,7.2,18314,247,40,839,1085,24.7,1529.8,red,1.67,2,18,70,blue
4523772935,6,6,5,0,0,0,0,16266,7,17321,207,44,927,-58,20.7,1626.6,6,6,4,1,1,0,0,15339,6.8,17379,201,46,-927,58,20.1,1533.9,blue,1.83,1.67,18,11,blue
